//MAP CONVERTED BY dmm2tgm.py THIS HEADER COMMENT PREVENTS RECONVERSION, DO NOT REMOVE
"ab" = (
/obj/structure/cable,
/obj/machinery/atmospherics/pipe/simple/green/hidden{
	dir = 4
	},
/turf/open/floor/tile/white,
/area/bigredv3/inside/command/highcomm)
"ad" = (
/turf/open/floor/tile/white,
/area/bigredv3/inside/command/highcomm)
"av" = (
/obj/structure/cable,
/obj/machinery/atmospherics/pipe/simple/green/hidden,
/turf/open/floor/tile/dark/blue2{
	dir = 6
	},
/area/bigredv3/inside/command/highcomm)
"be" = (
/obj/machinery/door/airlock/mainship/generic{
	dir = 2;
	name = "\improper Operations Toilet"
	},
/turf/open/floor/freezer,
/area/bigredv3/inside/command/highcomm)
"ca" = (
/obj/structure/bed/chair{
	dir = 1
	},
/obj/machinery/light,
/turf/open/floor/tile/white,
/area/bigredv3/inside/command/highcomm)
"cd" = (
/obj/machinery/door_control{
	id = "Operations";
	name = "Storm Shutters"
	},
/turf/open/floor/tile/dark/blue2{
	dir = 1
	},
/area/bigredv3/inside/command/highcomm)
"cD" = (
/turf/open/floor/tile/dark,
/area/bigredv3/inside/command/bridge)
"cH" = (
/obj/machinery/light,
/obj/structure/cable,
/obj/structure/bed/chair{
	dir = 1
	},
/turf/open/floor/tile/white,
/area/bigredv3/inside/command/highcomm)
"cK" = (
/obj/machinery/light{
	dir = 4
	},
/turf/open/floor/tile/dark/blue2{
	dir = 4
	},
/area/bigredv3/inside/command/highcomm)
"dq" = (
/obj/structure/cable,
/obj/machinery/atmospherics/pipe/simple/green/hidden,
/turf/open/floor/tile/dark/blue2{
	dir = 4
	},
/area/bigredv3/inside/command/highcomm)
"dV" = (
/obj/structure/cable,
/obj/machinery/atmospherics/pipe/simple/green/hidden,
/turf/open/floor/tile/dark/blue2/corner,
/area/bigredv3/inside/command/highcomm)
"dZ" = (
/obj/machinery/atmospherics/components/unary/vent_pump{
	dir = 4;
	on = 1
	},
/turf/open/floor/wood,
/area/bigredv3/inside/command/highcomm)
"ea" = (
/obj/structure/cable,
/obj/machinery/atmospherics/pipe/manifold/green/hidden{
	dir = 8
	},
/turf/open/floor/tile/dark/blue2/corner,
/area/bigredv3/inside/command/highcomm)
"ep" = (
/turf/closed/wall,
/area/bigredv3/inside/wall)
"eA" = (
/obj/machinery/atmospherics/pipe/simple/green/hidden,
/obj/structure/cable,
/turf/open/floor/tile/white,
/area/bigredv3/inside/command/highcomm)
"eD" = (
/obj/structure/closet/secure_closet/personal/cabinet,
/turf/open/floor/wood,
/area/bigredv3/inside/command/highcomm)
"eX" = (
/turf/open/floor/tile/dark/blue2{
	dir = 6
	},
/area/bigredv3/inside/command/highcomm)
"fb" = (
/obj/structure/cable,
/obj/machinery/door/airlock/mainship/command/free_access{
	dir = 1;
	name = "\improper Operations Maintenance"
	},
/turf/open/floor/plating,
/area/bigredv3/inside/command/highcomm)
"fc" = (
/turf/open/floor/tile/dark/blue2{
	dir = 10
	},
/area/bigredv3/inside/command/highcomm)
"fe" = (
/obj/structure/cable,
/turf/open/floor/tile/dark,
/area/bigredv3/inside/command/bridge)
"fP" = (
/obj/machinery/light{
	dir = 1
	},
/turf/open/floor/tile/dark/red2{
	dir = 5
	},
/area/bigredv3/inside/security/colarmory)
"fY" = (
/obj/effect/landmark/start/job/survivor,
/obj/effect/landmark/start/latejoinsurvivor,
/obj/machinery/atmospherics/pipe/simple/green/hidden{
	dir = 4
	},
/turf/open/floor/tile/dark,
/area/bigredv3/inside/command/bridge)
"gj" = (
/obj/effect/landmark/start/job/survivor,
/obj/effect/landmark/start/latejoinsurvivor,
/turf/open/floor/grimy,
/area/bigredv3/inside/command/highcomm)
"gk" = (
/obj/structure/cable,
/obj/machinery/atmospherics/pipe/manifold/green/hidden{
	dir = 1
	},
/turf/open/floor/grimy,
/area/bigredv3/inside/command/highcomm)
"gQ" = (
/obj/structure/table,
/obj/item/tool/pen/red,
/turf/open/floor/tile/white,
/area/bigredv3/inside/command/highcomm)
"hn" = (
/obj/machinery/light{
	dir = 1
	},
/turf/open/floor/tile/white,
/area/bigredv3/inside/command/highcomm)
"ht" = (
/obj/machinery/vending/coffee,
/turf/open/floor/tile/white,
/area/bigredv3/inside/command/highcomm)
"hG" = (
/obj/machinery/atmospherics/pipe/simple/green/hidden{
	dir = 6
	},
/turf/open/floor/tile/dark/blue2{
	dir = 8
	},
/area/bigredv3/inside/command/highcomm)
"if" = (
/obj/structure/cable,
/obj/effect/ai_node,
/turf/open/floor/tile/dark/blue2{
	dir = 4
	},
/area/bigredv3/inside/command/highcomm)
"ir" = (
/obj/structure/cable,
/obj/machinery/atmospherics/pipe/simple/green/hidden{
	dir = 9
	},
/turf/open/floor/tile/dark,
/area/bigredv3/inside/command/highcomm)
"iy" = (
/obj/machinery/atmospherics/pipe/simple/green/hidden{
	dir = 4
	},
/obj/structure/cable,
/turf/open/floor/tile/dark,
/area/bigredv3/inside/command/highcomm)
"iT" = (
/obj/structure/cable,
/obj/machinery/atmospherics/pipe/simple/green/hidden,
/obj/effect/ai_node,
/turf/open/floor/tile/dark/blue2{
	dir = 4
	},
/area/bigredv3/inside/command/highcomm)
"ja" = (
/obj/machinery/atmospherics/pipe/simple/green/hidden{
	dir = 4
	},
/turf/open/floor/tile/dark,
/area/bigredv3/inside/command/bridge)
"jj" = (
/obj/structure/table,
/obj/item/phone,
/obj/machinery/light,
/turf/open/floor/tile/dark,
/area/bigredv3/inside/command/bridge)
"jz" = (
/obj/structure/cable,
/obj/machinery/atmospherics/pipe/simple/green/hidden{
	dir = 4
	},
/turf/open/floor/tile/dark,
/area/bigredv3/inside/command/highcomm)
"kK" = (
/obj/machinery/computer/security,
/obj/structure/table,
/turf/open/floor/tile/dark,
/area/bigredv3/inside/command/bridge)
"kX" = (
/obj/structure/flora/ausbushes/brflowers,
/obj/structure/flora/ausbushes/ywflowers,
/obj/structure/window/reinforced{
	dir = 1
	},
/obj/structure/window/reinforced,
/obj/structure/window/reinforced/windowstake{
	dir = 4
	},
/obj/structure/window/reinforced/windowstake{
	dir = 8
	},
/turf/open/ground/jungle/clear,
/area/bigredv3/inside/command/highcomm)
"la" = (
/obj/machinery/light{
	dir = 4
	},
/obj/structure/cable,
/turf/open/floor/tile/white,
/area/bigredv3/inside/command/highcomm)
"lq" = (
/obj/structure/table,
/obj/machinery/faxmachine,
/obj/machinery/light{
	dir = 1
	},
/turf/open/floor/tile/dark,
/area/bigredv3/inside/command/bridge)
"mv" = (
/turf/open/floor/tile/dark/blue2{
	dir = 4
	},
/area/bigredv3/inside/command/bridge)
"mF" = (
/turf/open/floor/tile/dark,
/area/bigredv3/inside/command/highcomm)
"nt" = (
/obj/machinery/computer/station_alert,
/obj/structure/table,
/turf/open/floor/tile/dark,
/area/bigredv3/inside/command/bridge)
"nB" = (
/obj/structure/cable,
/obj/machinery/atmospherics/pipe/simple/green/hidden,
/turf/open/floor/tile/dark/blue2{
	dir = 8
	},
/area/bigredv3/inside/command/highcomm)
"nF" = (
/obj/structure/cable,
/obj/machinery/atmospherics/pipe/simple/green/hidden,
/turf/open/floor/tile/dark/blue2{
	dir = 5
	},
/area/bigredv3/inside/command/highcomm)
"nH" = (
/turf/closed/wall/r_wall,
/area/bigredv3/inside/wall)
"nO" = (
/obj/structure/cable,
/obj/machinery/atmospherics/pipe/simple/green/hidden{
	dir = 4
	},
/obj/effect/ai_node,
/turf/open/floor/grimy,
/area/bigredv3/inside/command/highcomm)
"nP" = (
/obj/structure/table,
/obj/item/flashlight/lamp,
/turf/open/floor/tile/dark,
/area/bigredv3/inside/command/bridge)
"oG" = (
/obj/structure/cable,
/obj/machinery/atmospherics/pipe/simple/green/hidden{
	dir = 9
	},
/obj/effect/ai_node,
/turf/open/floor/tile/dark/blue2/corner{
	dir = 1
	},
/area/bigredv3/inside/command/highcomm)
"oS" = (
/turf/open/floor/tile/dark/blue2{
	dir = 9
	},
/area/bigredv3/inside/command/highcomm)
"pc" = (
/obj/machinery/light{
	dir = 1
	},
/turf/open/floor/tile/dark/blue2{
	dir = 1
	},
/area/bigredv3/inside/command/highcomm)
"ph" = (
/obj/machinery/atmospherics/components/unary/vent_pump{
	dir = 8;
	on = 1
	},
/obj/structure/cable,
/turf/open/floor/tile/dark,
/area/bigredv3/inside/command/bridge)
"py" = (
/turf/open/floor/tile/dark/blue2/corner{
	dir = 4
	},
/area/bigredv3/inside/command/highcomm)
"qq" = (
/obj/structure/cable,
/obj/structure/bed/chair{
	dir = 1
	},
/turf/open/floor/tile/white,
/area/bigredv3/inside/command/highcomm)
"qw" = (
/turf/open/floor/asteroidfloor,
/area/bigredv3/outside/directions/central)
"qy" = (
/obj/machinery/door_control{
	dir = 1;
	id = "Operations";
	name = "Storm Shutters"
	},
/turf/open/floor/tile/dark/blue2,
/area/bigredv3/inside/command/highcomm)
"ru" = (
/obj/structure/cable,
/obj/machinery/atmospherics/pipe/simple/green/hidden{
	dir = 10
	},
/turf/open/floor/tile/dark/blue2/corner{
	dir = 1
	},
/area/bigredv3/inside/command/highcomm)
"rv" = (
/obj/structure/cable,
/obj/machinery/atmospherics/pipe/manifold/green/hidden{
	dir = 4
	},
/turf/open/floor/tile/dark,
/area/bigredv3/inside/command/highcomm)
"rI" = (
/obj/machinery/faxmachine,
/obj/structure/table,
/turf/open/floor/tile/dark/blue2{
	dir = 9
	},
/area/bigredv3/inside/command/bridge)
"rM" = (
/obj/structure/bed/chair{
	dir = 1
	},
/turf/open/floor/tile/white,
/area/bigredv3/inside/command/highcomm)
"rV" = (
/obj/structure/cable,
/obj/machinery/atmospherics/pipe/manifold/green/hidden,
/turf/open/floor/tile/dark/blue2,
/area/bigredv3/inside/command/highcomm)
"st" = (
/turf/open/floor/tile/dark/blue2,
/area/bigredv3/inside/command/highcomm)
"sx" = (
/obj/effect/ai_node,
/turf/open/floor/grimy,
/area/bigredv3/inside/command/highcomm)
"sE" = (
/turf/open/floor/grimy,
/area/bigredv3/inside/command/highcomm)
"td" = (
/obj/structure/cable,
/obj/machinery/atmospherics/pipe/simple/green/hidden{
	dir = 5
	},
/obj/effect/ai_node,
/turf/open/floor/tile/dark,
/area/bigredv3/inside/command/highcomm)
"to" = (
/obj/machinery/door/airlock/mainship/generic{
	name = "\improper Operations Bedroom"
	},
/obj/machinery/atmospherics/pipe/simple/green/hidden{
	dir = 4
	},
/turf/open/floor/wood,
/area/bigredv3/inside/command/highcomm)
"tH" = (
/obj/structure/cable,
/obj/machinery/atmospherics/pipe/simple/green/hidden{
	dir = 4
	},
/obj/machinery/light,
/turf/open/floor/tile/dark/blue2,
/area/bigredv3/inside/command/highcomm)
"tP" = (
/obj/structure/bed/chair/office/dark{
	dir = 8
	},
/turf/open/floor/tile/dark,
/area/bigredv3/inside/command/bridge)
"tU" = (
/obj/machinery/light{
	dir = 8
	},
/turf/open/floor/tile/dark,
/area/bigredv3/inside/command/highcomm)
"ud" = (
/obj/machinery/door/airlock/multi_tile/mainship/comdoor/free_access{
	name = "\improper Operations"
	},
/obj/structure/cable,
/obj/machinery/atmospherics/pipe/simple/green/hidden,
/turf/open/floor/tile/dark/blue2{
	dir = 8
	},
/area/bigredv3/inside/command/highcomm)
"uu" = (
/obj/machinery/computer3/server,
/turf/open/floor/tile/dark/blue2{
	dir = 4
	},
/area/bigredv3/inside/command/bridge)
"uI" = (
/obj/machinery/light,
/turf/open/floor/tile/dark/red2{
	dir = 6
	},
/area/bigredv3/inside/security/colarmory)
"uM" = (
/obj/structure/bed/chair,
/turf/open/floor/tile/white,
/area/bigredv3/inside/command/highcomm)
"vf" = (
/obj/machinery/atmospherics/components/unary/vent_pump{
	dir = 8;
	on = 1
	},
/turf/open/floor/grimy,
/area/bigredv3/inside/command/highcomm)
"vM" = (
/obj/structure/rack,
/obj/item/weapon/gun/smg/mp7,
/obj/item/ammo_magazine/smg/mp7,
/obj/item/ammo_magazine/smg/mp7,
/obj/item/ammo_magazine/smg/mp7,
/turf/open/floor/tile/dark/red2{
	dir = 8
	},
/area/bigredv3/inside/security/colarmory)
"wi" = (
/obj/effect/spawner/random/machinery/random_broken_computer/small/comms,
/obj/structure/table,
/turf/open/floor/tile/dark,
/area/bigredv3/inside/command/bridge)
"wq" = (
/obj/structure/cable,
/obj/machinery/atmospherics/pipe/manifold/green/hidden{
	dir = 4
	},
/turf/open/floor/tile/dark/blue2/corner,
/area/bigredv3/inside/command/highcomm)
"xC" = (
/obj/machinery/computer/atmos_alert,
/obj/structure/table,
/turf/open/floor/tile/dark,
/area/bigredv3/inside/command/bridge)
"xL" = (
/turf/open/floor/tile/dark/blue2/corner,
/area/bigredv3/inside/command/highcomm)
"xM" = (
/turf/open/floor/tile/dark/blue2,
/area/bigredv3/inside/command/bridge)
"xT" = (
/obj/machinery/door/airlock/mainship/command/free_access{
	dir = 1;
	name = "\improper Operations Maintenance"
	},
/obj/structure/cable,
/turf/open/floor/plating,
/area/bigredv3/inside/command/highcomm)
"xV" = (
/obj/structure/bed,
/turf/open/floor/wood,
/area/bigredv3/inside/command/highcomm)
"yq" = (
/obj/structure/cable,
/obj/machinery/atmospherics/pipe/manifold/green/hidden,
/obj/machinery/light,
/turf/open/floor/tile/dark/blue2,
/area/bigredv3/inside/command/highcomm)
"yt" = (
/obj/structure/closet/secure_closet/guncabinet/mp_armory,
/turf/open/floor/tile/dark/red2{
	dir = 9
	},
/area/bigredv3/inside/security/colarmory)
"yD" = (
/obj/machinery/light,
/obj/structure/cable,
/turf/open/floor/tile/white,
/area/bigredv3/inside/command/highcomm)
"zl" = (
/obj/structure/cable,
/obj/machinery/atmospherics/pipe/simple/green/hidden,
/turf/open/floor/tile/white,
/area/bigredv3/inside/command/highcomm)
"zC" = (
/obj/structure/cable,
/obj/effect/ai_node,
/turf/open/floor/tile/white,
/area/bigredv3/inside/command/highcomm)
"zQ" = (
/obj/structure/cable,
/obj/machinery/atmospherics/pipe/simple/green/hidden{
	dir = 4
	},
/turf/open/floor/tile/dark/blue2/corner{
	dir = 8
	},
/area/bigredv3/inside/command/highcomm)
"Ag" = (
/obj/structure/closet/secure_closet/guncabinet/mp_armory,
/turf/open/floor/tile/dark/red2{
	dir = 10
	},
/area/bigredv3/inside/security/colarmory)
"Ap" = (
/obj/machinery/computer3/server/rack,
/turf/open/floor/tile/dark,
/area/bigredv3/inside/command/bridge)
"Bc" = (
/obj/machinery/atmospherics/pipe/simple/green/hidden{
	dir = 4
	},
/obj/structure/cable,
/turf/open/floor/tile/dark,
/area/bigredv3/inside/command/bridge)
"Bu" = (
/obj/structure/cable,
/obj/machinery/atmospherics/pipe/simple/green/hidden{
	dir = 4
	},
/turf/open/floor/grimy,
/area/bigredv3/inside/command/highcomm)
"Bz" = (
/obj/machinery/computer3/server/rack,
/turf/open/floor/tile/dark/blue2{
	dir = 1
	},
/area/bigredv3/inside/command/bridge)
"BV" = (
/turf/open/floor/wood,
/area/bigredv3/inside/command/highcomm)
"Cu" = (
/obj/structure/table/wood,
/turf/open/floor/wood,
/area/bigredv3/inside/command/highcomm)
"CY" = (
/obj/machinery/atmospherics/components/unary/vent_pump{
	dir = 4;
	on = 1
	},
/obj/machinery/light{
	dir = 1
	},
/turf/open/floor/wood,
/area/bigredv3/inside/command/highcomm)
"Dq" = (
/obj/structure/cable,
/obj/machinery/atmospherics/pipe/simple/green/hidden{
	dir = 4
	},
/turf/open/floor/tile/dark/blue2{
	dir = 1
	},
/area/bigredv3/inside/command/highcomm)
"Eg" = (
/obj/structure/cable,
/obj/machinery/atmospherics/pipe/manifold/green/hidden{
	dir = 4
	},
/turf/open/floor/tile/dark/blue2{
	dir = 4
	},
/area/bigredv3/inside/command/highcomm)
"Ev" = (
/turf/open/floor/tile/dark/blue2{
	dir = 4
	},
/area/bigredv3/inside/command/highcomm)
"ER" = (
/obj/structure/cable,
/obj/machinery/atmospherics/pipe/simple/green/hidden{
	dir = 9
	},
/turf/open/floor/tile/dark/blue2/corner{
	dir = 1
	},
/area/bigredv3/inside/command/highcomm)
"Fn" = (
/obj/structure/cable,
/obj/machinery/atmospherics/pipe/simple/green/hidden{
	dir = 4
	},
/turf/open/floor/tile/dark/blue2/corner{
	dir = 4
	},
/area/bigredv3/inside/command/highcomm)
"Fx" = (
/obj/machinery/atmospherics/pipe/simple/green/hidden{
	dir = 4
	},
/turf/open/floor/tile/dark,
/area/bigredv3/inside/command/highcomm)
"FS" = (
/obj/structure/window/framed/colony/reinforced,
/obj/machinery/door/poddoor/shutters/mainship{
	id = "Operations";
	name = "\improper Operations Shutters"
	},
/turf/open/floor/plating,
/area/bigredv3/inside/wall)
"Gd" = (
/obj/machinery/door/airlock/mainship/command/free_access{
	name = "\improper Operations Office"
	},
/obj/machinery/atmospherics/pipe/simple/green/hidden{
	dir = 4
	},
/obj/structure/cable,
/turf/open/floor/tile/dark,
/area/bigredv3/inside/command/bridge)
"Go" = (
/obj/structure/rack,
/obj/item/weapon/gun/pistol/highpower,
/obj/item/ammo_magazine/pistol/highpower,
/obj/item/ammo_magazine/pistol/highpower,
/obj/item/ammo_magazine/pistol/highpower,
/turf/open/floor/tile/dark/red2{
	dir = 8
	},
/area/bigredv3/inside/security/colarmory)
"GK" = (
/obj/structure/bed/chair/office/dark,
/turf/open/floor/tile/dark,
/area/bigredv3/inside/command/bridge)
"GM" = (
/obj/structure/table,
/obj/effect/spawner/random/machinery/random_broken_computer/small/comms,
/turf/open/floor/tile/dark/blue2{
	dir = 6
	},
/area/bigredv3/inside/command/bridge)
"GX" = (
/obj/machinery/air_alarm{
	dir = 1
	},
/obj/structure/cable,
/obj/structure/bed/chair{
	dir = 1
	},
/turf/open/floor/tile/white,
/area/bigredv3/inside/command/highcomm)
"Hg" = (
/obj/structure/cable,
/obj/machinery/atmospherics/pipe/simple/green/hidden,
/obj/machinery/light{
	dir = 4
	},
/turf/open/floor/tile/dark/blue2{
	dir = 4
	},
/area/bigredv3/inside/command/highcomm)
"Hx" = (
/obj/machinery/light{
	dir = 8
	},
/turf/open/floor/tile/dark/blue2{
	dir = 8
	},
/area/bigredv3/inside/command/highcomm)
"HW" = (
/obj/machinery/vending/cigarette,
/turf/open/floor/tile/white,
/area/bigredv3/inside/command/highcomm)
"Io" = (
/obj/machinery/door/airlock/mainship/security/glass/free_access{
	name = "\improper Operations Armory"
	},
/obj/machinery/atmospherics/pipe/simple/green/hidden{
	dir = 4
	},
/turf/open/floor/tile/dark,
/area/bigredv3/inside/security/colarmory)
"Ir" = (
/obj/structure/table,
/obj/item/tool/pen/red,
/obj/effect/spawner/random/misc/paperbin,
/turf/open/floor/tile/white,
/area/bigredv3/inside/command/highcomm)
"IN" = (
/obj/machinery/atmospherics/components/unary/vent_pump{
	dir = 4;
	on = 1
	},
/turf/open/floor/tile/dark,
/area/bigredv3/inside/command/bridge)
"Je" = (
/obj/structure/cable,
/obj/machinery/atmospherics/pipe/simple/green/hidden{
	dir = 6
	},
/obj/effect/ai_node,
/turf/open/floor/tile/dark/blue2{
	dir = 9
	},
/area/bigredv3/inside/command/highcomm)
"Jk" = (
/obj/structure/cable,
/obj/machinery/atmospherics/pipe/simple/green/hidden,
/obj/effect/ai_node,
/turf/open/floor/tile/dark/blue2{
	dir = 8
	},
/area/bigredv3/inside/command/highcomm)
"JJ" = (
/obj/machinery/door/airlock/mainship/generic{
	name = "\improper Operations Toilet"
	},
/turf/open/floor/freezer,
/area/bigredv3/inside/command/highcomm)
"JO" = (
/obj/machinery/atmospherics/pipe/simple/green/hidden{
	dir = 4
	},
/turf/open/floor/tile/dark/blue2/corner{
	dir = 1
	},
/area/bigredv3/inside/command/highcomm)
"JS" = (
/obj/machinery/atmospherics/pipe/simple/green/hidden{
	dir = 4
	},
/turf/open/floor/tile/dark/blue2{
	dir = 8
	},
/area/bigredv3/inside/command/highcomm)
"KC" = (
/obj/machinery/atmospherics/pipe/simple/green/hidden,
/obj/structure/cable,
/obj/machinery/door/airlock/multi_tile/mainship/comdoor/free_access{
	name = "\improper Operations"
	},
/turf/open/floor/tile/white,
/area/bigredv3/inside/command/highcomm)
"KL" = (
/obj/machinery/atmospherics/components/unary/vent_pump{
	on = 1
	},
/turf/open/floor/wood,
/area/bigredv3/inside/command/highcomm)
"KP" = (
/obj/structure/cable,
/obj/machinery/atmospherics/pipe/simple/green/hidden,
/turf/open/floor/tile/dark/blue2/corner{
	dir = 8
	},
/area/bigredv3/inside/command/highcomm)
"Lf" = (
/obj/structure/cable,
/obj/machinery/atmospherics/pipe/simple/green/hidden{
	dir = 5
	},
/turf/open/floor/grimy,
/area/bigredv3/inside/command/highcomm)
"Ls" = (
/obj/structure/cable,
/obj/machinery/atmospherics/pipe/simple/green/hidden{
	dir = 4
	},
/obj/machinery/light{
	dir = 1
	},
/turf/open/floor/tile/dark/blue2{
	dir = 1
	},
/area/bigredv3/inside/command/highcomm)
"LB" = (
/obj/effect/ai_node,
/turf/open/floor/tile/dark/blue2{
	dir = 4
	},
/area/bigredv3/inside/command/highcomm)
"LG" = (
/obj/structure/cable,
/obj/machinery/atmospherics/pipe/simple/green/hidden{
	dir = 4
	},
/turf/open/floor/tile/dark/blue2,
/area/bigredv3/inside/command/highcomm)
"Mj" = (
/obj/structure/table/wood,
/obj/machinery/light{
	dir = 8
	},
/turf/open/floor/wood,
/area/bigredv3/inside/command/highcomm)
"Mk" = (
/obj/machinery/photocopier,
/turf/open/floor/tile/dark,
/area/bigredv3/inside/command/bridge)
"Mr" = (
/obj/machinery/photocopier,
/turf/open/floor/tile/dark/blue2{
	dir = 5
	},
/area/bigredv3/inside/command/bridge)
"MG" = (
/obj/structure/cable,
/obj/machinery/atmospherics/pipe/manifold/green/hidden{
	dir = 8
	},
/turf/open/floor/tile/dark/blue2{
	dir = 8
	},
/area/bigredv3/inside/command/highcomm)
"Ni" = (
/turf/open/floor/tile/dark/red2{
	dir = 4
	},
/area/bigredv3/inside/security/colarmory)
"Nq" = (
/obj/structure/cable,
/obj/machinery/atmospherics/pipe/manifold4w/green/hidden,
/obj/effect/ai_node,
/turf/open/floor/tile/dark/blue2/corner,
/area/bigredv3/inside/command/highcomm)
"ND" = (
/obj/machinery/atmospherics/pipe/simple/green/hidden,
/turf/open/floor/tile/dark/blue2{
	dir = 1
	},
/area/bigredv3/inside/command/highcomm)
"NN" = (
/turf/open/floor/tile/dark/blue2/corner{
	dir = 8
	},
/area/bigredv3/inside/command/highcomm)
"NO" = (
/obj/machinery/lapvend,
/turf/open/floor/tile/dark,
/area/bigredv3/inside/command/bridge)
"NW" = (
/obj/structure/bed/chair/office/dark{
	dir = 1
	},
/turf/open/floor/tile/dark,
/area/bigredv3/inside/command/bridge)
"Oa" = (
/obj/structure/toilet,
/obj/machinery/light/small{
	dir = 1
	},
/turf/open/floor/freezer,
/area/bigredv3/inside/command/highcomm)
"Ol" = (
/turf/open/floor/tile/dark/blue2{
	dir = 8
	},
/area/bigredv3/inside/command/highcomm)
"Om" = (
/obj/machinery/light{
	dir = 1
	},
/obj/machinery/power/apc/weak/ntf,
/obj/structure/cable,
/turf/open/floor/tile/dark/blue2{
	dir = 1
	},
/area/bigredv3/inside/command/bridge)
"Or" = (
/obj/machinery/atmospherics/components/unary/vent_pump{
	dir = 4;
	on = 1
	},
/obj/machinery/door_control{
	id = "Operations";
	name = "Storm Shutters"
	},
/turf/open/floor/wood,
/area/bigredv3/inside/command/highcomm)
"OE" = (
/obj/structure/cable,
/obj/machinery/atmospherics/pipe/simple/green/hidden{
	dir = 4
	},
/turf/open/floor/tile/dark/blue2/corner,
/area/bigredv3/inside/command/highcomm)
"OI" = (
/obj/structure/cable,
/obj/machinery/atmospherics/pipe/manifold/green/hidden,
/turf/open/floor/tile/dark/blue2/corner{
	dir = 4
	},
/area/bigredv3/inside/command/highcomm)
"Pb" = (
/obj/structure/bed/chair/office/dark,
/turf/open/floor/tile/dark/blue2{
	dir = 4
	},
/area/bigredv3/inside/command/bridge)
"PQ" = (
/obj/machinery/vending/cola,
/turf/open/floor/tile/white,
/area/bigredv3/inside/command/highcomm)
"Qo" = (
/obj/machinery/vending/snack,
/turf/open/floor/tile/white,
/area/bigredv3/inside/command/highcomm)
"QL" = (
/obj/machinery/atmospherics/pipe/simple/green/hidden,
/turf/open/floor/tile/dark/blue2{
	dir = 8
	},
/area/bigredv3/inside/command/highcomm)
"QX" = (
/obj/machinery/door/airlock/mainship/generic{
	dir = 2;
	name = "\improper Operations Bedroom"
	},
/obj/machinery/atmospherics/pipe/simple/green/hidden,
/turf/open/floor/wood,
/area/bigredv3/inside/command/highcomm)
"Sd" = (
/obj/machinery/light{
	dir = 1
	},
/obj/structure/bed/chair,
/turf/open/floor/tile/white,
/area/bigredv3/inside/command/highcomm)
"Se" = (
/obj/structure/cable,
/obj/machinery/atmospherics/pipe/simple/green/hidden,
/turf/open/floor/tile/dark/blue2/corner{
	dir = 4
	},
/area/bigredv3/inside/command/highcomm)
"Sw" = (
/obj/machinery/atmospherics/components/unary/vent_pump{
	dir = 1;
	on = 1
	},
/turf/open/floor/tile/dark/red2{
	dir = 4
	},
/area/bigredv3/inside/security/colarmory)
"SK" = (
/obj/machinery/atmospherics/pipe/simple/green/hidden{
	dir = 6
	},
/turf/open/floor/tile/dark,
/area/bigredv3/inside/security/colarmory)
"SW" = (
/turf/open/floor/freezer,
/area/bigredv3/inside/command/highcomm)
"Tf" = (
/obj/machinery/light{
	dir = 8
	},
/turf/open/floor/tile/dark/blue2{
	dir = 8
	},
/area/bigredv3/inside/command/bridge)
"Tk" = (
/obj/machinery/door/airlock/multi_tile/mainship/comdoor/free_access{
	dir = 1;
	name = "\improper Operations"
	},
/obj/structure/cable,
/obj/machinery/atmospherics/pipe/simple/green/hidden{
	dir = 4
	},
/turf/open/floor/tile/dark/blue2,
/area/bigredv3/inside/command/highcomm)
"Tt" = (
/obj/machinery/atmospherics/pipe/simple/green/hidden,
/turf/open/floor/tile/dark,
/area/bigredv3/inside/command/highcomm)
"TE" = (
/turf/open/floor/tile/dark/blue2{
	dir = 1
	},
/area/bigredv3/inside/command/highcomm)
"TR" = (
/obj/structure/table,
/turf/open/floor/tile/dark/blue2{
	dir = 8
	},
/area/bigredv3/inside/command/bridge)
"Ue" = (
/obj/structure/table/wood,
/obj/machinery/light,
/turf/open/floor/wood,
/area/bigredv3/inside/command/highcomm)
"UA" = (
/obj/structure/cable,
/obj/machinery/atmospherics/pipe/manifold/green/hidden{
	dir = 8
	},
/obj/effect/ai_node,
/turf/open/floor/grimy,
/area/bigredv3/inside/command/highcomm)
"UC" = (
/obj/structure/table,
/obj/item/tool/pen,
/turf/open/floor/tile/dark/blue2{
	dir = 10
	},
/area/bigredv3/inside/command/bridge)
"UD" = (
/obj/structure/bed/chair,
/obj/machinery/light{
	dir = 1
	},
/turf/open/floor/tile/white,
/area/bigredv3/inside/command/highcomm)
"UL" = (
/obj/structure/table/wood,
/obj/effect/spawner/random/misc/paperbin,
/obj/item/tool/pen,
/obj/machinery/light,
/turf/open/floor/wood,
/area/bigredv3/inside/command/highcomm)
"US" = (
/obj/structure/table,
/turf/open/floor/tile/white,
/area/bigredv3/inside/command/highcomm)
"Va" = (
/obj/structure/table,
/obj/effect/spawner/random/misc/paperbin,
/obj/item/tool/pen,
/obj/machinery/light,
/turf/open/floor/tile/dark/blue2,
/area/bigredv3/inside/command/bridge)
"VB" = (
/obj/structure/cable,
/turf/open/floor/tile/white,
/area/bigredv3/inside/command/highcomm)
"VC" = (
/obj/structure/cable,
/turf/open/floor/tile/dark/blue2{
	dir = 4
	},
/area/bigredv3/inside/command/highcomm)
"VK" = (
/obj/machinery/atmospherics/components/unary/vent_pump{
	dir = 8;
	on = 1
	},
/turf/open/floor/wood,
/area/bigredv3/inside/command/highcomm)
"Xz" = (
/obj/structure/table,
/obj/item/paper,
/turf/open/floor/tile/dark,
/area/bigredv3/inside/command/bridge)
"XA" = (
/obj/effect/ai_node,
/turf/open/floor/tile/dark/blue2{
	dir = 1
	},
/area/bigredv3/inside/command/highcomm)
"XS" = (
/obj/structure/cable,
/obj/machinery/atmospherics/pipe/simple/green/hidden,
/turf/open/floor/grimy,
/area/bigredv3/inside/command/highcomm)
"Yi" = (
/obj/structure/window/framed/colony/reinforced,
/obj/machinery/door/poddoor/shutters/mainship{
	dir = 2;
	id = "Operations";
	name = "\improper Operations Shutters"
	},
/turf/open/floor/plating,
/area/bigredv3/inside/wall)
"Ym" = (
/obj/structure/toilet{
	dir = 4
	},
/obj/machinery/light/small{
	dir = 8
	},
/turf/open/floor/freezer,
/area/bigredv3/inside/command/highcomm)
"Yp" = (
/turf/open/floor/marking/asteroidwarning{
	dir = 1
	},
/area/bigredv3/outside/directions/central)
"YR" = (
/obj/machinery/computer3/server,
/turf/open/floor/tile/dark,
/area/bigredv3/inside/command/bridge)
"Za" = (
/obj/structure/cable,
/obj/machinery/atmospherics/pipe/simple/green/hidden,
/obj/effect/ai_node,
/turf/open/floor/tile/dark/blue2/corner{
	dir = 4
	},
/area/bigredv3/inside/command/highcomm)
"Zj" = (
/obj/machinery/door/airlock/mainship/command/free_access{
	name = "\improper Operations Office"
	},
/obj/machinery/atmospherics/pipe/simple/green/hidden{
	dir = 4
	},
/turf/open/floor/tile/dark,
/area/bigredv3/inside/command/bridge)
"ZW" = (
/turf/open/floor/tile/dark/blue2/corner{
	dir = 1
	},
/area/bigredv3/inside/command/highcomm)

(1,1,1) = {"
Yp
nH
nH
nH
FS
FS
nH
nH
nH
FS
FS
FS
nH
nH
nH
FS
FS
nH
FS
FS
nH
nH
nH
qw
"}
(2,1,1) = {"
nH
nH
PQ
Qo
ad
US
Ir
ep
YR
xC
wi
Xz
YR
ep
ep
xV
eD
ep
xV
eD
ep
Ym
nH
nH
"}
(3,1,1) = {"
nH
uM
ad
sE
sE
sE
US
ep
Ap
tP
tP
cD
nP
ep
ep
CY
Cu
ep
CY
Cu
ep
SW
ep
nH
"}
(4,1,1) = {"
nH
uM
sE
sE
sE
sE
rM
ep
lq
cD
IN
cD
jj
ep
ep
to
ep
ep
to
ep
ep
JJ
ep
nH
"}
(5,1,1) = {"
KC
eA
XS
Lf
sE
sE
ca
ep
kK
NW
fY
cD
NO
ep
Je
rv
nB
MG
rv
nB
nB
td
fc
Yi
"}
(6,1,1) = {"
ad
ad
sE
nO
kX
sE
rM
ep
nt
NW
ja
cD
Mk
ep
Dq
xL
Ev
Fx
cK
Ev
Ev
Fn
st
Yi
"}
(7,1,1) = {"
nH
uM
sE
Bu
sx
sE
rM
ep
ep
ep
Zj
ep
ep
ep
Dq
st
ep
to
ep
ep
ep
Dq
st
nH
"}
(8,1,1) = {"
nH
UD
gj
gk
XS
UA
zl
ud
Jk
Jk
rv
nB
nB
MG
oG
st
ep
VK
BV
UL
ep
Dq
st
nH
"}
(9,1,1) = {"
Yi
uM
sE
vf
sE
Bu
ad
Ev
py
xL
Ev
cK
Ev
iy
Ev
eX
ep
xV
BV
eD
ep
Ls
st
nH
"}
(10,1,1) = {"
Yi
gQ
sE
sE
sE
Bu
US
ep
cd
qy
ep
ep
ep
Gd
ep
ep
ep
ep
ep
ep
ep
Dq
st
nH
"}
(11,1,1) = {"
nH
ht
ad
ad
ad
ab
US
ep
TE
st
ep
rI
Tf
Bc
TR
UC
ep
oS
hG
QL
QL
ER
st
Yi
"}
(12,1,1) = {"
nH
ep
ep
ep
TE
Tk
ep
ep
TE
st
ep
Bz
cD
Bc
tP
Va
ep
XA
OE
VC
VC
if
eX
Yi
"}
(13,1,1) = {"
Yi
eD
Mj
ep
TE
LG
ep
oS
ZW
st
ep
Om
fe
ph
GK
xM
ep
pc
LG
ep
ep
ep
ep
nH
"}
(14,1,1) = {"
Yi
xV
KL
QX
Tt
rV
ep
TE
xL
eX
ep
Mr
uu
mv
Pb
GM
ep
XA
jz
xT
zC
VB
VB
nH
"}
(15,1,1) = {"
nH
ep
ep
ep
TE
LG
ep
pc
st
ep
ep
ep
ep
ep
ep
ep
ep
TE
LG
ep
Sd
US
cH
nH
"}
(16,1,1) = {"
Yi
eD
Mj
ep
cd
tH
ep
TE
st
ep
yt
vM
vM
Go
Go
Ag
ep
TE
LG
ep
uM
US
GX
nH
"}
(17,1,1) = {"
Yi
xV
KL
QX
Tt
rV
ep
TE
st
ep
fP
Ni
SK
Sw
Ni
uI
ep
TE
LG
ep
uM
US
qq
nH
"}
(18,1,1) = {"
nH
ep
ep
ep
TE
LG
ep
TE
st
ep
ep
ep
Io
ep
ep
ep
ep
pc
LG
ep
hn
VB
yD
nH
"}
(19,1,1) = {"
Yi
eD
Mj
ep
TE
zQ
Ol
ZW
NN
Hx
Ol
Ol
JS
mF
Ol
Hx
Ol
ZW
LG
ep
HW
VB
PQ
nH
"}
(20,1,1) = {"
Yi
xV
KL
QX
Tt
Nq
dq
dq
iT
Hg
dq
dq
Eg
Se
dV
Za
ea
iT
ir
fb
la
zC
Qo
nH
"}
(21,1,1) = {"
nH
ep
ep
ep
TE
LG
ep
ep
ep
ep
ep
ep
ep
pc
st
TE
tH
ep
ep
ep
ep
ep
ep
nH
"}
(22,1,1) = {"
Yi
eD
Mj
ep
mF
LG
ep
xV
eD
ep
xV
eD
ep
TE
st
TE
LG
ep
xV
eD
ep
xV
eD
nH
"}
(23,1,1) = {"
Yi
xV
KL
QX
ND
yq
ep
Or
Ue
ep
dZ
Ue
ep
TE
st
TE
LG
ep
Or
Ue
ep
dZ
Ue
nH
"}
(24,1,1) = {"
nH
ep
ep
ep
TE
LG
ep
to
ep
ep
to
ep
ep
pc
st
TE
tH
ep
to
ep
ep
to
ep
nH
"}
(25,1,1) = {"
Yi
eD
Mj
ep
mF
zQ
Ol
Fx
Ol
Hx
Fx
Ol
Ol
ZW
st
TE
zQ
Ol
JS
tU
Ol
JO
st
nH
"}
(26,1,1) = {"
Yi
xV
KL
QX
ND
wq
dq
Eg
dq
dq
Eg
dq
dq
dq
av
nF
Eg
dq
Eg
dq
dq
OI
st
nH
"}
(27,1,1) = {"
nH
ep
ep
ep
TE
NN
Ol
Ol
Ol
Ol
Ol
Ol
Ol
Ol
Ol
Ol
Ol
Ol
Ol
Ol
Ol
ru
KP
ud
"}
(28,1,1) = {"
nH
Oa
SW
be
mF
LB
Ev
Ev
Ev
Ev
LB
cK
Ev
Ev
Ev
LB
Ev
Ev
cK
Ev
Ev
Ev
Ev
Ev
"}
(29,1,1) = {"
nH
nH
nH
nH
nH
nH
nH
nH
FS
FS
nH
nH
nH
FS
FS
FS
FS
nH
nH
nH
FS
FS
nH
nH
"}
