//MAP CONVERTED BY dmm2tgm.py THIS HEADER COMMENT PREVENTS RECONVERSION, DO NOT REMOVE
"b" = (
/turf/open/floor/plating/ground/mars/random/cave/rock,
/area/bigredv3/caves/south/garbledradio)
"c" = (
/turf/open/floor/plating/ground/mars/random/cave/rock,
/area/bigredv3/caves/southwest)
"d" = (
/obj/effect/ai_node,
/turf/open/floor/plating/ground/mars/random/cave,
/area/bigredv3/caves/south/garbledradio)
"h" = (
/obj/effect/ai_node,
/turf/open/floor/plating/ground/mars/random/cave/rock,
/area/bigredv3/caves/southwest)
"i" = (
/obj/effect/landmark/lv624/fog_blocker,
/turf/closed/mineral/smooth/bigred,
/area/bigredv3/caves/rock)
"j" = (
/turf/closed/mineral/smooth/bigred,
/area/bigredv3/caves/rock)
"l" = (
/obj/effect/landmark/lv624/fog_blocker,
/turf/open/floor/plating/ground/mars/random/cave/rock,
/area/bigredv3/caves/southwest)
"q" = (
/obj/effect/ai_node,
/turf/open/floor/plating/ground/mars/random/cave,
/area/bigredv3/caves/southwest)
"s" = (
/turf/open/floor/plating/ground/mars/random/cave,
/area/bigredv3/caves/southwest)
"u" = (
/turf/open/floor/plating/ground/mars/random/cave,
/area/bigredv3/caves/south)
"x" = (
/turf/closed/wall/r_wall,
/area/bigredv3/inside/wall)
"y" = (
/obj/structure/fence/standard/xenoproof,
/turf/open/floor/plating/ground/mars/random/cave,
/area/bigredv3/caves/south/garbledradio)
"A" = (
/turf/open/floor/plating/ground/mars/random/cave,
/area/bigredv3/caves/south/garbledradio)
"E" = (
/obj/effect/ai_node,
/turf/open/floor/plating/ground/mars/random/cave/rock,
/area/bigredv3/caves/south/garbledradio)
"I" = (
/obj/effect/landmark/lv624/fog_blocker,
/turf/closed/wall/r_wall,
/area/bigredv3/inside/wall)
"L" = (
/obj/structure/fence/standard/xenoproof,
/turf/open/floor/plating/ground/mars/random/cave,
/area/bigredv3/caves/southwest)
"N" = (
/obj/effect/landmark/lv624/fog_blocker,
/turf/open/floor/plating/ground/mars/random/cave,
/area/bigredv3/caves/southwest)
"T" = (
/obj/structure/fence/standard/xenoproof,
/turf/open/floor/plating/ground/mars/random/cave/rock,
/area/bigredv3/caves/south/garbledradio)
"V" = (
/obj/structure/fence/standard/xenoproof,
/turf/open/floor/plating/ground/mars/random/cave/rock,
/area/bigredv3/caves/southwest)
"W" = (
/obj/effect/ai_node,
/turf/open/floor/plating/ground/mars/random/cave,
/area/bigredv3/caves/south)

(1,1,1) = {"
i
j
j
j
j
j
c
s
s
s
c
j
j
j
j
s
s
j
j
j
j
j
"}
(2,1,1) = {"
N
j
j
j
j
j
j
s
q
s
c
j
j
j
j
s
s
s
j
j
j
j
"}
(3,1,1) = {"
N
j
j
j
j
j
j
s
s
s
c
j
j
j
c
s
s
j
j
j
j
j
"}
(4,1,1) = {"
N
j
j
j
j
j
s
s
s
s
c
j
j
j
c
s
s
j
j
j
j
j
"}
(5,1,1) = {"
N
c
j
j
j
j
s
s
s
s
s
j
j
c
s
s
s
j
j
j
j
j
"}
(6,1,1) = {"
N
c
j
j
c
V
s
s
s
s
s
j
j
s
s
q
j
j
j
j
j
j
"}
(7,1,1) = {"
N
s
x
h
s
L
s
s
q
s
s
s
s
s
q
j
j
j
j
j
j
j
"}
(8,1,1) = {"
N
s
x
c
s
L
s
s
s
s
s
s
s
s
s
j
j
j
j
j
j
j
"}
(9,1,1) = {"
N
c
x
s
s
L
s
j
j
j
s
s
s
s
s
j
j
j
j
j
j
j
"}
(10,1,1) = {"
l
s
x
q
j
j
j
j
j
j
j
s
s
s
s
j
j
s
j
j
j
j
"}
(11,1,1) = {"
i
j
j
j
j
j
j
j
j
j
j
j
s
s
s
s
s
s
j
j
j
j
"}
(12,1,1) = {"
j
i
j
j
j
j
j
j
j
j
j
j
s
s
s
s
s
s
j
j
j
j
"}
(13,1,1) = {"
j
j
i
i
j
j
j
j
j
j
j
j
s
s
s
s
s
j
j
j
j
j
"}
(14,1,1) = {"
j
j
j
j
i
j
j
j
j
j
j
j
s
s
s
s
j
j
j
j
j
j
"}
(15,1,1) = {"
j
j
j
j
j
i
j
j
j
j
j
j
j
s
s
c
j
j
j
j
j
j
"}
(16,1,1) = {"
j
j
j
j
j
j
i
j
j
j
j
j
j
s
q
c
c
j
j
j
j
j
"}
(17,1,1) = {"
s
j
j
j
j
j
i
j
j
j
j
j
j
s
c
c
j
j
j
j
j
j
"}
(18,1,1) = {"
s
q
j
j
j
j
i
j
j
j
j
j
j
s
s
s
j
j
j
j
j
j
"}
(19,1,1) = {"
s
s
j
j
j
j
i
j
j
j
j
j
s
s
s
s
s
j
j
j
j
j
"}
(20,1,1) = {"
c
s
j
j
j
j
i
j
j
j
s
s
s
s
s
c
s
j
j
j
j
j
"}
(21,1,1) = {"
c
s
s
j
j
j
i
j
j
j
s
s
s
s
s
c
s
j
j
j
j
j
"}
(22,1,1) = {"
s
s
s
s
s
s
I
j
j
j
s
s
s
s
s
j
j
j
j
j
j
j
"}
(23,1,1) = {"
s
s
s
s
s
s
I
s
s
j
s
s
s
s
s
j
j
j
j
j
j
j
"}
(24,1,1) = {"
s
s
s
s
s
s
I
s
s
L
s
s
s
s
s
j
j
j
j
j
j
j
"}
(25,1,1) = {"
s
s
s
s
s
j
i
s
s
L
s
c
s
s
q
s
j
j
j
j
j
j
"}
(26,1,1) = {"
A
A
A
A
A
j
i
j
j
y
A
A
A
b
A
A
j
j
j
j
j
j
"}
(27,1,1) = {"
A
d
A
A
A
j
i
j
j
j
j
j
A
A
A
A
A
j
j
j
j
j
"}
(28,1,1) = {"
b
A
A
A
A
j
i
j
j
j
j
j
j
A
A
A
A
A
A
j
j
j
"}
(29,1,1) = {"
b
A
A
A
A
j
i
j
j
j
j
j
j
A
d
b
A
d
A
A
j
j
"}
(30,1,1) = {"
A
A
A
A
A
j
i
j
j
j
j
j
j
j
A
A
A
A
A
A
A
j
"}
(31,1,1) = {"
A
A
A
A
A
j
i
j
j
j
j
j
j
j
j
A
A
A
A
A
A
j
"}
(32,1,1) = {"
A
A
A
A
A
j
i
j
j
j
j
j
j
j
j
A
A
A
A
A
A
u
"}
(33,1,1) = {"
A
A
A
A
A
j
i
j
j
j
j
j
j
j
j
j
A
A
A
A
u
u
"}
(34,1,1) = {"
b
A
A
A
j
j
i
j
j
j
j
j
j
j
j
j
j
d
A
A
W
u
"}
(35,1,1) = {"
b
A
A
A
j
j
i
j
j
j
j
j
j
j
j
j
j
A
A
A
b
u
"}
(36,1,1) = {"
b
A
A
A
j
j
i
j
j
j
j
j
j
j
j
j
j
j
A
A
A
u
"}
(37,1,1) = {"
A
A
A
A
j
j
i
j
j
j
j
j
j
j
j
j
j
j
A
A
A
u
"}
(38,1,1) = {"
A
d
A
A
j
j
i
j
j
j
j
j
j
j
j
j
j
A
A
A
u
u
"}
(39,1,1) = {"
A
A
A
j
j
j
i
j
j
j
j
j
j
j
j
A
A
A
A
A
u
u
"}
(40,1,1) = {"
A
A
A
j
j
j
i
j
j
j
j
j
j
j
A
A
A
A
A
A
d
u
"}
(41,1,1) = {"
A
A
A
j
j
j
i
j
j
j
j
j
j
A
A
A
A
A
E
A
A
W
"}
(42,1,1) = {"
A
A
j
j
j
j
i
j
j
j
j
j
A
A
A
A
A
A
A
A
A
u
"}
(43,1,1) = {"
A
j
j
j
j
j
i
j
j
j
j
A
d
A
b
d
A
A
d
b
j
j
"}
(44,1,1) = {"
j
j
j
j
j
j
i
j
j
j
j
j
y
T
y
y
y
T
j
j
j
j
"}
