//MAP CONVERTED BY dmm2tgm.py THIS HEADER COMMENT PREVENTS RECONVERSION, DO NOT REMOVE
"ae" = (
/obj/effect/decal/cleanable/dirt,
/turf/open/floor/asteroidfloor,
/area/bigredv3/outside/directions/nw)
"cd" = (
/obj/structure/cargo_container/ch_red,
/turf/open/floor/plating,
/area/bigredv3/outside/directions/nw)
"cS" = (
/obj/effect/ai_node,
/turf/open/floor/plating/ground/mars/random/dirt,
/area/bigredv3/outside/medical/virology)
"dr" = (
/obj/machinery/light{
	dir = 1
	},
/turf/open/floor/plating/ground/mars/random/dirt,
/area/bigredv3/outside/medical/virology)
"dv" = (
/obj/machinery/atmospherics/pipe/simple/green/hidden{
	dir = 10
	},
/obj/structure/cable,
/turf/open/floor/asteroidfloor,
/area/bigredv3/outside/directions/nw)
"eR" = (
/obj/effect/ai_node,
/turf/open/floor/plating/ground/mars/random/cave/rock,
/area/bigredv3/caves/west)
"ft" = (
/turf/open/floor/asteroidfloor,
/area/bigredv3/outside/medical/virology)
"fv" = (
/turf/open/floor/marking/asteroidwarning{
	dir = 5
	},
/area/bigredv3/outside/directions/nw)
"fV" = (
/turf/open/floor/marking/asteroidwarning{
	dir = 4
	},
/area/bigredv3/outside/directions/nw)
"fY" = (
/obj/structure/cable,
/obj/machinery/atmospherics/pipe/simple/green/hidden{
	dir = 4
	},
/turf/open/floor/marking/asteroidwarning{
	dir = 1
	},
/area/bigredv3/outside/directions/nw)
"gv" = (
/obj/effect/ai_node,
/turf/open/floor/plating,
/area/bigredv3/outside/directions/nw)
"hs" = (
/obj/structure/cable,
/obj/machinery/atmospherics/pipe/simple/green/hidden{
	dir = 4
	},
/obj/effect/ai_node,
/obj/effect/decal/cleanable/dirt,
/turf/open/floor/plating,
/area/bigredv3/outside/directions/nw)
"hQ" = (
/turf/open/floor/plating/ground/mars/dirttosand/autosmooth{
	dir = 5
	},
/area/bigredv3/outside/medical/virology)
"hU" = (
/obj/effect/decal/cleanable/dirt,
/obj/structure/cable,
/obj/machinery/atmospherics/pipe/simple/green/hidden{
	dir = 5
	},
/turf/open/floor/asteroidfloor,
/area/bigredv3/outside/directions/nw)
"iJ" = (
/obj/machinery/light{
	dir = 1
	},
/turf/open/floor/plating,
/area/bigredv3/outside/directions/nw)
"iL" = (
/obj/structure/fence/standard/xenoproof,
/turf/open/floor/plating/ground/mars/cavetodirt{
	dir = 4
	},
/area/bigredv3/caves/west)
"iP" = (
/turf/open/floor/plating/ground/mars/dirttosand/autosmooth{
	dir = 1
	},
/area/bigredv3/outside/directions/nw)
"jr" = (
/turf/open/floor/plating/ground/mars/dirttosand/autosmooth{
	dir = 6
	},
/area/bigredv3/outside/directions/nw)
"jt" = (
/obj/machinery/atmospherics/pipe/simple/green/hidden,
/obj/structure/cable,
/turf/open/floor/marking/asteroidwarning{
	dir = 4
	},
/area/bigredv3/outside/directions/nw)
"kT" = (
/turf/open/floor/marking/asteroidwarning,
/area/bigredv3/outside/directions/nw)
"ld" = (
/obj/effect/ai_node,
/obj/effect/decal/cleanable/dirt,
/turf/open/floor/plating,
/area/bigredv3/outside/directions/nw)
"lT" = (
/obj/effect/ai_node,
/turf/open/floor/plating/ground/mars/random/cave,
/area/bigredv3/caves/northwest)
"md" = (
/obj/structure/cargo_container/horizontal{
	dir = 1
	},
/turf/open/floor/plating,
/area/bigredv3/outside/directions/nw)
"mn" = (
/obj/structure/cable,
/obj/machinery/atmospherics/pipe/simple/green/hidden{
	dir = 4
	},
/turf/open/floor/plating,
/area/bigredv3/outside/directions/nw)
"mC" = (
/obj/structure/cable,
/obj/machinery/atmospherics/pipe/simple/green/hidden,
/turf/open/floor/marking/asteroidwarning{
	dir = 4
	},
/area/bigredv3/outside/directions/nw)
"mP" = (
/obj/machinery/atmospherics/pipe/simple/green/hidden,
/obj/structure/cable,
/turf/open/floor/plating,
/area/bigredv3/outside/directions/nw)
"nl" = (
/obj/machinery/light{
	dir = 1
	},
/turf/open/floor/plating/ground/mars/random/sand,
/area/bigredv3/outside/medical/virology)
"nK" = (
/obj/machinery/light{
	dir = 4
	},
/turf/open/floor/marking/asteroidwarning{
	dir = 1
	},
/area/bigredv3/outside/medical/virology)
"nM" = (
/obj/effect/ai_node,
/obj/machinery/light,
/turf/open/floor/plating,
/area/bigredv3/outside/directions/nw)
"od" = (
/turf/closed/mineral/smooth/bigred/indestructible,
/area/space)
"oH" = (
/turf/open/floor/plating/ground/mars/random/sand,
/area/bigredv3/caves/northwest)
"oO" = (
/obj/effect/turf_decal/sandedge,
/turf/open/floor/plating/ground/mars/random/sand,
/area/bigredv3/caves/northwest)
"oW" = (
/turf/open/floor/marking/asteroidwarning{
	dir = 6
	},
/area/bigredv3/outside/directions/nw)
"pc" = (
/obj/effect/decal/cleanable/dirt,
/turf/open/floor/marking/asteroidwarning{
	dir = 10
	},
/area/bigredv3/outside/directions/nw)
"pM" = (
/obj/effect/decal/cleanable/dirt,
/obj/effect/ai_node,
/turf/open/floor/plating,
/area/bigredv3/outside/directions/nw)
"pX" = (
/obj/effect/decal/cleanable/dirt,
/turf/open/floor/marking/asteroidwarning{
	dir = 1
	},
/area/bigredv3/outside/directions/nw)
"qw" = (
/obj/structure/cable,
/turf/open/floor/plating,
/area/bigredv3/outside/directions/nw)
"qN" = (
/obj/effect/ai_node,
/turf/open/floor/asteroidfloor,
/area/bigredv3/outside/directions/nw)
"qY" = (
/obj/effect/ai_node,
/turf/open/floor/marking/asteroidwarning{
	dir = 9
	},
/area/bigredv3/outside/directions/nw)
"rR" = (
/obj/effect/decal/cleanable/dirt,
/turf/open/floor/plating,
/area/bigredv3/outside/directions/nw)
"sr" = (
/obj/structure/cable,
/obj/machinery/atmospherics/pipe/simple/green/hidden{
	dir = 6
	},
/turf/open/floor/marking/asteroidwarning{
	dir = 4
	},
/area/bigredv3/outside/directions/nw)
"sI" = (
/obj/machinery/atmospherics/pipe/simple/green/hidden{
	dir = 4
	},
/obj/structure/cable,
/obj/effect/decal/cleanable/dirt,
/turf/open/floor/plating,
/area/bigredv3/outside/directions/nw)
"sN" = (
/obj/machinery/atmospherics/pipe/manifold/green/hidden,
/obj/structure/cable,
/turf/open/floor/plating,
/area/bigredv3/outside/directions/nw)
"sV" = (
/obj/structure/cargo_container/ch_red{
	dir = 1
	},
/turf/open/floor/plating,
/area/bigredv3/outside/directions/nw)
"tk" = (
/obj/effect/ai_node,
/turf/open/floor/plating/ground/mars/random/cave,
/area/bigredv3/caves/west)
"tt" = (
/turf/open/floor/plating/ground/mars/cavetodirt{
	dir = 6
	},
/area/bigredv3/caves/west)
"tS" = (
/obj/effect/ai_node,
/turf/open/floor/marking/asteroidwarning{
	dir = 1
	},
/area/bigredv3/outside/medical/virology)
"ug" = (
/turf/open/floor/plating/ground/mars/dirttosand/autosmooth{
	dir = 4
	},
/area/bigredv3/outside/directions/nw)
"uh" = (
/obj/effect/ai_node,
/turf/open/floor/plating/ground/mars/random/dirt,
/area/bigredv3/outside/directions/nw)
"up" = (
/obj/machinery/light{
	dir = 8
	},
/turf/open/floor/plating,
/area/bigredv3/outside/directions/nw)
"uP" = (
/obj/structure/cargo_container/hd_blue{
	dir = 4
	},
/turf/open/floor/plating,
/area/bigredv3/outside/directions/nw)
"uS" = (
/obj/structure/fence/standard/xenoproof,
/turf/open/floor/plating/ground/mars/random/cave,
/area/bigredv3/caves/west)
"uU" = (
/obj/effect/ai_node,
/turf/open/floor/plating/warning{
	dir = 1
	},
/area/bigredv3/outside/directions/nw)
"vq" = (
/obj/effect/decal/cleanable/dirt,
/turf/open/floor/marking/asteroidwarning{
	dir = 8
	},
/area/bigredv3/outside/directions/nw)
"vB" = (
/obj/effect/decal/cleanable/dirt,
/turf/open/floor/plating/warning{
	dir = 8
	},
/area/bigredv3/outside/directions/nw)
"vU" = (
/turf/open/floor/plating/ground/mars/random/dirt,
/area/bigredv3/caves/west)
"wt" = (
/turf/open/floor/marking/asteroidwarning{
	dir = 1
	},
/area/bigredv3/outside/directions/nw)
"wA" = (
/obj/effect/decal/cleanable/dirt,
/turf/open/floor/marking/asteroidwarning,
/area/bigredv3/outside/directions/nw)
"wT" = (
/turf/open/floor/plating/ground/mars/dirttosand/autosmooth,
/area/bigredv3/outside/directions/nw)
"xn" = (
/turf/open/floor/plating/warning{
	dir = 1
	},
/area/bigredv3/outside/directions/nw)
"xA" = (
/turf/open/floor/plating/ground/mars/dirttosand/autosmooth{
	dir = 9
	},
/area/bigredv3/outside/medical/virology)
"xF" = (
/turf/open/floor/marking/asteroidwarning{
	dir = 10
	},
/area/bigredv3/outside/directions/nw)
"xP" = (
/turf/open/floor/plating/ground/mars/random/dirt,
/area/bigredv3/outside/medical/virology)
"ya" = (
/turf/open/floor/plating/ground/mars/dirttosand/autosmooth{
	dir = 9
	},
/area/bigredv3/outside/directions/nw)
"yh" = (
/turf/open/floor/plating/ground/mars/random/cave,
/area/bigredv3/caves/west)
"ym" = (
/obj/structure/cargo_container/hd,
/turf/open/floor/plating,
/area/bigredv3/outside/directions/nw)
"yx" = (
/obj/machinery/atmospherics/pipe/simple/green/hidden,
/obj/structure/cable,
/turf/open/floor/asteroidfloor,
/area/bigredv3/outside/directions/nw)
"zo" = (
/obj/machinery/atmospherics/pipe/simple/green/hidden{
	dir = 4
	},
/obj/structure/cable,
/obj/effect/ai_node,
/obj/effect/decal/cleanable/dirt,
/turf/open/floor/plating,
/area/bigredv3/outside/directions/nw)
"An" = (
/obj/effect/ai_node,
/turf/open/floor/marking/asteroidwarning{
	dir = 8
	},
/area/bigredv3/outside/directions/nw)
"AG" = (
/turf/open/floor/marking/asteroidwarning{
	dir = 1
	},
/area/bigredv3/outside/medical/virology)
"Bk" = (
/obj/effect/decal/cleanable/blood,
/turf/open/floor/plating/ground/mars/random/sand,
/area/bigredv3/outside/directions/nw)
"BF" = (
/turf/closed/wall/r_wall,
/area/bigredv3/inside/wall)
"BV" = (
/obj/machinery/atmospherics/pipe/simple/green/hidden{
	dir = 4
	},
/obj/structure/cable,
/turf/open/floor/plating,
/area/bigredv3/outside/directions/nw)
"Cq" = (
/turf/open/floor/plating/ground/mars/random/sand,
/area/bigredv3/outside/medical/virology)
"Dr" = (
/obj/structure/cargo_container/hd{
	dir = 4
	},
/turf/open/floor/plating,
/area/bigredv3/outside/directions/nw)
"DV" = (
/turf/open/floor/marking/asteroidwarning{
	dir = 9
	},
/area/bigredv3/outside/medical/virology)
"Eh" = (
/turf/open/floor/plating/ground/mars/random/cave/rock,
/area/bigredv3/caves/northwest)
"EC" = (
/obj/machinery/light{
	dir = 8
	},
/turf/open/floor/marking/asteroidwarning{
	dir = 1
	},
/area/bigredv3/outside/directions/nw)
"Fh" = (
/obj/machinery/floodlight/outpost/bigred,
/turf/open/floor/plating/ground/mars/random/sand,
/area/bigredv3/outside/directions/nw)
"FB" = (
/obj/structure/cargo_container/hd_blue{
	dir = 1
	},
/turf/open/floor/plating,
/area/bigredv3/outside/directions/nw)
"Gb" = (
/obj/machinery/atmospherics/pipe/simple/green/hidden{
	dir = 4
	},
/obj/structure/cable,
/obj/effect/ai_node,
/turf/open/floor/plating,
/area/bigredv3/outside/directions/nw)
"HB" = (
/obj/effect/decal/cleanable/dirt,
/turf/open/floor/marking/asteroidwarning{
	dir = 4
	},
/area/bigredv3/outside/directions/nw)
"Jy" = (
/turf/open/floor/plating/ground/mars/random/cave,
/area/bigredv3/caves/northwest)
"JY" = (
/turf/open/floor/plating,
/area/bigredv3/outside/directions/nw)
"JZ" = (
/obj/machinery/power/apc/weak/ntf,
/obj/structure/cable,
/turf/open/floor/plating,
/area/bigredv3/outside/directions/nw)
"Le" = (
/obj/structure/cargo_container/hd_blue,
/turf/open/floor/plating,
/area/bigredv3/outside/directions/nw)
"Lp" = (
/obj/structure/cable,
/obj/machinery/atmospherics/pipe/simple/green/hidden{
	dir = 4
	},
/obj/effect/decal/cleanable/dirt,
/turf/open/floor/plating/warning{
	dir = 8
	},
/area/bigredv3/outside/directions/nw)
"Lu" = (
/turf/open/floor/tile/white,
/area/bigredv3/inside/medical/central)
"LS" = (
/obj/structure/cable,
/obj/machinery/atmospherics/pipe/simple/green/hidden{
	dir = 4
	},
/obj/effect/ai_node,
/turf/open/floor/plating,
/area/bigredv3/outside/directions/nw)
"LW" = (
/turf/open/floor/marking/asteroidwarning{
	dir = 8
	},
/area/bigredv3/outside/directions/nw)
"Md" = (
/turf/open/floor/plating/ground/mars/random/dirt,
/area/bigredv3/outside/directions/nw)
"Mj" = (
/turf/open/floor/plating/ground/mars/dirttosand/autosmooth{
	dir = 5
	},
/area/bigredv3/outside/directions/nw)
"MB" = (
/turf/open/floor/plating/ground/mars/random/cave/rock,
/area/bigredv3/caves/west)
"MV" = (
/obj/structure/cargo_container/hd{
	dir = 1
	},
/turf/open/floor/plating,
/area/bigredv3/outside/directions/nw)
"MX" = (
/turf/open/floor/asteroidfloor,
/area/bigredv3/outside/directions/nw)
"Nk" = (
/obj/machinery/atmospherics/pipe/simple/green/hidden{
	dir = 4
	},
/obj/structure/cable,
/turf/open/floor/tile/white,
/area/bigredv3/inside/medical/central)
"NQ" = (
/obj/effect/ai_node,
/turf/open/floor/plating/ground/mars/random/sand,
/area/bigredv3/outside/directions/nw)
"OG" = (
/obj/effect/decal/cleanable/dirt,
/turf/open/floor/marking/asteroidwarning{
	dir = 6
	},
/area/bigredv3/outside/directions/nw)
"OK" = (
/obj/structure/cargo_container/horizontal{
	dir = 2
	},
/turf/open/floor/plating,
/area/bigredv3/outside/directions/nw)
"OQ" = (
/obj/machinery/atmospherics/pipe/simple/green/hidden,
/obj/structure/cable,
/turf/open/floor/marking/asteroidwarning,
/area/bigredv3/outside/directions/nw)
"Pp" = (
/obj/machinery/atmospherics/pipe/simple/green/hidden{
	dir = 4
	},
/obj/structure/cable,
/obj/machinery/door/airlock/multi_tile/mainship/medidoor{
	dir = 1;
	name = "\improper Medical Clinic"
	},
/turf/open/floor/tile/white,
/area/bigredv3/inside/medical/central)
"Pw" = (
/obj/machinery/atmospherics/pipe/simple/green/hidden,
/obj/structure/cable,
/turf/open/floor/plating/warning{
	dir = 1
	},
/area/bigredv3/outside/directions/nw)
"PF" = (
/obj/machinery/atmospherics/pipe/simple/green/hidden,
/obj/structure/cable,
/obj/effect/ai_node,
/turf/open/floor/marking/asteroidwarning{
	dir = 1
	},
/area/bigredv3/outside/directions/nw)
"PJ" = (
/turf/open/floor/plating/ground/mars/dirttosand/autosmooth{
	dir = 10
	},
/area/bigredv3/outside/directions/nw)
"PN" = (
/obj/machinery/atmospherics/pipe/simple/green/hidden{
	dir = 4
	},
/obj/structure/cable,
/turf/open/floor/asteroidfloor,
/area/bigredv3/outside/directions/nw)
"PT" = (
/obj/machinery/light,
/turf/open/floor/plating,
/area/bigredv3/outside/directions/nw)
"QC" = (
/obj/structure/cargo_container/horizontal{
	dir = 4
	},
/turf/open/floor/plating,
/area/bigredv3/outside/directions/nw)
"QK" = (
/turf/open/floor/marking/asteroidwarning{
	dir = 9
	},
/area/bigredv3/outside/directions/nw)
"Rm" = (
/turf/open/floor/marking/asteroidwarning{
	dir = 8
	},
/area/bigredv3/outside/medical/virology)
"Ro" = (
/turf/closed/mineral/smooth/bigred,
/area/bigredv3/caves/rock)
"RJ" = (
/obj/machinery/atmospherics/pipe/simple/green/hidden{
	dir = 4
	},
/obj/structure/cable,
/turf/open/floor/marking/asteroidwarning{
	dir = 8
	},
/area/bigredv3/outside/directions/nw)
"RO" = (
/turf/open/floor/plating/ground/mars/random/sand,
/area/bigredv3/outside/directions/nw)
"RQ" = (
/obj/effect/decal/cleanable/dirt,
/obj/effect/ai_node,
/turf/open/floor/marking/asteroidwarning{
	dir = 9
	},
/area/bigredv3/outside/directions/nw)
"RT" = (
/obj/structure/cargo_container/ch_red{
	dir = 4
	},
/turf/open/floor/plating,
/area/bigredv3/outside/directions/nw)
"Sk" = (
/obj/effect/decal/cleanable/dirt,
/obj/effect/ai_node,
/turf/open/floor/marking/asteroidwarning{
	dir = 8
	},
/area/bigredv3/outside/directions/nw)
"UY" = (
/obj/effect/turf_decal/sandedge/corner2,
/turf/open/floor/plating/ground/mars/random/sand,
/area/bigredv3/caves/northwest)
"Vq" = (
/obj/machinery/atmospherics/pipe/simple/green/hidden{
	dir = 4
	},
/obj/structure/cable,
/turf/open/floor/marking/asteroidwarning{
	dir = 1
	},
/area/bigredv3/outside/directions/nw)
"Wn" = (
/obj/effect/ai_node,
/turf/open/floor/marking/asteroidwarning{
	dir = 4
	},
/area/bigredv3/outside/directions/nw)
"Wq" = (
/turf/closed/wall,
/area/bigredv3/inside/wall)
"Xm" = (
/obj/structure/cable,
/obj/machinery/atmospherics/pipe/simple/green/hidden,
/obj/effect/ai_node,
/turf/open/floor/marking/asteroidwarning{
	dir = 4
	},
/area/bigredv3/outside/directions/nw)
"Xq" = (
/turf/open/floor/plating/warning{
	dir = 8
	},
/area/bigredv3/outside/directions/nw)
"XG" = (
/turf/open/floor/plating/ground/mars/dirttosand/autosmooth{
	dir = 8
	},
/area/bigredv3/outside/directions/nw)
"Yf" = (
/obj/machinery/atmospherics/pipe/simple/green/hidden,
/obj/structure/cable,
/obj/effect/decal/cleanable/dirt,
/turf/open/floor/asteroidfloor,
/area/bigredv3/outside/directions/nw)
"Zy" = (
/obj/effect/ai_node,
/turf/open/floor/marking/asteroidwarning,
/area/bigredv3/outside/directions/nw)
"ZW" = (
/obj/machinery/floodlight/outpost/bigred,
/turf/open/floor/plating/ground/mars/random/dirt,
/area/bigredv3/outside/directions/nw)

(1,1,1) = {"
od
od
od
od
od
od
od
od
od
od
od
od
od
od
od
od
od
od
od
od
od
od
"}
(2,1,1) = {"
Ro
Ro
Ro
Ro
Ro
Ro
Ro
Ro
Ro
Ro
Ro
Ro
Ro
Ro
Ro
Ro
Ro
Ro
Ro
Ro
Ro
Ro
"}
(3,1,1) = {"
Ro
Ro
Ro
Ro
Ro
Ro
Ro
Ro
Ro
Ro
Ro
Ro
Ro
Ro
Ro
Ro
MB
MB
MB
MB
Ro
Ro
"}
(4,1,1) = {"
Ro
Ro
Ro
Ro
Ro
Ro
Ro
Ro
Ro
Ro
Ro
Ro
Ro
Ro
Ro
MB
yh
yh
yh
yh
MB
Ro
"}
(5,1,1) = {"
Ro
Ro
Ro
Ro
Ro
Ro
Ro
Ro
Ro
Ro
Ro
Ro
Ro
Ro
MB
yh
yh
yh
yh
yh
yh
MB
"}
(6,1,1) = {"
Ro
Ro
Ro
Ro
Ro
Ro
Ro
Ro
Ro
Ro
Ro
Ro
Ro
Ro
yh
yh
yh
yh
yh
yh
yh
yh
"}
(7,1,1) = {"
Ro
Ro
Ro
Ro
Ro
Ro
Ro
Ro
Ro
Ro
Ro
Ro
Ro
Eh
yh
yh
yh
yh
yh
yh
MB
yh
"}
(8,1,1) = {"
Ro
Ro
Ro
Ro
Ro
Ro
Ro
Ro
Jy
Jy
Jy
Jy
Jy
lT
yh
yh
yh
yh
yh
yh
eR
yh
"}
(9,1,1) = {"
Ro
Jy
Jy
Jy
Jy
Jy
Jy
Jy
Jy
Jy
Jy
Jy
Jy
Jy
yh
yh
yh
yh
yh
yh
MB
yh
"}
(10,1,1) = {"
Jy
Jy
Jy
Jy
Jy
Jy
Jy
Jy
Jy
Jy
Jy
Jy
Eh
Jy
yh
yh
yh
yh
yh
yh
MB
yh
"}
(11,1,1) = {"
Jy
Jy
Jy
Jy
Jy
Eh
Jy
Jy
Jy
Jy
Jy
Jy
Jy
Jy
yh
yh
yh
yh
yh
yh
MB
Ro
"}
(12,1,1) = {"
Jy
Jy
Eh
Eh
Jy
Jy
lT
Jy
Jy
Jy
Jy
lT
Jy
lT
yh
yh
yh
yh
yh
yh
eR
Ro
"}
(13,1,1) = {"
Eh
Jy
Jy
Jy
Jy
Jy
Jy
Jy
Jy
Jy
Jy
Eh
Jy
Jy
yh
yh
yh
yh
yh
yh
yh
MB
"}
(14,1,1) = {"
Jy
Jy
Jy
Jy
Jy
Jy
Ro
Ro
Ro
Ro
Ro
Ro
Ro
Ro
Ro
Ro
Ro
yh
yh
yh
tk
MB
"}
(15,1,1) = {"
lT
Jy
Jy
Jy
Jy
Ro
Ro
Ro
Ro
Ro
Ro
Ro
Ro
Ro
Ro
Ro
Ro
yh
Ro
Ro
uS
iL
"}
(16,1,1) = {"
Jy
Jy
Jy
Ro
Ro
Ro
Ro
Ro
Ro
Ro
Ro
Ro
Ro
Ro
Ro
Ro
Ro
Ro
Ro
Ro
tt
vU
"}
(17,1,1) = {"
Jy
Jy
Ro
Ro
Ro
Ro
Ro
Ro
Ro
Ro
Ro
Ro
Ro
Ro
Ro
Ro
Ro
Ro
BF
BF
BF
BF
"}
(18,1,1) = {"
Ro
Ro
Ro
Ro
Ro
Ro
Ro
Ro
Ro
Ro
Ro
Ro
Ro
Ro
Ro
Ro
Ro
Ro
BF
xP
xP
cS
"}
(19,1,1) = {"
Ro
Ro
Ro
Ro
Ro
Ro
Ro
Ro
Ro
Ro
Ro
Ro
Ro
Ro
Ro
Ro
Ro
Ro
BF
xP
xP
xP
"}
(20,1,1) = {"
Ro
Ro
Ro
Ro
Ro
Ro
Ro
Ro
Ro
Ro
Ro
Ro
Ro
Ro
Ro
Ro
Ro
Ro
BF
xP
xP
DV
"}
(21,1,1) = {"
Ro
Ro
Ro
Ro
Ro
Ro
Ro
Ro
Ro
Ro
Ro
Ro
Ro
Ro
Ro
Ro
Ro
Ro
BF
hQ
xP
tS
"}
(22,1,1) = {"
Ro
Ro
Ro
Ro
Ro
Ro
Ro
Ro
Ro
Ro
Ro
Ro
Ro
Ro
Ro
Ro
Ro
RO
BF
Cq
hQ
AG
"}
(23,1,1) = {"
Ro
Ro
Ro
Ro
Ro
Ro
Ro
Ro
Ro
Ro
Ro
Ro
Ro
Ro
Ro
Ro
Ro
RO
BF
nl
Cq
AG
"}
(24,1,1) = {"
Ro
Ro
Ro
Ro
Ro
Ro
Ro
Ro
Ro
Ro
Ro
Ro
Ro
RO
RO
RO
RO
RO
BF
Cq
xA
AG
"}
(25,1,1) = {"
Ro
Ro
Ro
Ro
Ro
Ro
Ro
Ro
Ro
NQ
RO
RO
RO
RO
RO
NQ
RO
RO
BF
xA
xP
tS
"}
(26,1,1) = {"
Ro
Ro
Ro
Ro
Ro
Ro
Ro
Ro
Ro
RO
RO
ya
XG
PJ
RO
RO
RO
RO
BF
xP
xP
AG
"}
(27,1,1) = {"
Ro
Ro
Ro
Ro
Ro
Ro
Ro
Ro
Ro
RO
RO
iP
Md
wT
RO
RO
RO
RO
BF
xP
xP
AG
"}
(28,1,1) = {"
oO
oH
Ro
Ro
Ro
RO
RO
RO
RO
RO
RO
Mj
ug
jr
RO
RO
RO
RO
BF
xP
xP
AG
"}
(29,1,1) = {"
oO
oH
oH
NQ
RO
RO
RO
RO
RO
NQ
RO
RO
RO
RO
RO
NQ
RO
RO
BF
dr
xP
tS
"}
(30,1,1) = {"
oO
oH
RO
Fh
RO
RO
ya
PJ
RO
Fh
RO
RO
RO
RO
RO
Fh
RO
RO
BF
xP
xP
AG
"}
(31,1,1) = {"
UY
RO
RO
RO
RO
ya
Md
Md
XG
PJ
RO
RO
RO
ya
XG
PJ
RO
RO
BF
xP
DV
Rm
"}
(32,1,1) = {"
RO
RO
ya
XG
XG
Md
Md
Md
Md
Md
XG
XG
XG
Md
Md
Md
XG
XG
BF
xP
nK
ft
"}
(33,1,1) = {"
RO
ya
Md
RQ
vq
vq
LW
vq
vq
LW
An
LW
LW
LW
vq
LW
vq
pc
BF
BF
BF
ft
"}
(34,1,1) = {"
RO
iP
qY
ae
ae
ae
HB
fV
HB
Wn
sr
mC
mC
mC
mC
Xm
mC
hU
pc
Md
EC
qN
"}
(35,1,1) = {"
ya
QK
MX
MX
MX
OG
Md
Md
wt
MX
PN
MX
kT
Md
Md
Md
uh
Vq
wA
Md
fv
fV
"}
(36,1,1) = {"
iP
wt
ae
ae
OG
Md
Md
Md
wt
ae
PN
ae
kT
Md
ZW
Md
Md
fY
wA
Md
Md
wt
"}
(37,1,1) = {"
iP
pX
MX
wA
Md
ug
BF
BF
BF
vB
Lp
Xq
BF
BF
BF
BF
Md
Vq
wA
Md
ZW
wt
"}
(38,1,1) = {"
iP
wt
MX
wA
wT
RO
BF
JY
JY
JY
mn
rR
up
JY
JY
BF
Md
Vq
kT
Md
Md
wt
"}
(39,1,1) = {"
iP
wt
MX
kT
wT
RO
BF
iJ
JY
JY
mn
JY
md
QC
OK
BF
LW
RJ
LW
vq
pc
MX
"}
(40,1,1) = {"
Sk
MX
qN
wA
wT
Fh
BF
gv
rR
rR
hs
JY
JY
JY
JY
BF
qN
dv
yx
Yf
OQ
Xm
"}
(41,1,1) = {"
ae
MX
ae
kT
wT
RO
BF
JY
JY
JY
mn
rR
JY
JY
rR
BF
BF
BF
BF
BF
wA
Md
"}
(42,1,1) = {"
fV
fV
HB
OG
wT
RO
BF
JY
JY
JY
LS
JY
JY
JY
JY
gv
JY
JY
JY
BF
kT
ug
"}
(43,1,1) = {"
Md
Md
Md
Md
Md
RO
BF
rR
JY
JY
mn
md
QC
OK
JY
rR
JY
Le
PT
BF
wA
RO
"}
(44,1,1) = {"
Md
Md
Md
Md
Md
QK
BF
iJ
JY
rR
mn
JY
JY
JY
JY
JY
JY
FB
JY
BF
wA
xF
"}
(45,1,1) = {"
LW
LW
LW
LW
LW
wt
xn
JY
rR
JY
mn
gv
rR
rR
JY
pM
JY
uP
JY
JY
kT
kT
"}
(46,1,1) = {"
MX
MX
qN
MX
MX
wt
uU
rR
rR
JY
hs
JY
JY
JY
ym
JY
JY
JY
ld
rR
wA
Zy
"}
(47,1,1) = {"
jt
jt
jt
jt
jt
PF
Pw
mP
mP
mP
sN
rR
JY
JY
MV
rR
JY
rR
JY
JY
wA
wA
"}
(48,1,1) = {"
ug
ug
Md
Md
Md
fv
BF
rR
rR
JY
BV
JY
rR
JY
Dr
JY
JY
JY
JY
BF
kT
oW
"}
(49,1,1) = {"
RO
RO
Mj
ug
ug
ug
BF
iJ
cd
JY
sI
JY
JY
JY
JY
gv
JY
JY
nM
BF
kT
RO
"}
(50,1,1) = {"
RO
RO
Fh
RO
RO
RO
BF
JY
sV
JY
Gb
JY
JY
JY
gv
BF
BF
BF
BF
BF
kT
RO
"}
(51,1,1) = {"
RO
RO
RO
RO
RO
RO
BF
JY
RT
rR
BV
JY
md
QC
OK
BF
HB
fV
HB
fV
OG
NQ
"}
(52,1,1) = {"
RO
RO
NQ
RO
RO
NQ
BF
JZ
qw
qw
zo
rR
JY
JY
JY
BF
RO
RO
RO
RO
RO
Bk
"}
(53,1,1) = {"
RO
RO
RO
RO
NQ
RO
BF
BF
BF
Lu
Pp
BF
BF
BF
BF
BF
RO
RO
Fh
RO
RO
RO
"}
(54,1,1) = {"
RO
RO
RO
RO
RO
RO
RO
RO
Wq
Lu
Nk
Wq
NQ
RO
RO
RO
NQ
RO
RO
RO
RO
NQ
"}
