//MAP CONVERTED BY dmm2tgm.py THIS HEADER COMMENT PREVENTS RECONVERSION, DO NOT REMOVE
"d" = (
/obj/effect/landmark/lv624/fog_blocker,
/turf/open/floor/plating/ground/mars/random/cave,
/area/bigredv3/caves/southwest)
"f" = (
/obj/effect/landmark/xeno_silo_spawn,
/turf/open/floor/plating/ground/mars/random/cave,
/area/bigredv3/caves/southwest)
"g" = (
/turf/closed/wall/r_wall,
/area/bigredv3/inside/wall)
"j" = (
/obj/effect/landmark/lv624/fog_blocker/xeno_spawn,
/turf/closed/mineral/smooth/bigred,
/area/bigredv3/caves/rock)
"q" = (
/obj/structure/fence/standard/xenoproof,
/turf/open/floor/plating/ground/mars/random/cave,
/area/bigredv3/caves/southwest)
"t" = (
/turf/closed/mineral/smooth/bigred/indestructible,
/area/space)
"B" = (
/obj/effect/landmark/lv624/fog_blocker/xeno_spawn,
/turf/open/floor/plating/ground/mars/random/cave,
/area/bigredv3/caves/southwest)
"E" = (
/obj/effect/ai_node,
/turf/open/floor/plating/ground/mars/random/cave/rock,
/area/bigredv3/caves/southwest)
"H" = (
/obj/effect/landmark/patrol_point/som/som_11,
/turf/open/floor/plating/ground/mars/random/cave,
/area/bigredv3/caves/southwest)
"J" = (
/turf/open/floor/plating/ground/mars/random/cave,
/area/bigredv3/caves/southwest)
"L" = (
/turf/open/floor/plating/ground/mars/random/cave/rock,
/area/bigredv3/caves/southwest)
"M" = (
/obj/effect/landmark/lv624/fog_blocker,
/turf/closed/mineral/smooth/bigred,
/area/bigredv3/caves/rock)
"N" = (
/obj/effect/landmark/xeno_tunnel_spawn,
/turf/open/floor/plating/ground/mars/random/cave,
/area/bigredv3/caves/southwest)
"P" = (
/turf/closed/mineral/smooth/bigred,
/area/bigredv3/caves/rock)
"W" = (
/obj/effect/ai_node,
/turf/open/floor/plating/ground/mars/random/cave,
/area/bigredv3/caves/southwest)

(1,1,1) = {"
t
t
t
t
t
t
t
t
t
t
t
t
t
t
t
t
t
t
t
t
t
t
t
t
t
t
t
t
t
t
t
t
t
t
t
t
t
t
t
t
t
t
t
"}
(2,1,1) = {"
P
P
P
P
P
P
P
P
P
P
P
P
j
P
P
P
P
P
P
P
P
P
P
P
P
P
P
P
P
P
P
P
P
P
P
t
t
t
t
t
t
t
t
"}
(3,1,1) = {"
P
P
P
P
P
P
P
P
P
P
P
P
j
P
P
P
P
P
P
P
P
P
P
P
P
P
P
P
P
P
P
P
P
P
P
t
t
t
t
t
t
t
t
"}
(4,1,1) = {"
P
P
P
P
P
P
P
P
P
P
P
P
j
P
P
P
P
P
P
P
P
P
P
P
P
P
P
P
P
P
P
P
P
P
P
t
t
t
t
t
t
t
t
"}
(5,1,1) = {"
P
P
P
P
P
P
P
P
P
P
P
P
j
P
P
P
P
P
P
P
P
P
P
P
P
P
P
P
P
P
P
P
P
P
P
t
t
t
t
t
t
t
t
"}
(6,1,1) = {"
P
P
P
P
P
P
P
P
P
P
P
P
j
P
P
P
P
J
L
L
L
L
L
P
P
P
P
P
P
P
P
P
P
P
P
t
t
t
t
t
t
t
t
"}
(7,1,1) = {"
P
P
P
P
J
J
J
J
J
P
P
P
j
P
P
L
J
J
J
J
J
J
N
L
P
P
P
P
P
P
P
P
P
P
P
t
t
t
t
t
t
t
t
"}
(8,1,1) = {"
P
P
J
J
J
J
J
J
J
J
J
P
j
P
L
J
J
J
J
J
J
J
J
L
P
P
P
P
P
P
P
P
P
P
P
t
t
t
t
t
t
t
t
"}
(9,1,1) = {"
P
J
J
J
J
J
J
J
J
J
J
J
B
J
J
J
J
J
J
J
f
J
J
L
P
P
P
P
P
P
P
P
P
P
P
t
t
t
t
t
t
t
t
"}
(10,1,1) = {"
J
J
W
J
J
J
J
J
J
J
J
W
B
J
J
W
J
J
J
J
W
J
J
J
L
P
P
P
P
P
P
P
P
P
P
t
t
t
t
t
t
t
t
"}
(11,1,1) = {"
J
J
J
J
J
J
J
J
J
J
J
J
B
J
J
J
J
J
J
J
J
J
J
J
L
P
P
P
P
P
P
P
P
P
P
t
t
t
t
t
t
t
t
"}
(12,1,1) = {"
J
J
J
J
J
J
J
J
J
J
P
P
j
J
J
J
J
J
J
J
J
J
J
J
J
J
J
P
P
P
P
P
P
P
P
t
t
t
t
t
t
t
t
"}
(13,1,1) = {"
J
L
E
P
P
P
P
P
P
P
P
P
j
J
J
J
J
J
J
J
J
J
J
J
J
J
J
P
P
P
P
P
P
P
P
t
t
t
t
t
t
t
t
"}
(14,1,1) = {"
J
J
L
P
P
P
P
P
P
P
P
P
j
J
J
J
J
J
J
J
J
J
J
J
J
J
J
L
P
P
P
P
P
P
P
t
t
t
t
t
t
t
t
"}
(15,1,1) = {"
J
J
J
L
L
P
P
P
P
P
P
P
j
L
J
J
J
J
J
H
J
J
J
J
J
J
J
J
P
P
P
P
P
P
P
t
t
t
t
t
t
t
t
"}
(16,1,1) = {"
J
J
J
J
L
P
P
P
P
P
P
P
j
P
J
W
J
J
J
J
W
J
J
J
J
W
J
J
P
P
P
P
P
P
P
t
t
t
t
t
t
t
t
"}
(17,1,1) = {"
J
J
J
J
L
P
P
P
P
P
P
P
j
P
J
J
J
J
J
J
J
J
J
J
J
J
J
L
P
P
P
P
P
P
P
t
t
t
t
t
t
t
t
"}
(18,1,1) = {"
J
J
J
J
L
P
P
P
P
P
P
P
j
P
J
J
J
J
J
J
J
J
J
J
J
J
P
P
P
P
P
P
P
P
P
t
t
t
t
t
t
t
t
"}
(19,1,1) = {"
J
J
W
J
E
P
P
P
P
P
P
P
j
j
B
B
B
B
J
J
J
J
J
L
J
J
P
P
P
P
P
P
P
P
P
t
t
t
t
t
t
t
t
"}
(20,1,1) = {"
P
J
J
J
J
L
P
P
P
P
P
L
L
L
J
J
J
B
J
J
J
J
J
L
J
J
J
P
P
P
P
P
P
P
P
t
t
t
t
t
t
t
t
"}
(21,1,1) = {"
P
P
P
J
J
L
P
P
P
P
P
L
J
J
J
J
J
B
J
J
J
J
L
J
J
J
J
P
P
P
P
P
P
P
P
t
t
t
t
t
t
t
t
"}
(22,1,1) = {"
P
P
P
J
J
J
L
J
P
P
P
J
W
J
J
W
L
j
L
J
J
J
L
P
P
J
J
P
P
P
P
P
P
P
P
t
t
t
t
t
t
t
t
"}
(23,1,1) = {"
P
P
P
J
J
J
J
J
J
P
J
J
J
J
J
L
P
j
j
j
j
j
j
j
j
B
B
B
j
j
j
j
j
j
j
t
t
t
t
t
t
t
t
"}
(24,1,1) = {"
P
P
P
J
J
J
J
J
L
J
J
L
J
J
J
L
P
P
P
P
P
P
P
P
J
J
J
J
P
P
P
P
P
P
P
t
t
t
t
t
t
t
t
"}
(25,1,1) = {"
P
P
P
L
J
J
J
J
J
J
L
J
J
J
J
P
P
P
P
P
P
P
P
P
J
W
J
J
P
P
P
P
P
P
P
t
t
t
t
t
t
t
t
"}
(26,1,1) = {"
P
P
P
P
W
J
J
J
J
J
J
J
L
J
J
P
P
P
P
P
P
P
P
P
P
J
W
J
P
P
P
P
P
P
P
t
t
t
t
t
t
t
t
"}
(27,1,1) = {"
P
P
P
J
J
W
J
J
J
J
J
J
W
J
J
P
P
P
P
P
P
P
P
P
P
J
J
J
J
P
P
P
P
P
P
t
t
t
t
t
t
t
t
"}
(28,1,1) = {"
P
P
J
J
J
J
J
J
J
J
J
J
J
J
L
P
P
P
P
P
P
P
P
P
P
P
J
J
J
P
P
P
P
P
P
t
t
t
t
t
t
t
t
"}
(29,1,1) = {"
P
P
J
J
J
J
J
J
J
J
J
J
J
J
J
P
P
P
P
P
P
P
P
P
P
P
J
J
J
P
P
P
P
P
P
t
t
t
t
t
t
t
t
"}
(30,1,1) = {"
P
J
J
J
J
J
J
J
J
L
P
L
W
J
J
J
P
P
P
P
P
P
P
P
P
P
J
J
J
J
P
P
P
P
P
t
t
t
t
t
t
t
t
"}
(31,1,1) = {"
P
J
J
J
J
J
J
J
J
L
P
P
L
W
J
J
J
P
P
P
P
P
P
P
P
P
E
J
J
J
P
P
P
P
P
t
t
t
t
t
t
t
t
"}
(32,1,1) = {"
P
J
W
J
J
W
P
J
J
L
P
P
P
J
W
J
J
W
J
P
P
P
P
P
P
P
L
E
J
J
P
P
P
P
P
t
t
t
t
t
t
t
t
"}
(33,1,1) = {"
P
J
J
J
P
P
P
L
L
P
P
P
P
J
J
J
J
J
J
J
L
P
P
P
P
P
P
L
W
J
J
P
P
P
P
t
t
t
t
t
t
t
t
"}
(34,1,1) = {"
P
q
q
q
P
P
P
P
P
P
P
P
P
P
J
J
J
J
J
J
J
L
P
P
P
P
P
P
J
J
J
J
P
P
P
t
t
t
t
t
t
t
t
"}
(35,1,1) = {"
P
J
J
J
P
P
P
P
P
P
P
P
P
J
J
J
J
J
J
J
L
P
P
P
P
P
P
P
J
J
J
P
P
P
P
t
t
t
t
t
t
t
t
"}
(36,1,1) = {"
P
g
g
g
P
P
P
P
P
P
P
P
P
L
J
J
J
J
J
J
L
P
P
P
P
P
P
P
J
J
J
P
P
P
P
t
t
t
t
t
t
t
t
"}
(37,1,1) = {"
J
J
J
J
P
P
P
P
P
P
P
P
P
P
P
P
J
W
J
J
J
E
P
P
P
P
P
P
J
J
J
P
P
P
P
t
t
t
t
t
t
t
t
"}
(38,1,1) = {"
J
J
J
J
P
P
P
P
P
P
P
P
P
P
P
P
J
J
J
J
J
L
P
P
P
P
L
L
J
J
J
P
P
P
P
t
t
t
t
t
t
t
t
"}
(39,1,1) = {"
J
J
J
J
P
P
P
P
P
P
P
P
P
P
P
P
L
J
J
J
J
L
P
P
P
P
L
L
J
J
P
P
P
P
P
t
t
t
t
t
t
t
t
"}
(40,1,1) = {"
J
J
J
J
P
P
P
P
P
P
P
P
P
P
P
P
P
P
P
J
J
J
L
L
P
P
P
P
J
J
P
P
P
P
P
t
t
t
t
t
t
t
t
"}
(41,1,1) = {"
d
d
d
M
M
M
M
M
M
M
M
M
M
M
P
P
P
P
P
J
J
J
J
L
P
P
P
P
J
J
P
P
P
P
P
t
t
t
t
t
t
t
t
"}
