//MAP CONVERTED BY dmm2tgm.py THIS HEADER COMMENT PREVENTS RECONVERSION, DO NOT REMOVE
"j" = (
/obj/effect/ai_node,
/turf/open/floor/plating/ground/mars/random/cave/rock,
/area/bigredv3/caves/southwest)
"m" = (
/obj/effect/landmark/lv624/fog_blocker,
/turf/open/floor/plating/ground/mars/random/cave/rock,
/area/bigredv3/caves/southwest)
"o" = (
/obj/structure/fence/standard/xenoproof,
/turf/open/floor/plating/ground/mars/random/cave/rock,
/area/bigredv3/caves/southwest)
"q" = (
/turf/open/floor/plating/ground/mars/random/cave/rock,
/area/bigredv3/caves/south)
"r" = (
/turf/closed/wall/r_wall,
/area/bigredv3/inside/wall)
"t" = (
/turf/open/floor/plating/ground/mars/random/cave/rock,
/area/bigredv3/caves/southwest)
"x" = (
/obj/effect/ai_node,
/turf/open/floor/plating/ground/mars/random/cave/rock,
/area/bigredv3/caves/south)
"y" = (
/turf/open/floor/plating/ground/mars/random/cave,
/area/bigredv3/caves/southwest)
"z" = (
/obj/effect/landmark/lv624/fog_blocker,
/turf/open/floor/plating/ground/mars/random/cave,
/area/bigredv3/caves/south)
"C" = (
/obj/structure/fence/standard/xenoproof,
/turf/open/floor/plating/ground/mars/random/cave,
/area/bigredv3/caves/south)
"E" = (
/turf/open/floor/plating/ground/mars/random/cave,
/area/bigredv3/caves/south)
"G" = (
/turf/closed/mineral/smooth/bigred,
/area/bigredv3/caves/rock)
"K" = (
/obj/effect/landmark/lv624/fog_blocker,
/turf/open/floor/plating/ground/mars/random/cave,
/area/bigredv3/caves/southwest)
"N" = (
/obj/effect/landmark/lv624/fog_blocker,
/turf/closed/mineral/smooth/bigred,
/area/bigredv3/caves/rock)
"R" = (
/obj/structure/fence/standard/xenoproof,
/turf/open/floor/plating/ground/mars/random/cave/rock,
/area/bigredv3/caves/south)
"U" = (
/obj/structure/fence/standard/xenoproof,
/turf/open/floor/plating/ground/mars/random/cave,
/area/bigredv3/caves/southwest)
"X" = (
/obj/effect/ai_node,
/turf/open/floor/plating/ground/mars/random/cave,
/area/bigredv3/caves/southwest)
"Z" = (
/obj/effect/ai_node,
/turf/open/floor/plating/ground/mars/random/cave,
/area/bigredv3/caves/south)

(1,1,1) = {"
N
G
G
G
G
G
t
y
y
y
t
G
G
G
G
y
y
G
G
G
G
G
"}
(2,1,1) = {"
K
G
G
G
G
G
G
y
X
y
t
G
G
G
G
y
y
y
G
G
G
G
"}
(3,1,1) = {"
K
G
G
G
G
G
G
y
y
y
t
G
G
G
t
y
y
G
G
G
G
G
"}
(4,1,1) = {"
K
G
G
G
G
G
y
y
y
y
t
G
G
G
t
y
y
G
G
G
G
G
"}
(5,1,1) = {"
K
t
G
G
G
G
y
y
y
y
y
G
G
t
y
y
y
G
G
G
G
G
"}
(6,1,1) = {"
K
t
G
G
t
o
y
y
y
y
y
G
G
y
y
X
G
G
G
G
G
G
"}
(7,1,1) = {"
K
y
j
r
y
U
y
y
X
y
G
G
G
y
X
G
G
G
G
G
G
G
"}
(8,1,1) = {"
K
y
y
r
y
U
y
y
y
G
G
G
y
y
y
G
G
G
G
G
G
G
"}
(9,1,1) = {"
K
t
y
r
y
U
y
G
G
G
G
G
y
y
y
G
G
G
G
G
G
G
"}
(10,1,1) = {"
m
y
y
r
G
G
G
G
G
G
G
G
y
y
y
G
G
y
G
G
G
G
"}
(11,1,1) = {"
K
y
X
G
G
G
G
G
G
G
G
G
y
y
y
y
y
y
G
G
G
G
"}
(12,1,1) = {"
y
K
y
G
G
G
G
G
G
G
G
G
y
y
y
y
y
y
G
G
G
G
"}
(13,1,1) = {"
y
y
K
N
G
G
G
G
G
G
G
G
y
y
y
y
y
G
G
G
G
G
"}
(14,1,1) = {"
y
y
G
G
N
G
G
G
G
G
G
G
y
y
y
y
G
G
G
G
G
G
"}
(15,1,1) = {"
y
y
G
G
G
N
G
G
G
G
G
G
G
y
y
t
G
G
G
G
G
G
"}
(16,1,1) = {"
y
y
G
G
G
G
N
G
G
G
G
G
G
y
X
t
t
G
G
G
G
G
"}
(17,1,1) = {"
y
y
G
G
G
G
N
G
G
G
G
G
G
y
t
t
G
G
G
G
G
G
"}
(18,1,1) = {"
y
X
G
G
G
G
N
G
G
G
G
G
G
y
y
y
G
G
G
G
G
G
"}
(19,1,1) = {"
y
y
y
G
G
G
N
G
G
G
G
G
y
y
y
y
y
G
G
G
G
G
"}
(20,1,1) = {"
t
y
y
y
G
G
N
G
G
G
y
y
y
y
y
t
y
G
G
G
G
G
"}
(21,1,1) = {"
t
y
y
y
G
G
N
G
G
G
y
y
y
y
y
t
y
G
G
G
G
G
"}
(22,1,1) = {"
y
y
y
y
y
G
N
G
G
G
y
y
y
y
y
G
G
G
G
G
G
G
"}
(23,1,1) = {"
y
y
y
y
y
G
N
G
G
G
y
y
y
y
y
G
G
G
G
G
G
G
"}
(24,1,1) = {"
y
y
y
y
y
G
N
G
G
G
y
y
y
y
y
G
G
G
G
G
G
G
"}
(25,1,1) = {"
y
y
y
y
y
G
N
G
G
G
G
t
y
y
X
y
G
G
G
G
G
G
"}
(26,1,1) = {"
E
E
E
E
E
G
N
G
G
G
G
E
E
q
E
E
G
G
G
G
G
G
"}
(27,1,1) = {"
E
Z
E
E
E
r
N
G
G
G
G
G
E
E
E
E
E
G
G
G
G
G
"}
(28,1,1) = {"
q
E
Z
E
E
r
z
Z
G
G
G
G
G
E
E
E
E
E
E
G
G
G
"}
(29,1,1) = {"
q
E
E
E
E
r
z
E
E
G
G
G
G
E
Z
q
E
Z
E
E
G
G
"}
(30,1,1) = {"
E
E
E
E
E
G
z
E
E
E
G
G
G
G
E
E
E
E
E
E
E
G
"}
(31,1,1) = {"
E
E
E
E
G
G
N
E
E
E
G
G
G
G
G
E
E
E
E
E
E
G
"}
(32,1,1) = {"
E
E
E
G
G
G
N
E
E
E
G
G
G
G
G
E
E
E
E
E
E
E
"}
(33,1,1) = {"
E
E
G
G
G
G
N
Z
E
E
Z
G
G
G
G
E
E
E
E
E
E
E
"}
(34,1,1) = {"
q
E
G
G
G
G
N
G
E
E
E
E
G
G
G
E
E
Z
E
E
Z
E
"}
(35,1,1) = {"
q
E
G
G
G
G
N
G
E
E
E
E
C
G
E
E
E
E
E
E
q
E
"}
(36,1,1) = {"
q
E
G
G
G
G
N
E
E
E
E
E
C
E
E
E
E
E
E
E
E
E
"}
(37,1,1) = {"
E
E
G
G
G
G
N
Z
E
E
Z
E
C
E
E
E
E
Z
E
E
E
E
"}
(38,1,1) = {"
E
Z
E
G
G
G
z
E
E
E
G
E
C
E
E
E
E
E
E
E
E
E
"}
(39,1,1) = {"
E
E
E
G
G
r
z
E
E
G
G
G
C
E
E
E
E
E
E
E
E
E
"}
(40,1,1) = {"
E
Z
E
E
E
r
z
Z
G
G
G
G
G
E
E
E
E
E
E
E
Z
E
"}
(41,1,1) = {"
E
E
E
E
E
r
z
G
G
G
G
G
G
E
E
E
E
E
x
E
E
Z
"}
(42,1,1) = {"
E
E
E
E
E
r
N
G
G
G
G
G
E
E
E
E
E
E
E
E
E
E
"}
(43,1,1) = {"
E
G
G
G
G
G
N
G
G
G
G
E
Z
E
q
Z
E
E
Z
q
G
G
"}
(44,1,1) = {"
G
G
G
G
G
G
N
G
G
G
G
G
C
R
C
C
C
R
G
G
G
G
"}
