//MAP CONVERTED BY dmm2tgm.py THIS HEADER COMMENT PREVENTS RECONVERSION, DO NOT REMOVE
"h" = (
/turf/open/floor/plating/ground/mars/random/cave,
/area/bigredv3/caves/south/garbledradio)
"m" = (
/obj/structure/fence/standard/xenoproof,
/turf/open/floor/plating/ground/mars/random/cave/rock,
/area/bigredv3/caves/southwest)
"t" = (
/obj/structure/fence/standard/xenoproof,
/turf/open/floor/plating/ground/mars/random/cave,
/area/bigredv3/caves/south/garbledradio)
"u" = (
/turf/open/floor/plating/ground/mars/random/cave,
/area/bigredv3/caves/south)
"w" = (
/turf/open/floor/plating/ground/mars/random/cave/rock,
/area/bigredv3/caves/south/garbledradio)
"y" = (
/obj/effect/ai_node,
/turf/open/floor/plating/ground/mars/random/cave,
/area/bigredv3/caves/south/garbledradio)
"z" = (
/obj/structure/fence/standard/xenoproof,
/turf/open/floor/plating/ground/mars/random/cave/rock,
/area/bigredv3/caves/south/garbledradio)
"B" = (
/turf/closed/wall/r_wall,
/area/bigredv3/inside/wall)
"D" = (
/obj/effect/landmark/lv624/fog_blocker,
/turf/open/floor/plating/ground/mars/random/cave,
/area/bigredv3/caves/southwest)
"H" = (
/obj/effect/landmark/lv624/fog_blocker,
/turf/closed/mineral/smooth/bigred,
/area/bigredv3/caves/rock)
"I" = (
/obj/effect/ai_node,
/turf/open/floor/plating/ground/mars/random/cave/rock,
/area/bigredv3/caves/south/garbledradio)
"M" = (
/obj/effect/ai_node,
/turf/open/floor/plating/ground/mars/random/cave,
/area/bigredv3/caves/southwest)
"P" = (
/turf/open/floor/plating/ground/mars/random/cave/rock,
/area/bigredv3/caves/southwest)
"R" = (
/obj/effect/ai_node,
/turf/open/floor/plating/ground/mars/random/cave/rock,
/area/bigredv3/caves/southwest)
"S" = (
/turf/closed/mineral/smooth/bigred,
/area/bigredv3/caves/rock)
"T" = (
/obj/effect/ai_node,
/turf/open/floor/plating/ground/mars/random/cave,
/area/bigredv3/caves/south)
"U" = (
/obj/effect/landmark/lv624/fog_blocker,
/turf/open/floor/plating/ground/mars/random/cave/rock,
/area/bigredv3/caves/southwest)
"V" = (
/turf/open/floor/plating/ground/mars/random/cave,
/area/bigredv3/caves/southwest)
"Z" = (
/obj/structure/fence/standard/xenoproof,
/turf/open/floor/plating/ground/mars/random/cave,
/area/bigredv3/caves/southwest)

(1,1,1) = {"
H
S
S
S
S
S
P
V
V
V
P
S
S
S
S
V
V
S
S
S
S
S
"}
(2,1,1) = {"
D
S
S
S
S
S
S
V
M
V
P
S
S
S
S
V
V
V
S
S
S
S
"}
(3,1,1) = {"
D
S
S
S
S
S
S
V
V
V
P
S
S
S
P
V
V
S
S
S
S
S
"}
(4,1,1) = {"
D
S
S
S
S
S
V
V
V
V
P
S
S
S
P
V
V
S
S
S
S
S
"}
(5,1,1) = {"
D
P
S
S
S
S
V
V
V
V
V
S
S
P
V
V
V
S
S
S
S
S
"}
(6,1,1) = {"
D
P
S
S
P
m
V
V
V
V
V
S
S
V
V
M
S
S
S
S
S
S
"}
(7,1,1) = {"
D
V
B
R
V
Z
V
V
M
V
S
S
S
V
M
S
S
S
S
S
S
S
"}
(8,1,1) = {"
D
V
B
P
V
Z
V
V
V
S
S
S
V
V
V
S
S
S
S
S
S
S
"}
(9,1,1) = {"
D
P
B
V
V
Z
V
S
S
S
S
S
V
V
V
S
S
S
S
S
S
S
"}
(10,1,1) = {"
U
V
B
M
S
S
S
S
S
S
S
S
V
V
V
S
S
V
S
S
S
S
"}
(11,1,1) = {"
H
S
S
S
S
S
S
S
S
S
S
S
V
V
V
V
V
V
S
S
S
S
"}
(12,1,1) = {"
S
H
S
S
S
S
S
S
S
S
S
S
V
V
V
V
V
V
S
S
S
S
"}
(13,1,1) = {"
S
S
H
H
S
S
S
S
S
S
S
S
V
V
V
V
V
S
S
S
S
S
"}
(14,1,1) = {"
S
S
S
S
H
S
S
S
S
S
S
S
V
V
V
V
S
S
S
S
S
S
"}
(15,1,1) = {"
S
S
S
S
S
H
S
S
S
S
S
S
S
V
V
P
S
S
S
S
S
S
"}
(16,1,1) = {"
S
S
S
S
S
S
H
S
S
S
S
S
S
V
M
P
P
S
S
S
S
S
"}
(17,1,1) = {"
V
S
S
S
S
S
H
S
S
S
S
S
S
V
P
P
S
S
S
S
S
S
"}
(18,1,1) = {"
V
M
S
S
S
S
H
S
S
S
S
S
S
V
V
V
S
S
S
S
S
S
"}
(19,1,1) = {"
V
V
S
S
S
S
H
S
S
S
S
S
V
V
V
V
V
S
S
S
S
S
"}
(20,1,1) = {"
P
V
S
S
S
S
H
S
S
S
V
V
V
V
V
P
V
S
S
S
S
S
"}
(21,1,1) = {"
P
V
V
S
S
S
H
S
S
S
V
V
V
V
V
P
V
S
S
S
S
S
"}
(22,1,1) = {"
V
V
V
V
V
S
H
S
S
S
V
V
V
V
V
S
S
S
S
S
S
S
"}
(23,1,1) = {"
V
V
V
V
V
S
H
S
S
S
V
V
V
V
V
S
S
S
S
S
S
S
"}
(24,1,1) = {"
V
V
V
V
V
S
H
S
S
S
V
V
V
V
V
S
S
S
S
S
S
S
"}
(25,1,1) = {"
V
V
V
V
V
S
H
S
S
V
V
P
V
V
M
V
S
S
S
S
S
S
"}
(26,1,1) = {"
h
h
h
h
h
S
H
S
S
h
h
h
h
w
h
h
S
S
S
S
S
S
"}
(27,1,1) = {"
h
y
h
h
h
S
H
S
S
S
S
S
h
h
h
h
h
S
S
S
S
S
"}
(28,1,1) = {"
w
h
h
h
h
S
H
S
S
S
S
S
S
h
h
h
h
h
h
S
S
S
"}
(29,1,1) = {"
w
h
h
h
h
S
H
S
S
S
S
S
S
h
y
w
h
y
h
h
S
S
"}
(30,1,1) = {"
h
h
h
h
h
S
H
S
S
S
S
S
S
S
h
h
h
h
h
h
h
S
"}
(31,1,1) = {"
h
h
h
h
h
S
H
S
S
S
S
S
S
S
S
h
h
h
h
h
h
S
"}
(32,1,1) = {"
h
h
h
h
h
S
H
S
S
S
S
S
S
S
S
h
h
h
h
h
u
u
"}
(33,1,1) = {"
h
h
h
h
h
S
H
S
S
S
S
S
S
S
S
S
h
h
h
h
u
u
"}
(34,1,1) = {"
w
h
h
h
S
S
H
S
S
S
S
S
S
S
S
S
S
y
h
h
y
u
"}
(35,1,1) = {"
w
h
h
h
S
S
H
S
S
S
S
S
S
S
S
S
S
h
h
h
w
u
"}
(36,1,1) = {"
w
h
h
h
S
S
H
S
S
S
S
S
S
S
S
S
S
S
h
h
h
u
"}
(37,1,1) = {"
h
h
h
h
S
S
H
S
S
S
S
S
S
S
S
S
S
S
h
h
u
u
"}
(38,1,1) = {"
h
y
h
h
S
S
H
S
S
S
S
S
S
S
S
S
S
h
h
h
u
u
"}
(39,1,1) = {"
h
h
h
S
S
S
H
S
S
S
S
S
S
S
S
h
h
h
h
h
u
u
"}
(40,1,1) = {"
h
h
h
S
S
S
H
S
S
S
S
S
S
S
h
h
h
h
h
h
T
u
"}
(41,1,1) = {"
h
h
h
S
S
S
H
S
S
S
S
S
S
h
h
h
h
h
I
h
u
T
"}
(42,1,1) = {"
h
h
S
S
S
S
H
S
S
S
S
S
h
h
h
h
h
h
h
h
u
u
"}
(43,1,1) = {"
h
S
S
S
S
S
H
S
S
S
S
h
y
h
w
y
h
h
y
w
S
S
"}
(44,1,1) = {"
S
S
S
S
S
S
H
S
S
S
S
S
t
z
t
t
t
z
S
S
S
S
"}
