//MAP CONVERTED BY dmm2tgm.py THIS HEADER COMMENT PREVENTS RECONVERSION, DO NOT REMOVE
"c" = (
/obj/effect/landmark/lv624/fog_blocker/xeno_spawn,
/turf/open/floor/plating/ground/mars/random/cave,
/area/bigredv3/caves/southwest)
"d" = (
/obj/effect/ai_node,
/turf/open/floor/plating/ground/mars/random/cave/rock,
/area/bigredv3/caves/southwest)
"h" = (
/obj/effect/ai_node,
/turf/open/floor/plating/ground/mars/random/cave,
/area/bigredv3/caves/southwest)
"i" = (
/turf/closed/wall/r_wall,
/area/bigredv3/inside/wall)
"j" = (
/turf/closed/mineral/smooth/bigred,
/area/bigredv3/caves/rock)
"k" = (
/turf/open/floor/plating/ground/mars/random/cave,
/area/bigredv3/caves/southwest)
"l" = (
/turf/closed/mineral/smooth/bigred/indestructible,
/area/space)
"t" = (
/obj/effect/landmark/lv624/fog_blocker/xeno_spawn,
/turf/closed/mineral/smooth/bigred,
/area/bigredv3/caves/rock)
"u" = (
/obj/effect/landmark/lv624/fog_blocker/xeno_spawn,
/turf/open/floor/plating/ground/mars/random/cave/rock,
/area/bigredv3/caves/southwest)
"v" = (
/obj/effect/landmark/xeno_tunnel_spawn,
/turf/open/floor/plating/ground/mars/random/cave,
/area/bigredv3/caves/southwest)
"z" = (
/obj/effect/landmark/lv624/fog_blocker,
/turf/open/floor/plating/ground/mars/random/cave,
/area/bigredv3/caves/southwest)
"O" = (
/obj/effect/landmark/lv624/fog_blocker,
/turf/closed/mineral/smooth/bigred,
/area/bigredv3/caves/rock)
"Q" = (
/turf/open/floor/plating/ground/mars/random/cave/rock,
/area/bigredv3/caves/southwest)
"R" = (
/obj/effect/landmark/patrol_point/som/som_11,
/turf/open/floor/plating/ground/mars/random/cave,
/area/bigredv3/caves/southwest)
"X" = (
/obj/structure/fence/standard/xenoproof,
/turf/open/floor/plating/ground/mars/random/cave,
/area/bigredv3/caves/southwest)
"Y" = (
/obj/effect/landmark/xeno_silo_spawn,
/turf/open/floor/plating/ground/mars/random/cave,
/area/bigredv3/caves/southwest)

(1,1,1) = {"
l
l
l
l
l
l
l
l
l
l
l
l
l
l
l
l
l
l
l
l
l
l
l
l
l
l
l
l
l
l
l
l
l
l
l
l
l
l
l
l
l
l
l
"}
(2,1,1) = {"
j
j
j
j
j
j
j
j
j
j
j
j
j
j
j
j
j
j
j
j
j
j
j
j
j
j
j
j
j
j
j
j
j
j
j
l
l
l
l
l
l
l
l
"}
(3,1,1) = {"
j
j
j
j
j
j
j
j
j
j
j
j
j
j
j
j
j
j
j
j
j
j
j
j
j
j
j
j
j
j
j
j
j
j
j
l
l
l
l
l
l
l
l
"}
(4,1,1) = {"
j
j
j
j
j
j
j
j
j
j
j
j
j
j
j
j
j
j
j
j
j
j
j
j
j
j
j
j
j
j
j
j
j
j
j
l
l
l
l
l
l
l
l
"}
(5,1,1) = {"
j
j
j
j
j
j
j
j
j
j
j
j
j
j
j
j
j
j
j
j
j
j
j
j
j
j
j
j
j
j
j
j
j
j
j
l
l
l
l
l
l
l
l
"}
(6,1,1) = {"
j
j
j
j
j
j
j
j
j
j
j
j
j
j
j
j
j
j
j
j
j
j
j
j
j
j
j
j
j
j
j
j
j
j
j
l
l
l
l
l
l
l
l
"}
(7,1,1) = {"
j
j
j
j
j
j
j
j
j
j
j
j
j
j
j
j
j
j
j
j
j
j
j
j
j
j
j
j
j
j
j
j
j
j
j
l
l
l
l
l
l
l
l
"}
(8,1,1) = {"
j
j
j
j
j
j
j
j
j
j
j
j
j
j
j
j
j
j
j
j
j
j
j
j
j
j
j
j
j
j
j
j
j
j
j
l
l
l
l
l
l
l
l
"}
(9,1,1) = {"
j
j
j
j
j
j
j
j
j
j
j
j
j
j
j
j
j
j
j
j
j
k
k
j
j
j
j
j
j
j
j
j
j
j
j
l
l
l
l
l
l
l
l
"}
(10,1,1) = {"
k
k
j
j
j
j
j
j
j
j
j
j
j
j
j
j
j
k
k
k
k
k
k
j
j
j
j
j
j
j
j
j
j
j
j
l
l
l
l
l
l
l
l
"}
(11,1,1) = {"
k
k
k
j
j
j
j
j
j
j
j
j
j
j
j
j
k
k
k
k
k
k
k
k
j
j
j
j
j
j
j
j
j
j
j
l
l
l
l
l
l
l
l
"}
(12,1,1) = {"
k
k
k
Q
Q
j
j
j
j
j
j
j
j
j
j
j
k
k
j
j
k
k
k
k
j
j
j
j
j
j
j
j
j
j
j
l
l
l
l
l
l
l
l
"}
(13,1,1) = {"
k
Q
d
k
Q
j
j
j
j
j
j
j
j
j
j
k
k
k
j
j
j
j
k
k
k
j
j
j
j
j
j
j
j
j
j
l
l
l
l
l
l
l
l
"}
(14,1,1) = {"
k
k
Q
k
Q
j
j
j
j
j
j
j
j
j
j
k
k
k
k
j
j
j
k
k
k
j
j
j
j
j
j
j
j
j
j
l
l
l
l
l
l
l
l
"}
(15,1,1) = {"
k
k
k
k
Q
j
j
j
j
j
j
j
j
j
j
k
k
k
k
k
j
j
j
k
k
j
j
j
j
j
j
j
j
j
j
l
l
l
l
l
l
l
l
"}
(16,1,1) = {"
k
k
k
k
d
j
j
j
j
j
j
j
j
j
j
k
k
k
k
k
k
j
j
k
k
j
j
j
j
j
j
j
j
j
j
l
l
l
l
l
l
l
l
"}
(17,1,1) = {"
k
k
k
k
k
d
j
j
j
j
j
Q
Q
Q
k
k
k
k
k
k
k
k
k
k
k
j
j
j
j
j
j
j
j
j
j
l
l
l
l
l
l
l
l
"}
(18,1,1) = {"
k
k
k
k
k
Q
j
j
j
j
j
Q
k
k
k
k
k
k
R
k
k
k
k
k
k
j
j
j
j
j
j
j
j
j
j
l
l
l
l
l
l
l
l
"}
(19,1,1) = {"
k
k
h
k
k
k
Q
k
j
j
j
k
h
k
k
k
k
k
k
k
k
k
k
Q
k
k
j
j
j
j
j
j
j
j
j
l
l
l
l
l
l
l
l
"}
(20,1,1) = {"
j
k
k
k
k
k
k
k
k
j
k
k
k
k
k
k
k
k
k
k
k
k
k
Q
k
k
k
j
j
j
j
j
j
j
j
l
l
l
l
l
l
l
l
"}
(21,1,1) = {"
j
j
j
k
k
k
k
k
k
k
k
k
k
k
k
k
k
k
k
k
k
k
Q
k
k
k
k
j
j
j
j
j
j
j
j
l
l
l
l
l
l
l
l
"}
(22,1,1) = {"
j
j
j
k
k
h
k
k
k
k
k
k
h
k
k
h
Q
j
Q
k
k
k
Q
j
j
k
k
j
j
j
j
j
j
j
j
l
l
l
l
l
l
l
l
"}
(23,1,1) = {"
j
j
j
k
k
k
k
k
k
k
k
k
k
k
k
Q
j
j
j
j
j
j
j
j
j
k
k
k
j
j
j
j
j
j
j
l
l
l
l
l
l
l
l
"}
(24,1,1) = {"
j
j
j
k
k
k
k
k
Q
k
k
Q
k
k
k
Q
j
j
j
j
j
j
j
j
k
k
k
k
j
j
j
j
j
j
j
l
l
l
l
l
l
l
l
"}
(25,1,1) = {"
j
j
j
Q
k
k
k
k
k
k
Q
k
k
k
k
j
j
j
j
j
j
j
j
j
k
h
k
k
j
j
j
j
j
j
j
l
l
l
l
l
l
l
l
"}
(26,1,1) = {"
j
j
j
j
h
k
k
k
k
k
k
k
Q
k
k
t
t
t
t
t
t
t
t
t
t
k
h
k
j
j
j
j
j
j
j
l
l
l
l
l
l
l
l
"}
(27,1,1) = {"
j
j
j
k
k
h
k
k
k
k
k
k
h
k
k
t
j
j
j
j
j
j
j
j
t
k
k
k
k
j
j
j
j
j
j
l
l
l
l
l
l
l
l
"}
(28,1,1) = {"
j
j
k
k
k
k
k
k
k
k
k
k
k
k
Q
t
j
j
j
k
k
v
j
j
t
j
k
k
k
j
j
j
j
j
j
l
l
l
l
l
l
l
l
"}
(29,1,1) = {"
j
k
k
k
k
k
k
k
k
k
k
k
k
k
k
t
j
j
k
k
k
Y
k
j
t
j
k
k
k
j
j
j
j
j
j
l
l
l
l
l
l
l
l
"}
(30,1,1) = {"
j
k
k
k
k
k
k
k
k
Q
j
Q
h
k
h
c
j
j
k
k
k
k
k
j
t
j
k
k
k
k
j
j
j
j
j
l
l
l
l
l
l
l
l
"}
(31,1,1) = {"
j
k
k
k
k
k
k
k
k
Q
j
j
Q
h
k
c
k
j
h
k
k
k
k
j
t
j
d
k
k
k
j
j
j
j
j
l
l
l
l
l
l
l
l
"}
(32,1,1) = {"
j
k
h
k
k
h
j
k
k
Q
j
j
j
k
k
c
k
h
k
k
k
k
j
j
t
j
Q
d
k
k
j
j
j
j
j
l
l
l
l
l
l
l
l
"}
(33,1,1) = {"
j
k
k
k
j
j
j
Q
Q
j
j
j
j
k
k
c
k
k
k
k
Q
k
j
j
t
j
j
Q
h
k
k
j
j
j
j
l
l
l
l
l
l
l
l
"}
(34,1,1) = {"
j
X
X
X
j
j
j
j
j
j
j
j
j
j
k
c
k
k
k
k
k
Q
j
j
t
j
j
j
k
k
k
k
j
j
j
l
l
l
l
l
l
l
l
"}
(35,1,1) = {"
j
k
k
k
j
j
j
j
j
j
j
j
j
k
k
c
c
c
c
c
u
t
t
t
t
j
j
j
k
k
k
j
j
j
j
l
l
l
l
l
l
l
l
"}
(36,1,1) = {"
j
i
i
i
j
j
j
j
j
j
j
j
j
Q
h
k
k
k
h
k
Q
j
j
j
j
j
j
j
k
k
k
j
j
j
j
l
l
l
l
l
l
l
l
"}
(37,1,1) = {"
k
k
k
k
j
j
j
j
j
j
j
j
j
j
j
j
k
h
k
h
k
d
j
j
j
j
j
j
k
k
k
j
j
j
j
l
l
l
l
l
l
l
l
"}
(38,1,1) = {"
k
k
k
k
j
j
j
j
j
j
j
j
j
j
j
j
k
k
k
k
k
Q
j
j
j
j
Q
Q
k
k
k
j
j
j
j
l
l
l
l
l
l
l
l
"}
(39,1,1) = {"
k
k
k
k
j
j
j
j
j
j
j
j
j
j
j
j
Q
k
k
k
k
Q
j
j
j
j
Q
Q
k
k
j
j
j
j
j
l
l
l
l
l
l
l
l
"}
(40,1,1) = {"
k
k
k
k
j
j
j
j
j
j
j
j
j
j
j
j
j
j
j
k
k
k
Q
Q
j
j
j
j
k
k
j
j
j
j
j
l
l
l
l
l
l
l
l
"}
(41,1,1) = {"
z
z
z
O
O
O
O
O
O
O
O
O
O
O
j
j
j
j
j
k
k
k
k
Q
j
j
j
j
k
k
j
j
j
j
j
l
l
l
l
l
l
l
l
"}
