//MAP CONVERTED BY dmm2tgm.py THIS HEADER COMMENT PREVENTS RECONVERSION, DO NOT REMOVE
"a" = (
/turf/open/space/basic,
/area/space)
"b" = (
/obj/effect/landmark/xeno_silo_spawn,
/turf/open/floor/plating/ground/mars/random/cave,
/area/bigredv2/caves/southeast)
"e" = (
/obj/effect/ai_node,
/turf/open/floor/plating/ground/mars/random/cave,
/area/bigredv2/caves/southeast/garbledradio)
"h" = (
/turf/open/floor/plating/ground/mars/random/cave,
/area/bigredv2/caves/southeast)
"i" = (
/obj/effect/landmark/lv624/fog_blocker/xeno_spawn,
/turf/closed/mineral/smooth/bigred,
/area/bigredv2/caves/rock)
"j" = (
/turf/closed/mineral/smooth/bigred,
/area/bigredv2/caves/rock)
"t" = (
/obj/effect/landmark/lv624/fog_blocker/xeno_spawn,
/turf/open/floor/plating/ground/mars/random/cave,
/area/bigredv2/caves/southeast)
"v" = (
/turf/open/floor/plating/ground/mars/random/cave,
/area/bigredv2/caves/southeast/garbledradio)
"A" = (
/obj/effect/ai_node,
/turf/open/floor/plating/ground/mars/random/cave,
/area/bigredv2/caves/southeast)
"C" = (
/obj/effect/ai_node,
/turf/open/floor/plating/ground/mars/random/cave/rock,
/area/bigredv2/caves/southeast/garbledradio)
"F" = (
/turf/open/floor/plating/ground/mars/random/cave,
/area/bigredv2/caves/east)
"H" = (
/turf/closed/mineral/smooth/bigred/indestructible,
/area/bigredv2/caves/rock)
"O" = (
/turf/open/floor/plating/ground/mars/random/cave/rock,
/area/bigredv2/caves/southeast/garbledradio)
"X" = (
/turf/closed/mineral/smooth/bigred/indestructible,
/area/space)

(1,1,1) = {"
j
j
j
j
j
j
j
j
j
j
j
j
j
j
j
j
v
v
v
v
v
v
O
j
j
j
j
j
j
j
j
h
h
h
h
h
h
j
j
j
j
j
j
j
j
j
j
j
j
j
h
h
h
h
j
j
j
j
j
j
j
j
j
j
X
X
a
"}
(2,1,1) = {"
F
j
j
j
j
j
j
j
j
j
j
j
j
j
O
O
v
v
v
j
v
v
O
j
j
j
j
j
j
j
j
h
h
h
h
h
j
j
j
j
j
j
j
j
j
j
j
j
j
j
h
h
h
h
j
j
j
j
j
j
j
j
j
j
j
X
a
"}
(3,1,1) = {"
j
j
j
j
j
j
j
j
j
j
j
j
j
j
v
v
v
v
v
j
O
v
O
j
j
j
j
j
j
j
j
h
h
h
h
h
j
j
j
j
j
j
j
j
j
j
j
j
j
j
h
h
h
h
j
j
j
j
j
j
j
j
j
j
j
X
a
"}
(4,1,1) = {"
j
j
j
j
j
j
j
j
j
j
j
j
j
C
v
v
e
v
j
j
j
v
O
j
j
j
j
j
j
j
j
h
h
h
h
h
j
j
j
j
j
j
j
j
j
j
j
j
j
j
h
h
h
h
j
j
j
j
j
j
j
j
j
j
j
X
a
"}
(5,1,1) = {"
j
j
j
j
j
j
j
j
j
j
j
j
j
v
v
O
v
v
j
j
j
v
O
j
j
j
j
j
j
j
j
h
h
h
h
h
j
j
j
j
j
j
j
j
j
j
j
j
j
j
h
h
A
h
j
j
j
j
j
j
j
j
j
j
j
X
a
"}
(6,1,1) = {"
j
j
j
j
j
j
j
j
j
j
j
O
O
v
v
O
v
v
j
j
j
v
O
v
j
j
j
j
j
j
j
h
h
h
h
h
j
j
j
j
j
j
j
j
j
j
j
j
j
j
h
h
h
h
j
j
j
j
j
j
j
j
j
j
j
X
a
"}
(7,1,1) = {"
j
j
j
j
j
j
j
j
j
j
j
v
v
v
O
v
v
j
j
j
j
v
O
v
v
h
h
h
j
j
j
h
h
h
h
h
j
j
j
j
j
j
j
j
j
j
j
j
j
j
h
h
h
h
j
j
j
j
j
j
j
j
j
j
j
X
a
"}
(8,1,1) = {"
j
j
j
j
j
j
j
j
j
j
j
v
v
e
v
j
j
j
j
j
j
v
O
v
v
v
h
h
h
h
j
h
h
h
h
h
j
j
j
j
j
j
j
j
j
j
j
j
j
j
h
h
h
h
j
j
j
j
j
j
j
j
j
j
j
X
a
"}
(9,1,1) = {"
j
j
j
j
j
j
j
j
j
j
j
v
C
v
v
j
j
j
j
j
j
v
O
v
v
h
h
h
h
h
h
h
h
h
h
h
j
j
j
j
j
j
j
j
j
j
j
j
j
j
h
h
h
h
j
j
j
j
j
j
j
j
j
j
j
X
a
"}
(10,1,1) = {"
j
j
j
j
j
j
j
j
j
j
O
v
O
v
v
j
j
j
j
v
v
e
O
v
v
h
h
h
h
h
h
h
h
h
h
h
j
j
j
j
j
j
j
j
j
j
j
j
j
j
h
h
h
h
j
j
j
j
j
j
j
j
j
j
j
X
a
"}
(11,1,1) = {"
j
j
j
j
j
j
j
j
j
j
v
v
O
v
O
O
O
O
O
v
v
v
O
j
j
j
h
h
h
h
h
h
h
A
h
h
h
j
j
j
j
j
j
j
j
j
j
j
j
j
h
h
h
h
j
j
j
j
j
j
j
j
j
j
j
X
a
"}
(12,1,1) = {"
j
j
j
j
j
j
j
j
j
j
v
v
v
O
v
v
v
v
O
v
v
v
j
j
j
j
j
j
j
h
h
h
A
h
h
h
h
j
j
j
j
j
j
j
j
j
j
j
j
j
h
h
h
j
j
j
j
j
j
j
j
j
j
j
j
X
a
"}
(13,1,1) = {"
j
j
j
j
j
j
j
j
j
j
v
v
v
v
v
v
e
v
v
v
v
v
j
j
j
j
j
j
j
h
h
h
h
h
h
h
h
j
j
j
j
j
j
j
j
j
j
j
j
h
h
h
h
j
j
j
j
j
j
j
j
j
j
j
j
X
a
"}
(14,1,1) = {"
O
v
j
j
j
j
j
j
j
O
v
v
v
v
v
v
v
v
v
v
v
j
j
j
j
j
j
j
j
h
h
h
h
h
h
h
h
h
h
j
j
j
j
j
j
j
j
j
j
h
h
h
A
j
j
j
j
j
j
j
j
j
j
j
j
X
a
"}
(15,1,1) = {"
O
j
j
j
j
j
j
j
j
v
e
v
e
v
v
v
e
v
v
O
j
j
j
j
j
j
j
j
j
h
h
h
h
h
h
h
h
h
h
h
h
j
j
j
j
j
j
j
h
h
h
A
h
j
j
j
j
j
j
j
j
j
j
j
j
X
a
"}
(16,1,1) = {"
O
j
j
j
j
j
j
O
O
v
O
v
v
v
v
v
v
v
v
v
j
j
j
j
j
j
j
j
j
h
h
h
h
h
h
h
h
h
h
h
h
h
h
h
h
j
j
j
h
h
h
h
h
j
j
j
j
j
j
j
j
j
j
j
j
X
a
"}
(17,1,1) = {"
v
j
j
j
j
j
j
v
v
v
O
v
v
v
j
j
j
j
j
j
j
j
j
j
j
j
j
h
h
h
h
h
h
h
h
h
h
h
h
h
h
h
h
h
h
h
h
h
h
h
h
h
j
j
j
j
j
j
j
j
j
j
j
j
j
X
a
"}
(18,1,1) = {"
v
j
j
j
j
j
j
O
v
O
v
v
v
j
j
j
j
j
j
j
j
j
j
j
j
j
j
h
h
h
h
h
h
h
h
h
h
h
h
h
h
h
h
h
h
h
h
h
h
h
h
h
j
j
j
j
j
j
j
j
j
j
j
j
j
X
a
"}
(19,1,1) = {"
v
j
j
j
j
j
v
v
v
O
v
j
j
j
j
j
j
j
j
j
j
j
j
j
j
h
h
h
A
h
h
h
h
A
h
h
h
h
h
h
h
h
A
h
h
h
h
h
h
A
h
A
j
j
j
j
j
j
j
j
j
j
j
j
j
H
a
"}
(20,1,1) = {"
v
j
j
v
v
v
e
v
v
v
e
j
j
j
j
j
j
j
j
j
j
j
j
j
j
h
h
h
h
h
h
h
h
h
h
h
h
h
h
h
h
h
h
h
h
h
h
h
h
h
h
h
j
j
j
j
j
j
j
j
j
j
j
j
j
H
a
"}
(21,1,1) = {"
v
v
v
v
v
v
v
v
O
v
j
j
j
j
j
j
j
i
i
i
i
i
i
i
i
t
h
h
A
h
h
h
h
h
h
h
h
h
h
h
h
h
h
h
h
h
h
h
h
h
h
j
j
j
j
j
j
j
j
j
j
j
j
j
j
H
a
"}
(22,1,1) = {"
v
v
v
v
O
O
v
v
v
v
j
j
j
j
j
j
j
i
j
j
j
h
h
h
h
t
h
h
h
h
h
h
h
h
h
h
h
j
j
j
j
h
h
h
h
h
h
h
h
h
j
j
j
j
j
j
j
j
j
j
j
j
j
j
j
H
a
"}
(23,1,1) = {"
v
e
v
O
v
v
e
v
v
j
j
j
j
j
j
j
j
i
j
j
h
h
h
h
h
t
h
h
h
h
h
h
h
h
h
h
j
j
j
j
j
j
j
j
j
j
j
j
j
j
j
j
j
j
j
j
j
j
j
j
j
j
j
j
j
H
a
"}
(24,1,1) = {"
v
O
O
v
v
v
v
O
j
j
j
j
j
j
j
j
j
i
j
h
h
h
h
h
h
t
h
h
h
h
h
h
h
h
h
h
j
j
j
j
j
j
j
j
j
j
j
j
j
j
j
j
j
j
j
j
j
j
j
j
j
j
j
j
j
H
a
"}
(25,1,1) = {"
O
v
v
O
j
j
j
j
j
j
j
j
j
j
j
j
j
i
j
h
h
h
b
h
h
t
h
h
h
A
h
h
h
h
h
h
j
j
j
j
j
j
j
j
j
j
j
j
j
j
j
j
j
j
j
j
j
j
j
j
j
j
j
j
j
H
a
"}
(26,1,1) = {"
v
v
v
O
j
j
j
j
j
j
j
j
j
j
j
j
j
i
j
h
h
h
h
h
h
t
h
h
A
h
h
h
h
A
h
j
j
j
j
j
j
j
j
j
j
j
j
j
j
j
j
j
j
j
j
j
j
j
j
j
j
j
j
j
j
H
a
"}
(27,1,1) = {"
j
j
j
j
j
j
j
j
j
j
j
j
j
j
j
j
j
i
j
j
h
h
h
h
h
t
h
h
h
h
h
h
h
h
h
j
j
j
j
j
j
j
j
j
j
j
j
j
j
j
j
j
j
j
j
j
j
j
j
j
j
j
j
j
j
H
a
"}
(28,1,1) = {"
j
j
j
j
j
j
j
j
j
j
j
j
j
j
j
j
j
i
j
j
h
h
h
h
h
t
h
h
h
h
h
h
h
h
j
j
j
j
j
j
j
j
j
j
j
j
j
j
j
j
j
j
j
j
j
j
j
j
j
j
j
j
j
j
j
H
a
"}
(29,1,1) = {"
j
j
j
j
j
j
j
j
j
j
j
j
j
j
j
j
j
i
j
j
h
h
h
h
h
t
h
h
h
h
h
h
h
j
j
j
j
j
j
j
j
j
j
j
j
j
j
j
j
j
j
j
j
j
j
j
j
j
j
j
j
j
j
j
j
H
a
"}
(30,1,1) = {"
j
j
j
j
j
j
j
j
j
j
j
j
j
j
j
j
j
i
j
j
j
h
h
h
h
t
h
h
A
h
h
h
j
j
j
j
j
j
j
j
j
j
j
j
j
j
j
j
j
j
j
j
j
j
j
j
j
j
j
j
j
j
j
j
j
H
a
"}
(31,1,1) = {"
j
j
j
j
j
j
j
j
j
j
j
j
j
j
j
j
j
i
j
j
j
j
j
h
h
t
h
A
h
h
h
j
j
j
j
j
j
j
j
j
j
j
j
j
j
j
j
j
j
j
j
j
j
j
j
j
j
j
j
j
j
j
j
j
j
H
a
"}
(32,1,1) = {"
h
h
j
j
j
j
j
j
j
j
j
j
j
j
j
j
j
i
j
j
j
j
j
j
h
t
h
h
h
h
j
j
j
j
j
j
j
j
j
j
j
j
j
j
j
j
j
j
j
j
j
j
j
j
j
j
j
j
j
j
j
j
j
j
j
H
a
"}
(33,1,1) = {"
h
h
h
h
A
j
j
j
j
j
j
j
j
j
j
j
j
i
i
i
i
i
i
i
i
t
h
h
h
h
j
j
j
j
j
j
j
j
j
j
j
j
j
j
j
j
j
j
j
j
j
j
j
j
j
j
j
j
j
j
j
j
j
j
j
H
a
"}
(34,1,1) = {"
h
h
h
h
h
h
h
j
j
j
j
j
j
j
j
j
j
j
j
j
j
j
j
j
j
h
h
h
h
h
j
j
j
j
j
j
j
j
j
j
j
j
j
j
j
j
j
j
j
j
j
j
j
j
j
j
j
j
j
j
j
j
j
j
j
H
a
"}
(35,1,1) = {"
h
h
h
h
h
h
h
j
j
j
j
j
j
j
j
j
j
j
j
j
j
j
j
j
j
h
h
h
h
j
j
j
j
j
j
j
j
j
j
j
j
j
j
j
j
j
j
j
j
j
j
j
j
j
j
j
j
j
j
j
j
j
j
j
j
H
a
"}
(36,1,1) = {"
h
h
h
h
h
h
h
h
j
h
j
j
j
j
j
j
j
j
j
j
j
j
j
j
h
h
h
h
h
j
j
j
j
j
j
j
j
j
j
j
j
j
j
j
j
j
j
j
j
j
j
j
j
j
j
j
j
j
j
j
j
j
j
j
j
H
a
"}
(37,1,1) = {"
h
h
h
h
A
h
h
A
h
h
h
h
j
j
j
j
j
j
j
j
j
j
j
j
h
h
h
h
h
j
j
j
j
j
j
j
j
j
j
j
j
j
j
j
j
j
j
j
j
j
j
j
j
j
j
j
j
j
j
j
j
j
j
j
j
H
a
"}
(38,1,1) = {"
j
j
h
h
h
h
h
h
h
h
h
h
h
h
j
j
j
j
j
j
j
j
j
j
h
h
h
h
h
j
j
j
j
j
j
j
j
j
j
j
j
j
j
j
j
j
j
j
j
j
j
j
j
j
j
j
j
j
j
j
j
j
j
X
X
X
a
"}
(39,1,1) = {"
j
j
h
h
h
h
h
A
h
h
h
h
h
h
A
h
h
h
j
j
j
j
j
h
h
h
h
h
h
j
j
j
j
j
j
j
j
j
j
j
j
j
j
j
j
j
j
j
j
j
j
j
j
j
j
j
j
j
j
j
j
j
j
X
X
X
a
"}
(40,1,1) = {"
j
j
h
h
h
h
h
h
h
h
h
h
h
h
h
h
h
h
h
j
j
j
j
h
h
h
h
h
h
j
j
j
j
j
j
j
j
j
j
j
j
j
j
j
j
j
j
j
j
j
j
j
j
j
j
j
j
j
j
j
j
j
j
X
X
X
a
"}
(41,1,1) = {"
h
h
h
h
h
h
h
h
h
h
h
h
h
h
h
h
h
h
h
h
j
j
h
h
h
h
h
h
h
j
j
j
j
j
j
j
j
j
j
j
j
j
j
j
j
j
j
j
j
j
j
j
j
j
j
j
j
j
j
j
j
j
j
X
X
X
a
"}
(42,1,1) = {"
h
h
h
h
h
h
h
h
h
h
h
h
h
h
h
h
h
h
h
h
h
h
h
h
h
h
h
h
h
j
j
j
j
j
j
j
j
j
j
j
j
j
j
j
j
j
j
j
j
j
j
j
j
j
j
j
j
j
j
j
j
j
j
X
X
X
a
"}
(43,1,1) = {"
h
h
h
h
h
h
h
h
h
h
h
h
h
h
h
h
h
h
h
h
h
h
h
h
h
h
h
h
h
j
j
j
j
j
j
j
j
j
j
j
j
j
j
j
j
j
j
j
j
j
j
j
j
j
j
j
j
j
j
j
j
j
j
X
X
X
a
"}
(44,1,1) = {"
h
h
h
h
h
h
h
h
h
h
h
h
h
h
h
h
h
h
h
h
h
h
h
h
h
h
h
h
h
j
j
j
j
j
j
j
j
j
j
j
j
j
j
j
j
j
j
j
j
j
j
j
j
j
j
j
j
j
j
j
j
j
j
X
X
X
a
"}
(45,1,1) = {"
h
A
h
h
h
h
h
A
h
h
h
h
h
h
A
h
h
h
h
h
h
h
h
h
h
h
h
h
h
j
j
j
j
j
j
j
j
j
j
j
j
j
j
j
j
j
j
j
j
j
j
j
j
j
j
j
j
j
j
j
j
j
j
X
X
X
a
"}
(46,1,1) = {"
h
h
h
h
h
h
h
h
h
j
h
h
h
h
h
h
h
h
h
h
h
h
h
h
h
h
h
h
j
j
j
j
j
j
j
j
j
j
j
j
j
j
j
j
j
j
j
j
j
j
j
j
j
j
j
j
j
j
j
j
j
j
j
X
X
X
a
"}
(47,1,1) = {"
h
h
h
h
h
h
h
h
h
j
j
j
h
h
h
h
h
h
h
h
h
h
h
h
h
h
h
h
j
j
j
j
j
j
j
j
j
j
j
j
j
j
j
j
j
j
j
j
j
j
j
j
j
j
j
j
j
j
j
j
j
j
j
X
X
X
a
"}
(48,1,1) = {"
h
h
h
h
h
h
h
j
j
j
j
j
j
j
j
h
h
h
h
h
h
h
h
h
h
h
h
j
j
j
j
j
j
j
j
j
j
j
j
j
j
j
j
j
j
j
j
j
j
j
j
j
j
j
j
j
j
j
j
j
j
j
j
X
X
X
a
"}
(49,1,1) = {"
h
A
h
h
h
h
j
j
j
j
j
j
j
j
j
j
j
h
h
h
h
h
h
h
h
h
h
j
j
j
j
j
j
j
j
j
j
j
j
j
j
j
j
j
j
j
j
j
j
j
j
j
j
j
j
j
j
j
j
j
j
j
j
X
X
X
a
"}
(50,1,1) = {"
h
h
h
j
j
j
j
j
j
j
j
j
j
j
j
j
j
j
j
h
h
h
h
h
h
j
j
j
j
j
j
j
j
j
j
j
j
j
j
j
j
j
j
j
j
j
j
j
j
j
j
j
j
j
j
j
j
j
j
j
j
j
j
X
X
X
a
"}
(51,1,1) = {"
h
h
h
j
j
j
j
j
j
j
j
j
j
j
j
j
j
j
j
j
j
j
h
h
j
j
j
j
j
j
j
j
j
j
j
j
j
j
j
j
j
j
j
j
j
j
j
j
j
j
j
j
j
j
j
j
j
j
j
j
j
j
j
X
X
X
a
"}
(52,1,1) = {"
j
j
j
j
j
j
j
j
j
j
j
j
j
j
j
j
j
j
j
j
j
j
j
j
j
j
j
j
j
j
j
j
j
j
j
j
j
j
j
j
j
j
j
j
j
j
j
j
j
j
j
j
j
j
j
j
j
j
j
j
j
j
j
X
X
X
a
"}
(53,1,1) = {"
j
j
j
j
j
j
j
j
j
j
j
j
j
j
j
j
j
j
j
j
j
j
j
j
j
j
j
j
j
j
j
j
j
j
j
j
j
j
j
j
j
j
j
j
j
j
j
j
j
j
j
j
j
j
j
j
j
j
j
j
j
j
j
X
X
X
a
"}
(54,1,1) = {"
j
j
j
j
j
j
j
j
j
j
j
j
j
j
j
j
j
j
j
j
j
j
j
j
j
j
j
j
j
j
j
j
j
j
j
j
j
j
j
j
j
j
j
j
j
j
j
j
j
j
j
j
j
j
j
j
j
j
j
j
j
j
j
X
X
X
a
"}
(55,1,1) = {"
j
j
j
j
j
j
j
j
j
j
j
j
j
j
j
j
j
j
j
j
j
j
j
j
j
j
j
j
j
j
j
j
j
j
j
j
j
j
j
j
j
j
j
j
j
j
j
j
j
j
j
j
j
j
j
j
j
j
j
j
j
j
j
X
X
X
a
"}
(56,1,1) = {"
j
j
j
j
j
j
j
j
j
j
j
j
j
j
j
j
j
j
j
j
j
j
j
j
j
j
j
j
j
j
j
j
j
j
j
j
j
j
j
j
j
j
j
j
j
j
j
j
j
j
j
j
j
j
j
j
j
j
j
j
j
j
j
X
X
X
a
"}
(57,1,1) = {"
j
j
j
j
j
j
j
j
j
j
j
j
j
j
j
j
j
j
j
j
j
j
j
j
j
j
j
j
j
j
j
j
j
j
j
j
j
j
j
j
j
j
j
j
j
j
j
j
j
j
j
j
j
j
j
j
j
j
j
j
j
j
j
X
X
X
a
"}
(58,1,1) = {"
j
j
j
j
j
j
j
j
j
j
j
j
j
j
j
j
j
j
j
j
j
j
j
j
j
j
j
j
j
j
j
j
j
j
j
j
j
j
j
j
j
j
j
j
j
j
j
j
j
j
j
j
j
j
j
j
j
j
j
j
j
j
j
X
X
X
a
"}
(59,1,1) = {"
j
j
j
j
j
j
j
j
j
j
j
j
j
j
j
j
j
j
j
j
j
j
j
j
j
j
j
j
j
j
j
j
j
j
j
j
j
j
j
j
j
j
j
j
j
j
j
j
j
j
j
j
j
j
j
j
j
j
j
j
j
j
j
X
X
X
a
"}
(60,1,1) = {"
j
j
j
j
j
j
j
j
j
j
j
j
j
j
j
j
j
j
j
j
j
j
j
j
j
j
j
j
j
j
j
j
j
j
j
j
j
j
j
j
j
j
j
j
j
j
j
j
j
j
j
j
j
j
j
j
j
j
j
j
j
j
j
X
X
X
a
"}
(61,1,1) = {"
j
j
j
j
j
j
j
j
j
j
j
j
j
j
j
j
j
j
j
j
j
j
j
j
j
j
j
j
j
j
j
j
j
j
j
j
j
j
j
j
j
j
j
j
j
j
j
j
j
j
j
j
j
j
j
j
j
j
j
j
j
j
j
X
X
X
a
"}
(62,1,1) = {"
j
j
j
j
j
j
j
j
j
j
j
j
j
j
j
j
j
j
j
j
j
j
j
j
j
j
j
j
j
j
j
j
j
j
j
j
j
j
j
j
j
j
j
j
j
j
j
j
j
j
j
j
j
j
j
j
j
j
j
j
j
j
j
X
X
X
a
"}
(63,1,1) = {"
X
X
X
X
X
X
X
X
X
X
X
X
X
X
X
X
X
X
X
X
X
X
X
X
X
X
X
X
X
X
X
X
X
X
X
X
X
X
X
X
X
X
X
X
X
X
X
X
X
X
X
X
X
X
X
X
X
X
X
X
X
X
X
X
X
X
a
"}
(64,1,1) = {"
X
X
X
X
X
X
X
X
X
X
X
X
X
X
X
X
X
X
X
X
X
X
X
X
X
X
X
X
X
X
X
X
X
X
X
X
X
X
X
X
X
X
X
X
X
X
X
X
X
X
X
X
X
X
X
X
X
X
X
X
X
X
X
X
X
X
a
"}
(65,1,1) = {"
X
X
X
X
X
X
X
X
X
X
X
X
X
X
X
X
X
X
X
X
X
X
X
X
X
X
X
X
X
X
X
X
X
X
X
X
X
X
X
X
X
X
X
X
X
X
X
X
X
X
X
X
X
X
X
X
X
X
X
X
X
X
X
X
X
X
a
"}
(66,1,1) = {"
X
X
X
X
X
X
X
X
X
X
X
X
X
X
X
X
X
X
X
X
X
X
X
X
X
X
X
X
X
X
X
X
X
X
X
X
X
X
X
X
X
X
X
X
X
X
X
X
X
X
X
X
X
X
X
X
X
X
X
X
X
X
X
X
X
X
a
"}
(67,1,1) = {"
X
X
X
X
X
X
X
X
X
X
X
X
X
X
X
X
X
X
X
X
X
X
X
X
X
X
X
X
X
X
X
X
X
X
X
X
X
X
X
X
X
X
X
X
X
X
X
X
X
X
X
X
X
X
X
X
X
X
X
X
X
X
X
X
X
X
a
"}
(68,1,1) = {"
X
X
X
X
X
X
X
X
X
X
X
X
X
X
X
X
X
X
X
X
X
X
X
X
X
X
X
X
X
X
X
X
X
X
X
X
X
X
X
X
X
X
X
X
X
X
X
X
X
X
X
X
X
X
X
X
X
X
X
X
X
X
X
X
X
X
a
"}
(69,1,1) = {"
X
X
X
X
X
X
X
X
X
X
X
X
X
X
X
X
X
X
X
X
X
X
X
X
X
X
X
X
X
X
X
X
X
X
X
X
X
X
X
X
X
X
X
X
X
X
X
X
X
X
X
X
X
X
X
X
X
X
X
X
X
X
X
X
X
X
a
"}
(70,1,1) = {"
X
X
X
X
X
X
X
X
X
X
X
X
X
X
X
X
X
X
X
X
X
X
X
X
X
X
X
X
X
X
X
X
X
X
X
X
X
X
X
X
X
X
X
X
X
X
X
X
X
X
X
X
X
X
X
X
X
X
X
X
X
X
X
X
X
X
a
"}
(71,1,1) = {"
X
X
X
X
X
X
X
X
X
X
X
X
X
X
X
X
X
X
X
X
X
X
X
X
X
X
X
X
X
X
X
X
X
X
X
X
X
X
X
X
X
X
X
X
X
X
X
X
X
X
X
X
X
X
X
X
X
X
X
X
X
X
X
X
X
X
a
"}
