//MAP CONVERTED BY dmm2tgm.py THIS HEADER COMMENT PREVENTS RECONVERSION, DO NOT REMOVE
"ax" = (
/obj/structure/cable,
/obj/effect/ai_node,
/turf/open/floor/asteroidfloor,
/area/bigredv3/outside/directions/nw)
"bq" = (
/obj/effect/decal/cleanable/dirt,
/obj/structure/cable,
/turf/open/floor/asteroidfloor,
/area/bigredv3/outside/directions/nw)
"bz" = (
/turf/open/floor/marking/asteroidwarning{
	dir = 4
	},
/area/bigredv3/outside/directions/nw)
"cS" = (
/turf/open/floor/plating/ground/mars/random/dirt,
/area/bigredv3/outside/medical/virology)
"dw" = (
/turf/closed/wall/r_wall,
/area/bigredv3/inside/wall)
"dI" = (
/obj/effect/decal/cleanable/dirt,
/obj/effect/decal/cleanable/dirt,
/obj/effect/decal/cleanable/dirt,
/turf/open/floor/marking/asteroidwarning{
	dir = 8
	},
/area/bigredv3/outside/directions/nw)
"dP" = (
/obj/structure/cable,
/obj/machinery/atmospherics/pipe/simple/green/hidden,
/obj/effect/ai_node,
/turf/open/floor/asteroidfloor,
/area/bigredv3/outside/directions/nw)
"dZ" = (
/turf/open/floor/plating/ground/mars/random/sand,
/area/bigredv3/outside/medical/virology)
"eF" = (
/obj/effect/decal/cleanable/dirt,
/obj/effect/decal/cleanable/dirt,
/obj/effect/decal/cleanable/dirt,
/turf/open/floor/marking/asteroidwarning{
	dir = 9
	},
/area/bigredv3/outside/directions/nw)
"eT" = (
/obj/effect/decal/cleanable/dirt,
/turf/open/floor/plating/ground/mars/random/dirt,
/area/bigredv3/outside/directions/nw)
"ft" = (
/obj/machinery/atmospherics/pipe/simple/green/hidden,
/obj/structure/cable,
/turf/open/floor/marking/asteroidwarning{
	dir = 4
	},
/area/bigredv3/outside/directions/nw)
"gs" = (
/obj/effect/decal/cleanable/dirt,
/turf/open/floor/marking/asteroidwarning{
	dir = 8
	},
/area/bigredv3/outside/directions/nw)
"gQ" = (
/turf/open/floor/tile/white,
/area/bigredv3/outside/directions/nw)
"hn" = (
/obj/effect/decal/cleanable/dirt,
/obj/structure/cable,
/obj/effect/decal/cleanable/dirt,
/turf/open/floor/plating,
/area/bigredv3/outside/directions/nw)
"hu" = (
/obj/structure/cable,
/obj/machinery/atmospherics/pipe/simple/green/hidden,
/obj/effect/decal/cleanable/dirt,
/turf/open/floor/marking/asteroidwarning{
	dir = 1
	},
/area/bigredv3/outside/directions/nw)
"hx" = (
/turf/open/floor/plating/ground/mars/dirttosand/autosmooth{
	dir = 4
	},
/area/bigredv3/caves/northwest)
"hH" = (
/obj/effect/decal/cleanable/dirt,
/obj/effect/decal/cleanable/dirt,
/turf/open/floor/marking/asteroidwarning{
	dir = 10
	},
/area/bigredv3/outside/directions/nw)
"hZ" = (
/obj/machinery/atmospherics/pipe/simple/green/hidden{
	dir = 4
	},
/obj/structure/cable,
/turf/open/floor/marking/asteroidwarning{
	dir = 1
	},
/area/bigredv3/outside/directions/nw)
"io" = (
/turf/open/floor/plating/ground/mars/cavetodirt{
	dir = 6
	},
/area/bigredv3/caves/west)
"jc" = (
/obj/effect/decal/cleanable/dirt,
/turf/open/floor/marking/asteroidwarning{
	dir = 6
	},
/area/bigredv3/outside/directions/nw)
"jD" = (
/obj/structure/cargo_container/horizontal{
	dir = 4
	},
/turf/open/floor/plating,
/area/bigredv3/outside/directions/nw)
"kj" = (
/turf/open/floor/marking/asteroidwarning{
	dir = 1
	},
/area/bigredv3/outside/medical/virology)
"kB" = (
/turf/open/floor/marking/asteroidwarning,
/area/bigredv3/outside/directions/nw)
"kC" = (
/obj/machinery/atmospherics/pipe/simple/green/hidden{
	dir = 4
	},
/obj/structure/cable,
/obj/effect/decal/cleanable/dirt,
/turf/open/floor/plating,
/area/bigredv3/outside/directions/nw)
"kH" = (
/obj/structure/cargo_container/green,
/turf/open/floor/plating,
/area/bigredv3/outside/directions/nw)
"kP" = (
/obj/structure/largecrate/random/case/double,
/turf/open/floor/plating,
/area/bigredv3/outside/directions/nw)
"lr" = (
/obj/structure/cable,
/turf/open/floor/marking/asteroidwarning{
	dir = 8
	},
/area/bigredv3/outside/directions/nw)
"lJ" = (
/turf/open/floor/plating/ground/mars/dirttosand/autosmooth{
	dir = 6
	},
/area/bigredv3/caves/northwest)
"lM" = (
/obj/structure/cable,
/obj/machinery/atmospherics/pipe/simple/green/hidden,
/turf/open/floor/marking/asteroidwarning{
	dir = 4
	},
/area/bigredv3/outside/directions/nw)
"lU" = (
/obj/effect/turf_decal/sandedge/corner2,
/turf/open/floor/plating/ground/mars/random/sand,
/area/bigredv3/caves/northwest)
"lZ" = (
/obj/effect/ai_node,
/turf/open/floor/plating/ground/mars/random/cave/rock,
/area/bigredv3/caves/west)
"mA" = (
/turf/open/floor/plating/ground/mars/dirttosand/autosmooth{
	dir = 8
	},
/area/bigredv3/outside/directions/nw)
"mV" = (
/turf/open/floor/plating/warning{
	dir = 8
	},
/area/bigredv3/outside/directions/nw)
"nP" = (
/turf/open/floor/plating/warning{
	dir = 1
	},
/area/bigredv3/outside/directions/nw)
"ob" = (
/obj/machinery/atmospherics/pipe/simple/green/hidden,
/turf/open/floor/plating/warning{
	dir = 1
	},
/area/bigredv3/outside/directions/nw)
"oF" = (
/obj/structure/cable,
/turf/open/floor/marking/asteroidwarning{
	dir = 1
	},
/area/bigredv3/outside/directions/nw)
"qu" = (
/obj/structure/rack,
/turf/open/floor/plating,
/area/bigredv3/outside/directions/nw)
"qC" = (
/obj/effect/decal/cleanable/dirt,
/turf/open/floor/marking/asteroidwarning{
	dir = 4
	},
/area/bigredv3/outside/directions/nw)
"qJ" = (
/obj/structure/cable,
/obj/machinery/power/apc/weak/ntf,
/turf/open/floor/plating,
/area/bigredv3/outside/directions/nw)
"qY" = (
/obj/machinery/atmospherics/pipe/simple/green/hidden,
/turf/open/floor/marking/asteroidwarning{
	dir = 4
	},
/area/bigredv3/outside/directions/nw)
"rn" = (
/obj/effect/ai_node,
/turf/open/floor/plating/ground/mars/random/sand,
/area/bigredv3/outside/directions/nw)
"rw" = (
/obj/machinery/light{
	dir = 8
	},
/turf/open/floor/marking/asteroidwarning{
	dir = 1
	},
/area/bigredv3/outside/directions/nw)
"sf" = (
/obj/machinery/atmospherics/pipe/simple/green/hidden,
/turf/open/floor/marking/asteroidwarning{
	dir = 1
	},
/area/bigredv3/outside/directions/nw)
"tt" = (
/obj/effect/ai_node,
/turf/open/floor/plating/ground/mars/random/cave,
/area/bigredv3/caves/northwest)
"uu" = (
/obj/effect/ai_node,
/turf/open/floor/plating/ground/mars/random/dirt,
/area/bigredv3/outside/medical/virology)
"uS" = (
/obj/machinery/light,
/turf/open/floor/plating,
/area/bigredv3/outside/directions/nw)
"uV" = (
/obj/structure/cable,
/turf/open/floor/plating/warning{
	dir = 1
	},
/area/bigredv3/outside/directions/nw)
"uW" = (
/obj/structure/cable,
/obj/machinery/atmospherics/pipe/simple/green/hidden{
	dir = 4
	},
/turf/open/floor/asteroidfloor,
/area/bigredv3/outside/directions/nw)
"wb" = (
/turf/open/floor/plating/ground/mars/dirttosand/autosmooth{
	dir = 1
	},
/area/bigredv3/outside/directions/nw)
"wf" = (
/obj/effect/ai_node,
/turf/open/floor/asteroidfloor,
/area/bigredv3/outside/directions/nw)
"wg" = (
/obj/machinery/light{
	dir = 4
	},
/turf/open/floor/marking/asteroidwarning{
	dir = 1
	},
/area/bigredv3/outside/medical/virology)
"wV" = (
/turf/open/floor/marking/asteroidwarning{
	dir = 10
	},
/area/bigredv3/outside/directions/nw)
"xa" = (
/obj/structure/cable,
/turf/open/floor/plating,
/area/bigredv3/outside/directions/nw)
"xL" = (
/obj/effect/decal/cleanable/dirt,
/turf/open/floor/marking/asteroidwarning,
/area/bigredv3/outside/directions/nw)
"yf" = (
/obj/effect/spawner/random/engineering/structure/tank/fuelweighted,
/turf/open/floor/plating,
/area/bigredv3/outside/directions/nw)
"yq" = (
/obj/effect/spawner/random/misc/structure/barrel,
/turf/open/floor/plating,
/area/bigredv3/outside/directions/nw)
"zj" = (
/obj/effect/ai_node,
/obj/effect/decal/cleanable/dirt,
/turf/open/floor/plating,
/area/bigredv3/outside/directions/nw)
"zO" = (
/turf/open/floor/plating/ground/mars/dirttosand/autosmooth{
	dir = 4
	},
/area/bigredv3/outside/directions/nw)
"zP" = (
/turf/open/floor/marking/asteroidwarning{
	dir = 4
	},
/area/bigredv3/outside/medical/virology)
"zR" = (
/obj/effect/decal/cleanable/blood,
/turf/open/floor/plating/ground/mars/random/sand,
/area/bigredv3/outside/directions/nw)
"zT" = (
/obj/effect/decal/cleanable/dirt,
/obj/effect/ai_node,
/turf/open/floor/marking/asteroidwarning{
	dir = 8
	},
/area/bigredv3/outside/directions/nw)
"Ac" = (
/turf/open/floor/plating/ground/mars/random/cave/rock,
/area/bigredv3/caves/northwest)
"AC" = (
/obj/machinery/light{
	dir = 8
	},
/turf/open/floor/plating,
/area/bigredv3/outside/directions/nw)
"AT" = (
/obj/effect/ai_node,
/turf/open/floor/plating,
/area/bigredv3/outside/directions/nw)
"BW" = (
/obj/machinery/light,
/obj/effect/spawner/random/misc/structure/supplycrate/normalweighted,
/turf/open/floor/plating,
/area/bigredv3/outside/directions/nw)
"Cj" = (
/turf/open/floor/plating/ground/mars/random/cave,
/area/bigredv3/caves/west)
"Cq" = (
/obj/machinery/light{
	dir = 1
	},
/obj/structure/largecrate/random/case/small,
/turf/open/floor/plating,
/area/bigredv3/outside/directions/nw)
"Du" = (
/obj/machinery/light{
	dir = 8
	},
/turf/open/floor/asteroidfloor,
/area/bigredv3/outside/directions/nw)
"Ea" = (
/turf/open/floor/plating,
/area/bigredv3/outside/directions/nw)
"Ee" = (
/obj/structure/cable,
/obj/machinery/atmospherics/pipe/simple/green/hidden{
	dir = 4
	},
/turf/open/floor/plating/warning{
	dir = 8
	},
/area/bigredv3/outside/directions/nw)
"EG" = (
/turf/open/floor/plating/ground/mars/random/dirt,
/area/bigredv3/caves/west)
"ES" = (
/turf/open/floor/plating/ground/mars/random/sand,
/area/bigredv3/caves/northwest)
"EU" = (
/turf/open/floor/marking/asteroidwarning{
	dir = 5
	},
/area/bigredv3/outside/medical/virology)
"Hr" = (
/turf/open/floor/plating/ground/mars/dirttosand/autosmooth{
	dir = 5
	},
/area/bigredv3/outside/medical/virology)
"Hz" = (
/obj/effect/turf_decal/sandedge,
/turf/open/floor/plating/ground/mars/random/sand,
/area/bigredv3/caves/northwest)
"HZ" = (
/obj/structure/cargo_container/hd_blue{
	dir = 1
	},
/turf/open/floor/plating,
/area/bigredv3/outside/directions/nw)
"IG" = (
/obj/machinery/atmospherics/pipe/simple/green/hidden,
/obj/structure/cable,
/turf/open/floor/plating,
/area/bigredv3/outside/directions/nw)
"IP" = (
/turf/closed/mineral/smooth/bigred/indestructible,
/area/space)
"IS" = (
/obj/machinery/light{
	dir = 1
	},
/turf/open/floor/plating,
/area/bigredv3/outside/directions/nw)
"Jr" = (
/obj/effect/spawner/random/misc/structure/barrel,
/obj/effect/decal/cleanable/dirt,
/turf/open/floor/plating,
/area/bigredv3/outside/directions/nw)
"JC" = (
/obj/effect/ai_node,
/turf/open/floor/plating/ground/mars/random/cave,
/area/bigredv3/caves/west)
"JE" = (
/turf/open/floor/plating/ground/mars/dirttosand/autosmooth{
	dir = 5
	},
/area/bigredv3/outside/directions/nw)
"JJ" = (
/obj/machinery/floodlight/outpost/bigred,
/turf/open/floor/plating/ground/mars/random/sand,
/area/bigredv3/outside/directions/nw)
"JN" = (
/obj/structure/cargo_container/hd_blue{
	dir = 8
	},
/turf/open/floor/plating,
/area/bigredv3/outside/directions/nw)
"Km" = (
/turf/open/floor/plating/ground/mars/random/sand,
/area/bigredv3/outside/directions/nw)
"KP" = (
/obj/effect/decal/cleanable/dirt,
/turf/closed/wall/r_wall,
/area/bigredv3/inside/wall)
"Ls" = (
/turf/open/floor/plating/ground/mars/random/dirt,
/area/bigredv3/outside/directions/nw)
"LE" = (
/obj/structure/fence/standard/xenoproof,
/turf/open/floor/plating/ground/mars/cavetodirt{
	dir = 4
	},
/area/bigredv3/caves/west)
"LK" = (
/obj/effect/ai_node,
/turf/open/floor/marking/asteroidwarning{
	dir = 4
	},
/area/bigredv3/outside/medical/virology)
"LS" = (
/turf/open/floor/marking/asteroidwarning{
	dir = 5
	},
/area/bigredv3/outside/directions/nw)
"LY" = (
/obj/structure/cable,
/obj/effect/decal/cleanable/dirt,
/turf/open/floor/plating,
/area/bigredv3/outside/directions/nw)
"Mf" = (
/obj/machinery/light{
	dir = 1
	},
/turf/open/floor/plating/ground/mars/dirttosand/autosmooth{
	dir = 5
	},
/area/bigredv3/outside/medical/virology)
"Mr" = (
/obj/machinery/atmospherics/pipe/simple/green/hidden{
	dir = 4
	},
/obj/structure/cable,
/obj/effect/ai_node,
/turf/open/floor/plating,
/area/bigredv3/outside/directions/nw)
"Nb" = (
/obj/machinery/atmospherics/pipe/manifold/green/hidden,
/obj/structure/cable,
/turf/open/floor/plating,
/area/bigredv3/outside/directions/nw)
"Nj" = (
/obj/machinery/atmospherics/pipe/simple/green/hidden{
	dir = 4
	},
/obj/structure/cable,
/turf/open/floor/plating,
/area/bigredv3/outside/directions/nw)
"NK" = (
/obj/structure/cargo_container/green{
	dir = 4
	},
/turf/open/floor/plating,
/area/bigredv3/outside/directions/nw)
"NW" = (
/obj/structure/cable,
/turf/open/floor/marking/asteroidwarning,
/area/bigredv3/outside/directions/nw)
"Oi" = (
/turf/open/floor/asteroidfloor,
/area/bigredv3/outside/directions/nw)
"Os" = (
/turf/open/floor/plating/ground/mars/dirttosand/autosmooth{
	dir = 5
	},
/area/bigredv3/caves/northwest)
"OQ" = (
/obj/structure/cargo_container/horizontal,
/turf/open/floor/plating,
/area/bigredv3/outside/directions/nw)
"Pd" = (
/turf/open/floor/marking/asteroidwarning{
	dir = 1
	},
/area/bigredv3/outside/directions/nw)
"Pz" = (
/turf/open/floor/plating/ground/mars/dirttosand/autosmooth{
	dir = 9
	},
/area/bigredv3/outside/directions/nw)
"PP" = (
/obj/structure/cable,
/obj/machinery/atmospherics/pipe/simple/green/hidden{
	dir = 5
	},
/turf/open/floor/asteroidfloor,
/area/bigredv3/outside/directions/nw)
"PX" = (
/turf/open/floor/plating/ground/mars/random/cave,
/area/bigredv3/caves/northwest)
"Qe" = (
/turf/open/floor/marking/asteroidwarning{
	dir = 8
	},
/area/bigredv3/outside/medical/virology)
"Qs" = (
/obj/effect/decal/cleanable/dirt,
/turf/open/floor/marking/asteroidwarning{
	dir = 1
	},
/area/bigredv3/outside/directions/nw)
"QI" = (
/obj/machinery/atmospherics/pipe/simple/green/hidden{
	dir = 10
	},
/obj/structure/cable,
/turf/open/floor/marking/asteroidwarning{
	dir = 5
	},
/area/bigredv3/outside/directions/nw)
"QZ" = (
/obj/structure/cargo_container/horizontal{
	dir = 1
	},
/turf/open/floor/plating,
/area/bigredv3/outside/directions/nw)
"Rk" = (
/obj/structure/cable,
/obj/machinery/atmospherics/pipe/simple/green/hidden{
	dir = 6
	},
/obj/effect/ai_node,
/turf/open/floor/plating,
/area/bigredv3/outside/directions/nw)
"Rm" = (
/obj/structure/cargo_container/green{
	dir = 1
	},
/turf/open/floor/plating,
/area/bigredv3/outside/directions/nw)
"RA" = (
/obj/machinery/atmospherics/pipe/simple/green/hidden{
	dir = 4
	},
/obj/structure/cable,
/turf/open/floor/asteroidfloor,
/area/bigredv3/outside/directions/nw)
"RN" = (
/obj/effect/spawner/random/misc/structure/supplycrate/normalweighted,
/turf/open/floor/plating,
/area/bigredv3/outside/directions/nw)
"Sj" = (
/turf/open/floor/asteroidfloor,
/area/bigredv3/outside/medical/virology)
"Tc" = (
/obj/machinery/light{
	dir = 1
	},
/turf/open/floor/plating/ground/mars/random/dirt,
/area/bigredv3/outside/medical/virology)
"Tf" = (
/obj/effect/decal/cleanable/dirt,
/turf/open/floor/plating,
/area/bigredv3/outside/directions/nw)
"Tt" = (
/turf/open/floor/plating/ground/mars/random/cave/rock,
/area/bigredv3/caves/west)
"TL" = (
/obj/effect/decal/cleanable/dirt,
/turf/open/floor/marking/asteroidwarning{
	dir = 5
	},
/area/bigredv3/outside/directions/nw)
"Up" = (
/obj/structure/cargo_container/hd_blue{
	dir = 4
	},
/turf/open/floor/plating,
/area/bigredv3/outside/directions/nw)
"Uw" = (
/turf/closed/mineral/smooth/bigred,
/area/bigredv3/caves/rock)
"UG" = (
/obj/machinery/light,
/obj/effect/spawner/random/engineering/structure/tank/fuelweighted,
/turf/open/floor/plating,
/area/bigredv3/outside/directions/nw)
"UL" = (
/obj/effect/turf_decal/sandedge{
	dir = 4
	},
/obj/structure/fence/standard/xenoproof,
/turf/open/floor/plating/ground/mars/random/dirt,
/area/bigredv3/caves/northwest)
"Vb" = (
/turf/open/floor/marking/asteroidwarning{
	dir = 8
	},
/area/bigredv3/outside/directions/nw)
"Vf" = (
/turf/open/floor/marking/asteroidwarning{
	dir = 9
	},
/area/bigredv3/outside/medical/virology)
"Vv" = (
/obj/structure/fence/standard/xenoproof,
/turf/open/floor/plating/ground/mars/random/cave,
/area/bigredv3/caves/west)
"VR" = (
/obj/effect/decal/cleanable/dirt,
/obj/effect/ai_node,
/turf/open/floor/marking/asteroidwarning{
	dir = 10
	},
/area/bigredv3/outside/directions/nw)
"VW" = (
/turf/open/floor/marking/asteroidwarning{
	dir = 9
	},
/area/bigredv3/outside/directions/nw)
"WW" = (
/obj/machinery/atmospherics/pipe/simple/green/hidden{
	dir = 4
	},
/obj/structure/cable,
/obj/machinery/door/airlock/multi_tile/mainship/medidoor{
	dir = 1;
	name = "\improper Medical Clinic"
	},
/turf/open/floor/tile/white,
/area/bigredv3/outside/directions/nw)
"Xs" = (
/obj/effect/decal/cleanable/dirt,
/turf/open/floor/asteroidfloor,
/area/bigredv3/outside/directions/nw)
"YE" = (
/obj/machinery/atmospherics/pipe/simple/green/hidden,
/obj/structure/cable,
/obj/effect/ai_node,
/turf/open/floor/marking/asteroidwarning{
	dir = 4
	},
/area/bigredv3/outside/directions/nw)
"YG" = (
/obj/structure/cable,
/obj/machinery/atmospherics/pipe/simple/green/hidden,
/turf/open/floor/plating,
/area/bigredv3/outside/directions/nw)
"ZM" = (
/turf/open/floor/plating/ground/mars/dirttosand/autosmooth,
/area/bigredv3/outside/directions/nw)
"ZT" = (
/obj/structure/cable,
/turf/open/floor/asteroidfloor,
/area/bigredv3/outside/directions/nw)
"ZY" = (
/obj/structure/fence/standard/xenoproof,
/turf/open/floor/plating/ground/mars/dirttosand/autosmooth{
	dir = 6
	},
/area/bigredv3/caves/northwest)

(1,1,1) = {"
IP
IP
IP
IP
IP
IP
IP
IP
IP
IP
IP
IP
IP
IP
IP
IP
IP
IP
IP
IP
IP
IP
"}
(2,1,1) = {"
Uw
Uw
Uw
Uw
Uw
Uw
Uw
Uw
Uw
Uw
Uw
Uw
Uw
Uw
Uw
Uw
Uw
Uw
Uw
Uw
Uw
Uw
"}
(3,1,1) = {"
Uw
Uw
Uw
Uw
Uw
Uw
Uw
Uw
Uw
Uw
Uw
Uw
Uw
Uw
Uw
Uw
Tt
Tt
Tt
Tt
Uw
Uw
"}
(4,1,1) = {"
Uw
Uw
Uw
Uw
Uw
Uw
Uw
Uw
Uw
Uw
Uw
Uw
Uw
Uw
Uw
Tt
Cj
Cj
Cj
Cj
Tt
Uw
"}
(5,1,1) = {"
Uw
Uw
Uw
Uw
Uw
Uw
Uw
Uw
Uw
Uw
Uw
Uw
Uw
Uw
Tt
Cj
Cj
Cj
Cj
Cj
Cj
Tt
"}
(6,1,1) = {"
Uw
Uw
Uw
Uw
Uw
Uw
Uw
Uw
Uw
Uw
Uw
Uw
Uw
Uw
Cj
Cj
Cj
Cj
Cj
Cj
Cj
Cj
"}
(7,1,1) = {"
Uw
Uw
Uw
Uw
Uw
Uw
Uw
Uw
Uw
Uw
Uw
Uw
Uw
Ac
Cj
Cj
Cj
Cj
Cj
Cj
Tt
Cj
"}
(8,1,1) = {"
Uw
Uw
Uw
Uw
Uw
Uw
Uw
Uw
PX
PX
PX
PX
PX
tt
Cj
Cj
Cj
Cj
Cj
Cj
lZ
Cj
"}
(9,1,1) = {"
Uw
PX
PX
PX
PX
PX
PX
PX
PX
PX
PX
PX
PX
PX
Cj
Cj
Cj
Cj
Cj
Cj
Tt
Cj
"}
(10,1,1) = {"
PX
PX
PX
PX
PX
PX
PX
PX
PX
PX
PX
PX
Ac
PX
Cj
Cj
Cj
Cj
Cj
Cj
Tt
Cj
"}
(11,1,1) = {"
PX
PX
PX
PX
PX
Ac
PX
PX
PX
PX
PX
PX
PX
PX
Cj
Cj
Cj
Cj
Cj
Cj
Tt
Uw
"}
(12,1,1) = {"
PX
PX
Ac
Ac
PX
PX
tt
PX
PX
PX
PX
tt
PX
tt
Cj
Cj
Cj
Cj
Cj
Cj
lZ
Uw
"}
(13,1,1) = {"
Ac
PX
PX
PX
PX
PX
PX
PX
PX
PX
PX
Ac
PX
PX
Cj
Cj
Cj
Cj
Cj
Cj
Cj
Tt
"}
(14,1,1) = {"
PX
PX
PX
PX
PX
PX
Uw
Uw
Uw
ZY
UL
UL
UL
ZY
Uw
Uw
Uw
Cj
Cj
Cj
JC
Tt
"}
(15,1,1) = {"
PX
PX
PX
PX
PX
Uw
Uw
Uw
Uw
Os
hx
hx
lJ
ES
Uw
Uw
Uw
Cj
Uw
Uw
Vv
LE
"}
(16,1,1) = {"
PX
PX
PX
Uw
Uw
Uw
Uw
Uw
Uw
dw
dw
dw
dw
dw
Uw
Uw
Uw
Uw
Uw
Uw
io
EG
"}
(17,1,1) = {"
PX
PX
Uw
Uw
Uw
Uw
Uw
Uw
Uw
ES
ES
ES
ES
ES
Uw
Uw
Uw
Uw
dw
dw
dw
dw
"}
(18,1,1) = {"
Uw
Uw
Uw
Uw
Uw
Uw
Uw
dw
dw
dw
dw
KP
dw
dw
dw
Uw
Uw
Uw
dw
cS
cS
cS
"}
(19,1,1) = {"
Uw
Uw
Uw
Uw
Uw
Uw
Uw
dw
yq
Ea
Ea
Tf
Tf
Ea
dw
dw
dw
dw
dw
cS
cS
cS
"}
(20,1,1) = {"
Uw
Uw
Uw
Uw
Uw
Uw
Uw
dw
IS
Ea
Ea
AT
Ea
Ea
Ea
QZ
jD
OQ
dw
cS
uu
Vf
"}
(21,1,1) = {"
Uw
Uw
Uw
Uw
Uw
Uw
Uw
dw
Ea
Ea
Ea
Ea
zj
Tf
Ea
Ea
Ea
Ea
dw
Mf
cS
kj
"}
(22,1,1) = {"
Uw
Uw
Uw
Uw
Uw
Uw
Uw
dw
Ea
Ea
Ea
Tf
Ea
AT
Tf
Ea
AT
uS
dw
dZ
Hr
kj
"}
(23,1,1) = {"
Uw
Uw
Uw
Uw
Uw
Uw
Uw
dw
Ea
Ea
kH
RN
Ea
Ea
Tf
Ea
Tf
Ea
dw
dZ
dZ
kj
"}
(24,1,1) = {"
Uw
Uw
Uw
Uw
Uw
Uw
Uw
dw
Ea
Ea
Rm
RN
Ea
Ea
kH
Ea
Tf
Ea
Vf
Qe
Qe
Sj
"}
(25,1,1) = {"
Uw
Uw
Uw
Uw
Uw
Uw
Uw
dw
Ea
Ea
NK
Ea
Ea
Ea
Rm
Tf
Tf
AT
kj
Sj
Sj
Sj
"}
(26,1,1) = {"
Uw
Uw
Uw
Uw
Uw
Uw
Uw
dw
Ea
Ea
yq
Ea
Ea
Ea
NK
Ea
AT
Ea
EU
zP
LK
Sj
"}
(27,1,1) = {"
Uw
Uw
Uw
Uw
Uw
Uw
dw
dw
Ea
Ea
Ea
Tf
Tf
Tf
Jr
Tf
Ea
Ea
dw
cS
cS
kj
"}
(28,1,1) = {"
Hz
ES
Uw
Uw
Uw
Uw
dw
Ea
Ea
Tf
AT
Ea
AT
Ea
Tf
Ea
AT
Ea
dw
cS
cS
kj
"}
(29,1,1) = {"
Hz
ES
ES
Uw
Uw
Uw
dw
Ea
Ea
Ea
Tf
Tf
Ea
JN
Ea
Ea
Ea
RN
dw
Tc
cS
kj
"}
(30,1,1) = {"
Hz
ES
Km
JJ
Km
Km
dw
IS
Ea
Tf
Tf
Ea
Ea
HZ
Tf
Tf
Ea
BW
dw
cS
cS
kj
"}
(31,1,1) = {"
lU
Km
Km
Km
Pz
mA
dw
Ea
Ea
Ea
Ea
Ea
Ea
Up
Ea
Ea
Ea
RN
dw
cS
Vf
Qe
"}
(32,1,1) = {"
Pz
mA
mA
mA
Ls
Ls
dw
Ea
Ea
Tf
Ea
Ea
RN
Ea
Ea
Ea
Ea
Ea
dw
cS
wg
Sj
"}
(33,1,1) = {"
wb
VW
lr
gs
Vb
gs
wV
Tf
Tf
Ea
Tf
Ea
Ea
Ea
Tf
eF
dI
hH
dw
dw
dw
Sj
"}
(34,1,1) = {"
wb
Pd
ax
bq
bq
bq
NW
LY
hn
xa
Rk
YG
YG
YG
YG
hu
dP
PP
VR
Ls
rw
Oi
"}
(35,1,1) = {"
wb
Pd
Oi
Oi
bz
bz
jc
Ea
Ea
Ea
kC
Ea
Ea
Ea
Ea
Qs
Xs
RA
xL
Ls
LS
bz
"}
(36,1,1) = {"
wb
Pd
Xs
xL
eT
Ls
dw
Ea
Ea
Tf
Nj
Tf
Ea
Ea
Ea
TL
qC
uW
xL
Ls
Ls
Pd
"}
(37,1,1) = {"
wb
Qs
Oi
xL
Ls
zO
dw
dw
dw
mV
Ee
mV
dw
dw
dw
dw
Ls
hZ
xL
Ls
Ls
Pd
"}
(38,1,1) = {"
wb
Pd
Oi
xL
ZM
Km
dw
yf
Ea
Ea
Nj
Ea
AC
Ea
Ea
dw
Ls
hZ
kB
Ls
Ls
Pd
"}
(39,1,1) = {"
wb
Pd
Oi
kB
ZM
Km
dw
Cq
Ea
Ea
Mr
Ea
QZ
jD
OQ
dw
Ls
hZ
Oi
gs
Vb
Oi
"}
(40,1,1) = {"
zT
Oi
wf
xL
ZM
Km
dw
Ea
Ea
Ea
Nj
Ea
Ea
Ea
Ea
dw
Ls
QI
YE
ft
ft
lM
"}
(41,1,1) = {"
Xs
Oi
Xs
kB
ZM
Km
dw
qJ
xa
xa
Nj
Ea
QZ
jD
OQ
dw
zO
zO
zO
zO
Ls
Ls
"}
(42,1,1) = {"
bz
bz
qC
jc
ZM
Km
dw
Ea
Ea
Ea
Nj
Ea
Ea
Ea
Ea
dw
Km
Km
Km
Km
JE
zO
"}
(43,1,1) = {"
Ls
Ls
Ls
Ls
Ls
Km
dw
Ea
Ea
Ea
Nj
Ea
Ea
Ea
Ea
dw
Km
JJ
Km
Km
Km
Km
"}
(44,1,1) = {"
Ls
Ls
Ls
Ls
Ls
VW
dw
IS
Ea
Ea
Nj
Ea
Ea
Ea
UG
dw
Km
Km
Km
Km
Km
Km
"}
(45,1,1) = {"
Vb
Vb
Vb
Vb
Vb
Pd
nP
Ea
Ea
Ea
Nj
Ea
Ea
Ea
Ea
dw
Km
Km
rn
Km
Km
Km
"}
(46,1,1) = {"
ZT
ZT
ax
ZT
ax
oF
uV
xa
Ea
Ea
Mr
Ea
Ea
Ea
Ea
dw
Km
Km
Km
Km
Km
Km
"}
(47,1,1) = {"
qY
qY
qY
qY
qY
sf
ob
IG
IG
IG
Nb
Ea
Ea
Ea
qu
dw
Km
Km
Km
Km
Km
Km
"}
(48,1,1) = {"
zO
zO
Ls
Ls
Ls
LS
dw
kP
Ea
Ea
Nj
Ea
Ea
Ea
Ea
dw
Km
Km
Km
Km
Km
Km
"}
(49,1,1) = {"
Km
Km
JE
zO
zO
zO
dw
Cq
Ea
Ea
Nj
Ea
Ea
Ea
uS
dw
Km
JJ
Km
Km
Km
Km
"}
(50,1,1) = {"
Km
Km
JJ
Km
Km
Km
dw
kP
Ea
Ea
Nj
Ea
QZ
jD
OQ
dw
Km
Km
Km
Km
Km
Km
"}
(51,1,1) = {"
Km
Km
Km
Km
Km
Km
dw
Ea
Ea
Ea
Nj
Ea
Ea
Ea
Ea
dw
Km
Km
Km
Km
Km
Km
"}
(52,1,1) = {"
Km
Km
Km
Km
Km
Km
dw
Ea
Ea
Ea
Mr
Ea
Ea
Ea
Ea
dw
Km
Km
Km
Km
Km
zR
"}
(53,1,1) = {"
Km
Km
Km
Km
Km
Km
dw
dw
dw
gQ
WW
dw
dw
dw
dw
dw
Km
Km
Km
Km
Km
Km
"}
(54,1,1) = {"
Km
Km
Km
Km
Km
Km
Pd
Du
Oi
Oi
RA
Oi
Oi
Du
Oi
kB
Km
Km
rn
Km
Km
Km
"}
