//MAP CONVERTED BY dmm2tgm.py THIS HEADER COMMENT PREVENTS RECONVERSION, DO NOT REMOVE
"b" = (
/obj/structure/fence/standard/xenoproof,
/turf/open/floor/plating/ground/mars/random/cave,
/area/bigredv3/caves/southwest)
"d" = (
/obj/effect/ai_node,
/turf/open/floor/plating/ground/mars/random/cave,
/area/bigredv3/caves/southwest)
"f" = (
/turf/closed/mineral/smooth/bigred,
/area/bigredv3/caves/rock)
"g" = (
/obj/effect/landmark/lv624/fog_blocker/xeno_spawn,
/turf/open/floor/plating/ground/mars/random/cave,
/area/bigredv3/caves/southwest)
"j" = (
/obj/effect/landmark/patrol_point/som/som_11,
/turf/open/floor/plating/ground/mars/random/cave,
/area/bigredv3/caves/southwest)
"n" = (
/turf/closed/mineral/smooth/bigred/indestructible,
/area/space)
"u" = (
/turf/open/floor/plating/ground/mars/random/cave,
/area/bigredv3/caves/southwest)
"w" = (
/turf/open/floor/plating/ground/mars/random/cave/rock,
/area/bigredv3/caves/southwest)
"x" = (
/obj/effect/landmark/lv624/fog_blocker/xeno_spawn,
/turf/open/floor/plating/ground/mars/random/cave/rock,
/area/bigredv3/caves/southwest)
"F" = (
/obj/effect/landmark/xeno_silo_spawn,
/turf/open/floor/plating/ground/mars/random/cave,
/area/bigredv3/caves/southwest)
"G" = (
/obj/effect/landmark/lv624/fog_blocker,
/turf/open/floor/plating/ground/mars/random/cave,
/area/bigredv3/caves/southwest)
"I" = (
/obj/effect/landmark/lv624/fog_blocker/xeno_spawn,
/turf/closed/mineral/smooth/bigred,
/area/bigredv3/caves/rock)
"K" = (
/obj/effect/landmark/xeno_tunnel_spawn,
/turf/open/floor/plating/ground/mars/random/cave,
/area/bigredv3/caves/southwest)
"P" = (
/obj/effect/landmark/lv624/fog_blocker,
/turf/closed/mineral/smooth/bigred,
/area/bigredv3/caves/rock)
"U" = (
/obj/effect/ai_node,
/turf/open/floor/plating/ground/mars/random/cave/rock,
/area/bigredv3/caves/southwest)
"Y" = (
/turf/closed/wall/r_wall,
/area/bigredv3/inside/wall)

(1,1,1) = {"
n
n
n
n
n
n
n
n
n
n
n
n
n
n
n
n
n
n
n
n
n
n
n
n
n
n
n
n
n
n
n
n
n
n
n
n
n
n
n
n
n
n
n
"}
(2,1,1) = {"
f
f
f
f
f
f
f
f
f
f
f
f
f
I
f
f
f
f
f
f
f
f
f
f
f
f
f
f
f
f
f
f
f
f
f
n
n
n
n
n
n
n
n
"}
(3,1,1) = {"
f
f
f
f
f
f
f
f
f
f
f
f
f
I
f
f
f
f
f
f
f
f
f
f
f
f
f
f
f
f
f
f
f
f
f
n
n
n
n
n
n
n
n
"}
(4,1,1) = {"
f
f
f
f
f
f
f
f
f
f
f
f
f
I
f
f
f
f
f
f
f
f
f
f
f
f
f
f
f
f
f
f
f
f
f
n
n
n
n
n
n
n
n
"}
(5,1,1) = {"
f
f
f
f
f
f
f
f
f
f
f
f
f
I
f
f
f
f
f
f
f
f
u
u
u
u
u
f
f
f
f
f
f
f
f
n
n
n
n
n
n
n
n
"}
(6,1,1) = {"
f
f
f
f
f
f
f
f
f
f
f
f
f
I
f
f
f
u
w
w
w
w
w
u
u
u
u
u
f
f
f
f
f
f
f
n
n
n
n
n
n
n
n
"}
(7,1,1) = {"
f
f
f
f
u
u
d
u
u
f
f
f
f
g
u
w
u
u
u
u
u
u
u
u
u
u
F
u
f
f
f
f
f
f
f
n
n
n
n
n
n
n
n
"}
(8,1,1) = {"
f
f
u
u
u
u
u
u
u
u
u
f
f
g
U
u
u
u
u
u
u
u
d
u
u
u
u
d
u
f
f
f
f
f
f
n
n
n
n
n
n
n
n
"}
(9,1,1) = {"
f
u
u
u
u
u
u
u
u
u
u
u
u
g
u
u
u
u
u
u
u
u
u
u
u
u
u
u
u
f
f
f
f
f
f
n
n
n
n
n
n
n
n
"}
(10,1,1) = {"
u
u
d
u
u
u
d
u
u
u
u
d
u
g
d
f
f
f
f
f
u
u
u
u
u
u
u
u
u
f
f
f
f
f
f
n
n
n
n
n
n
n
n
"}
(11,1,1) = {"
u
u
u
u
u
u
u
u
u
u
u
u
u
g
u
f
f
f
f
f
f
f
u
K
w
u
u
u
u
f
f
f
f
f
f
n
n
n
n
n
n
n
n
"}
(12,1,1) = {"
u
u
u
u
u
u
u
u
u
u
f
f
f
g
u
u
f
f
f
f
f
f
f
f
u
u
u
u
u
f
f
f
f
f
f
n
n
n
n
n
n
n
n
"}
(13,1,1) = {"
u
w
U
f
f
f
f
f
f
f
f
f
f
g
u
u
u
f
f
f
f
f
f
f
u
u
u
u
u
f
f
f
f
f
f
n
n
n
n
n
n
n
n
"}
(14,1,1) = {"
u
u
w
f
f
f
f
f
f
f
f
f
f
g
u
u
u
u
u
f
f
f
f
f
f
u
u
w
f
f
f
f
f
f
f
n
n
n
n
n
n
n
n
"}
(15,1,1) = {"
u
u
u
w
w
f
f
f
f
f
f
f
f
x
d
u
u
u
u
u
f
f
f
f
f
u
u
u
f
f
f
f
f
f
f
n
n
n
n
n
n
n
n
"}
(16,1,1) = {"
u
u
u
u
w
f
f
f
f
f
f
f
f
I
u
d
u
u
u
u
d
f
f
f
f
u
u
u
f
f
f
f
f
f
f
n
n
n
n
n
n
n
n
"}
(17,1,1) = {"
u
u
u
u
w
f
f
f
f
f
f
f
f
I
u
u
u
u
u
u
u
d
u
u
u
u
u
U
f
f
f
f
f
f
f
n
n
n
n
n
n
n
n
"}
(18,1,1) = {"
u
u
u
u
w
f
f
f
f
f
f
f
f
I
u
u
u
u
u
u
u
u
u
u
u
u
d
f
f
f
f
f
f
f
f
n
n
n
n
n
n
n
n
"}
(19,1,1) = {"
u
u
d
u
U
f
f
f
f
f
f
f
f
I
I
g
g
g
g
g
g
g
g
x
g
g
g
I
I
I
I
I
I
I
I
n
n
n
n
n
n
n
n
"}
(20,1,1) = {"
f
u
u
u
u
w
f
f
f
f
f
f
f
f
f
f
u
u
u
u
u
u
u
w
u
u
u
f
f
f
f
f
f
f
f
n
n
n
n
n
n
n
n
"}
(21,1,1) = {"
f
f
f
u
u
w
f
f
f
f
f
f
f
f
f
f
f
u
u
u
u
u
w
u
u
u
u
f
f
f
f
f
f
f
f
n
n
n
n
n
n
n
n
"}
(22,1,1) = {"
f
f
f
u
u
u
w
u
f
f
f
f
f
f
f
f
f
f
f
f
u
u
w
f
f
u
u
f
f
f
f
f
f
f
f
n
n
n
n
n
n
n
n
"}
(23,1,1) = {"
f
f
f
u
u
u
u
u
u
f
f
f
f
f
f
f
f
f
f
f
f
f
f
f
f
u
u
u
f
f
f
f
f
f
f
n
n
n
n
n
n
n
n
"}
(24,1,1) = {"
f
f
f
u
u
u
u
u
w
u
u
f
f
f
f
f
f
f
f
f
f
f
f
f
u
u
u
u
f
f
f
f
f
f
f
n
n
n
n
n
n
n
n
"}
(25,1,1) = {"
f
f
f
w
u
u
u
u
u
u
w
u
f
f
f
f
f
f
f
f
f
f
f
f
u
d
u
u
f
f
f
f
f
f
f
n
n
n
n
n
n
n
n
"}
(26,1,1) = {"
f
f
f
f
d
u
u
u
u
u
u
u
w
f
f
f
f
f
f
f
f
f
f
f
f
u
d
u
f
f
f
f
f
f
f
n
n
n
n
n
n
n
n
"}
(27,1,1) = {"
f
f
f
u
u
d
u
j
u
u
u
u
u
u
f
f
f
f
f
f
f
f
f
f
f
u
u
u
u
f
f
f
f
f
f
n
n
n
n
n
n
n
n
"}
(28,1,1) = {"
f
f
u
u
u
u
u
u
u
u
u
u
u
u
w
f
f
f
f
f
f
f
f
f
f
f
u
u
u
f
f
f
f
f
f
n
n
n
n
n
n
n
n
"}
(29,1,1) = {"
f
u
u
u
u
u
u
u
u
u
u
u
u
u
u
f
f
f
f
f
f
f
f
f
f
f
u
u
u
f
f
f
f
f
f
n
n
n
n
n
n
n
n
"}
(30,1,1) = {"
f
u
u
u
u
u
u
u
u
w
f
w
d
u
u
u
f
f
f
f
f
f
f
f
f
f
u
u
u
u
f
f
f
f
f
n
n
n
n
n
n
n
n
"}
(31,1,1) = {"
f
u
u
u
u
u
u
u
u
w
f
f
w
d
u
u
u
f
f
f
f
f
f
f
f
f
U
u
u
u
f
f
f
f
f
n
n
n
n
n
n
n
n
"}
(32,1,1) = {"
f
u
d
u
u
d
f
u
u
w
f
f
f
u
d
u
u
d
u
f
f
f
f
f
f
f
w
U
u
u
f
f
f
f
f
n
n
n
n
n
n
n
n
"}
(33,1,1) = {"
f
u
u
u
f
f
f
w
w
f
f
f
f
u
u
u
u
u
u
u
w
f
f
f
f
f
f
w
d
u
u
f
f
f
f
n
n
n
n
n
n
n
n
"}
(34,1,1) = {"
f
b
b
b
f
f
f
f
f
f
f
f
f
f
u
u
u
u
u
u
u
w
f
f
f
f
f
f
u
u
u
u
f
f
f
n
n
n
n
n
n
n
n
"}
(35,1,1) = {"
f
u
u
u
f
f
f
f
f
f
f
f
f
u
u
u
u
u
u
u
w
f
f
f
f
f
f
f
u
u
u
f
f
f
f
n
n
n
n
n
n
n
n
"}
(36,1,1) = {"
f
Y
Y
Y
f
f
f
f
f
f
f
f
f
w
u
u
u
u
u
u
w
f
f
f
f
f
f
f
u
u
u
f
f
f
f
n
n
n
n
n
n
n
n
"}
(37,1,1) = {"
u
u
u
u
f
f
f
f
f
f
f
f
f
f
f
f
u
d
u
u
u
U
f
f
f
f
f
f
u
u
u
f
f
f
f
n
n
n
n
n
n
n
n
"}
(38,1,1) = {"
u
u
u
u
f
f
f
f
f
f
f
f
f
f
f
f
u
u
u
u
u
w
f
f
f
f
w
w
u
u
u
f
f
f
f
n
n
n
n
n
n
n
n
"}
(39,1,1) = {"
u
u
u
u
f
f
f
f
f
f
f
f
f
f
f
f
w
u
u
u
u
w
f
f
f
f
w
w
u
u
f
f
f
f
f
n
n
n
n
n
n
n
n
"}
(40,1,1) = {"
u
u
u
u
f
f
f
f
f
f
f
f
f
f
f
f
f
f
f
u
u
u
w
w
f
f
f
f
u
u
f
f
f
f
f
n
n
n
n
n
n
n
n
"}
(41,1,1) = {"
G
G
G
P
P
P
P
P
P
P
P
P
P
P
f
f
f
f
f
u
u
u
u
w
f
f
f
f
u
u
f
f
f
f
f
n
n
n
n
n
n
n
n
"}
