//MAP CONVERTED BY dmm2tgm.py THIS HEADER COMMENT PREVENTS RECONVERSION, DO NOT REMOVE
"ag" = (
/obj/effect/decal/cleanable/blood,
/turf/open/floor/carpet/side{
	dir = 8
	},
/area/bigredv3/inside/colony/library)
"aV" = (
/obj/machinery/atmospherics/pipe/simple/green/hidden,
/obj/structure/cable,
/turf/open/floor/marking/asteroidwarning{
	dir = 8
	},
/area/bigredv3/outside/directions/e)
"cB" = (
/obj/structure/table/wood,
/obj/item/toy/dice/d20,
/obj/item/paper/crumpled,
/turf/open/floor/wood,
/area/bigredv3/inside/colony/library)
"cF" = (
/obj/machinery/light{
	dir = 4
	},
/turf/open/floor/wood,
/area/bigredv3/inside/colony/library)
"cM" = (
/turf/open/floor/carpet/side{
	dir = 8
	},
/area/bigredv3/inside/colony/library)
"de" = (
/obj/machinery/light{
	dir = 4
	},
/obj/structure/table/wood,
/obj/effect/spawner/random/food_or_drink/drink_alcohol_bottle,
/obj/effect/spawner/random/food_or_drink/drink_alcohol_bottle{
	pixel_x = 1;
	pixel_y = 5
	},
/obj/effect/spawner/random/food_or_drink/drink_alcohol_bottle{
	pixel_y = 2
	},
/obj/effect/spawner/random/food_or_drink/drink_alcohol_bottle{
	pixel_x = -4;
	pixel_y = 3
	},
/obj/effect/spawner/random/food_or_drink/drink_alcohol_bottle,
/obj/effect/spawner/random/food_or_drink/drink_alcohol_bottle,
/obj/item/pizzabox/meat{
	pixel_x = -5;
	pixel_y = 12
	},
/turf/open/floor/wood,
/area/bigredv3/inside/colony/library)
"dx" = (
/obj/machinery/atmospherics/pipe/simple/green/hidden,
/obj/item/paper,
/obj/structure/cable,
/turf/open/floor/carpet/side{
	dir = 4
	},
/area/bigredv3/inside/colony/library)
"eI" = (
/obj/machinery/atmospherics/pipe/simple/green/hidden,
/obj/structure/cable,
/turf/open/floor/carpet/side{
	dir = 5
	},
/area/bigredv3/inside/colony/library)
"eV" = (
/obj/effect/ai_node,
/turf/open/floor/wood,
/area/bigredv3/inside/colony/library)
"fU" = (
/obj/item/toy/dice/d20,
/turf/open/floor/wood,
/area/bigredv3/inside/colony/library)
"gs" = (
/obj/structure/cable,
/obj/machinery/atmospherics/pipe/simple/green/hidden,
/obj/effect/ai_node,
/turf/open/floor/wood,
/area/bigredv3/inside/colony/library)
"iG" = (
/obj/machinery/atmospherics/pipe/manifold/green/hidden{
	dir = 4
	},
/obj/effect/ai_node,
/obj/effect/spawner/random/misc/trash,
/obj/structure/cable,
/turf/open/floor/wood,
/area/bigredv3/inside/colony/library)
"jI" = (
/obj/structure/cable,
/obj/machinery/atmospherics/components/unary/vent_pump{
	dir = 8;
	on = 1
	},
/turf/open/floor/wood,
/area/bigredv3/inside/colony/library)
"jK" = (
/turf/closed/wall,
/area/bigredv3/inside/wall)
"ka" = (
/obj/effect/decal/cleanable/blood,
/turf/open/floor/carpet/side{
	dir = 5
	},
/area/bigredv3/inside/colony/library)
"kf" = (
/obj/machinery/door_control{
	dir = 8;
	id = "Library";
	name = "Storm Shutters"
	},
/turf/open/floor/wood,
/area/bigredv3/inside/colony/library)
"kP" = (
/obj/structure/cable,
/obj/machinery/atmospherics/pipe/simple/green/hidden{
	dir = 9
	},
/obj/effect/decal/cleanable/blood/drip,
/turf/open/floor/wood,
/area/bigredv3/inside/colony/library)
"lG" = (
/obj/structure/cable,
/obj/machinery/atmospherics/pipe/simple/green/hidden{
	dir = 4
	},
/obj/machinery/door/airlock/mainship/generic{
	name = "\improper Library Backroom"
	},
/obj/effect/ai_node,
/turf/open/floor/wood,
/area/bigredv3/inside/colony/library)
"nb" = (
/turf/open/floor/carpet/side{
	dir = 1
	},
/area/bigredv3/inside/colony/library)
"nL" = (
/turf/open/floor/carpet/side{
	dir = 9
	},
/area/bigredv3/inside/colony/library)
"qw" = (
/obj/machinery/atmospherics/pipe/simple/green/hidden{
	dir = 4
	},
/obj/structure/cable,
/turf/open/floor/wood,
/area/bigredv3/inside/colony/library)
"rc" = (
/obj/effect/decal/cleanable/blood,
/turf/open/floor/wood,
/area/bigredv3/inside/colony/library)
"rt" = (
/obj/machinery/air_alarm{
	dir = 4
	},
/turf/open/floor/wood,
/area/bigredv3/inside/colony/library)
"rL" = (
/obj/structure/window/framed/colony,
/obj/machinery/door/poddoor/shutters/mainship{
	id = "Library";
	name = "\improper Library Shutters"
	},
/turf/open/floor/plating,
/area/bigredv3/inside/wall)
"rO" = (
/obj/structure/table/wood,
/obj/item/pizzabox/meat{
	pixel_x = -5;
	pixel_y = 12
	},
/turf/open/floor/wood,
/area/bigredv3/inside/colony/library)
"so" = (
/obj/machinery/atmospherics/pipe/simple/green/hidden,
/obj/effect/decal/cleanable/blood,
/obj/structure/cable,
/turf/open/floor/carpet/side{
	dir = 4
	},
/area/bigredv3/inside/colony/library)
"up" = (
/turf/open/floor/carpet/side{
	dir = 6
	},
/area/bigredv3/inside/colony/library)
"uy" = (
/obj/structure/bookcase,
/turf/open/floor/wood,
/area/bigredv3/inside/colony/library)
"uM" = (
/obj/machinery/atmospherics/pipe/simple/green/hidden{
	dir = 4
	},
/obj/structure/cable,
/obj/machinery/door/airlock/mainship/medical/glass/free_access{
	name = "\improper Greenhouse Storage"
	},
/turf/open/floor/wood,
/area/bigredv3/inside/colony/library)
"ve" = (
/obj/effect/spawner/random/misc/trash,
/turf/open/floor/carpet/side,
/area/bigredv3/inside/colony/library)
"vN" = (
/obj/machinery/light{
	dir = 4
	},
/obj/machinery/power/apc/weak/ntf,
/obj/structure/cable,
/obj/effect/ai_node,
/turf/open/floor/wood,
/area/bigredv3/inside/colony/library)
"vX" = (
/obj/structure/table/wood,
/obj/item/pizzabox/meat{
	pixel_x = -5;
	pixel_y = 12
	},
/obj/item/pizzabox/meat{
	pixel_x = -5;
	pixel_y = 12
	},
/obj/item/reagent_containers/food/drinks/bottle/absinthe,
/turf/open/floor/wood,
/area/bigredv3/inside/colony/library)
"xB" = (
/obj/structure/table/wood,
/obj/item/toy/dice/d20,
/obj/item/reagent_containers/food/snacks/pizzapasta/meatpizzaslice,
/obj/effect/spawner/random/food_or_drink/drink_alcohol_bottle{
	pixel_x = -1;
	pixel_y = 3
	},
/obj/effect/spawner/random/food_or_drink/drink_alcohol_bottle,
/turf/open/floor/wood,
/area/bigredv3/inside/colony/library)
"yE" = (
/obj/item/trash/chunk{
	pixel_x = -3;
	pixel_y = 4
	},
/turf/open/floor/wood,
/area/bigredv3/inside/colony/library)
"zM" = (
/obj/machinery/atmospherics/pipe/simple/green/hidden,
/obj/structure/cable,
/turf/open/floor/carpet,
/area/bigredv3/inside/colony/library)
"AA" = (
/obj/machinery/atmospherics/pipe/simple/green/hidden{
	dir = 4
	},
/obj/structure/cable,
/obj/effect/decal/cleanable/blood,
/turf/open/floor/wood,
/area/bigredv3/inside/colony/library)
"BC" = (
/obj/machinery/atmospherics/pipe/simple/green/hidden,
/obj/effect/ai_node,
/obj/structure/cable,
/turf/open/floor/carpet/side{
	dir = 4
	},
/area/bigredv3/inside/colony/library)
"CH" = (
/obj/effect/decal/cleanable/vomit,
/turf/open/floor/carpet/side{
	dir = 8
	},
/area/bigredv3/inside/colony/library)
"CM" = (
/obj/machinery/atmospherics/pipe/simple/green/hidden{
	dir = 5
	},
/obj/structure/cable,
/turf/open/floor/carpet/side,
/area/bigredv3/inside/colony/library)
"Ez" = (
/obj/structure/table/wood,
/obj/item/reagent_containers/food/snacks/pizzapasta/meatpizzaslice{
	pixel_x = -3;
	pixel_y = 4
	},
/obj/effect/spawner/random/food_or_drink/outdoors_snacks,
/obj/item/tool/pen/invisible,
/turf/open/floor/wood,
/area/bigredv3/inside/colony/library)
"EI" = (
/turf/open/floor/marking/asteroidwarning{
	dir = 4
	},
/area/bigredv3/outside/directions/e)
"Fz" = (
/obj/structure/bed/chair/wood/normal{
	dir = 4
	},
/obj/effect/decal/cleanable/blood/drip,
/turf/open/floor/wood,
/area/bigredv3/inside/colony/library)
"FX" = (
/obj/item/trash/chunk{
	pixel_x = -3;
	pixel_y = 4
	},
/turf/open/floor/carpet/side{
	dir = 8
	},
/area/bigredv3/inside/colony/library)
"HS" = (
/obj/effect/spawner/random/misc/trash,
/turf/open/floor/wood,
/area/bigredv3/inside/colony/library)
"Jb" = (
/obj/structure/bed/chair/wood/normal,
/obj/item/paper,
/turf/open/floor/wood,
/area/bigredv3/inside/colony/library)
"Jz" = (
/obj/item/toy/dice/d20,
/obj/effect/decal/cleanable/blood/drip,
/turf/open/floor/carpet/side{
	dir = 8
	},
/area/bigredv3/inside/colony/library)
"Kh" = (
/obj/structure/reagent_dispensers/beerkeg,
/turf/open/floor/wood,
/area/bigredv3/inside/colony/library)
"Mt" = (
/turf/open/floor/carpet/side{
	dir = 10
	},
/area/bigredv3/inside/colony/library)
"MR" = (
/turf/open/floor/carpet/side,
/area/bigredv3/inside/colony/library)
"Nb" = (
/obj/structure/table/wood,
/obj/item/reagent_containers/food/snacks/pizzapasta/meatpizzaslice,
/obj/effect/spawner/random/food_or_drink/drink_alcohol_bottle,
/obj/effect/spawner/random/food_or_drink/drink_alcohol_bottle,
/turf/open/floor/wood,
/area/bigredv3/inside/colony/library)
"PL" = (
/obj/effect/decal/cleanable/blood/drip,
/turf/open/floor/carpet/side{
	dir = 8
	},
/area/bigredv3/inside/colony/library)
"Qv" = (
/obj/structure/cable,
/obj/machinery/atmospherics/pipe/simple/green/hidden{
	dir = 4
	},
/turf/open/floor/wood,
/area/bigredv3/inside/colony/library)
"Rn" = (
/obj/structure/window/framed/colony,
/obj/machinery/door/poddoor/shutters/mainship{
	dir = 2;
	id = "Library";
	name = "\improper Library Shutters"
	},
/turf/open/floor/plating,
/area/bigredv3/inside/wall)
"RJ" = (
/obj/machinery/light{
	dir = 1
	},
/obj/item/weapon/broken_bottle,
/turf/open/floor/wood,
/area/bigredv3/inside/colony/library)
"St" = (
/obj/effect/decal/cleanable/vomit,
/turf/open/floor/wood,
/area/bigredv3/inside/colony/library)
"SH" = (
/obj/machinery/atmospherics/pipe/simple/green/hidden,
/obj/machinery/door/airlock/multi_tile/mainship/generic{
	name = "\improper Library"
	},
/obj/structure/cable,
/turf/open/floor/wood,
/area/bigredv3/inside/colony/library)
"SU" = (
/obj/machinery/atmospherics/pipe/simple/green/hidden,
/obj/structure/cable,
/turf/open/floor/carpet/side{
	dir = 4
	},
/area/bigredv3/inside/colony/library)
"Tc" = (
/obj/structure/bed/chair/wood/normal,
/turf/open/floor/wood,
/area/bigredv3/inside/colony/library)
"Tr" = (
/obj/effect/decal/cleanable/blood/drip,
/turf/open/floor/carpet/side{
	dir = 1
	},
/area/bigredv3/inside/colony/library)
"Tw" = (
/obj/structure/table/wood,
/obj/item/paper,
/turf/open/floor/wood,
/area/bigredv3/inside/colony/library)
"UU" = (
/obj/machinery/light{
	dir = 8
	},
/turf/open/floor/wood,
/area/bigredv3/inside/colony/library)
"VU" = (
/obj/structure/table/wood,
/obj/item/paper,
/obj/item/paper/crumpled,
/obj/effect/spawner/random/food_or_drink/drink_alcohol_bottle{
	pixel_x = -5
	},
/obj/effect/spawner/random/food_or_drink/drink_alcohol_bottle,
/turf/open/floor/wood,
/area/bigredv3/inside/colony/library)
"VX" = (
/turf/open/floor/plating/ground/mars/random/dirt,
/area/bigredv3/outside/directions/e)
"We" = (
/obj/machinery/light,
/turf/open/floor/wood,
/area/bigredv3/inside/colony/library)
"WK" = (
/obj/machinery/atmospherics/pipe/simple/green/hidden{
	dir = 10
	},
/obj/structure/cable,
/turf/open/floor/carpet/side,
/area/bigredv3/inside/colony/library)
"WZ" = (
/obj/structure/bed/chair/wood/normal{
	dir = 4
	},
/turf/open/floor/wood,
/area/bigredv3/inside/colony/library)
"Xq" = (
/obj/machinery/light{
	dir = 4
	},
/obj/structure/reagent_dispensers/beerkeg,
/turf/open/floor/wood,
/area/bigredv3/inside/colony/library)
"XA" = (
/obj/item/paper,
/turf/open/floor/wood,
/area/bigredv3/inside/colony/library)
"Yv" = (
/obj/structure/cable,
/obj/machinery/atmospherics/pipe/simple/green/hidden{
	dir = 6
	},
/turf/open/floor/wood,
/area/bigredv3/inside/colony/library)
"Yz" = (
/obj/machinery/atmospherics/pipe/simple/green/hidden,
/obj/structure/cable,
/turf/open/floor/wood,
/area/bigredv3/inside/colony/library)
"Zn" = (
/obj/effect/decal/cleanable/blood/drip,
/turf/open/floor/wood,
/area/bigredv3/inside/colony/library)
"ZY" = (
/turf/open/floor/wood,
/area/bigredv3/inside/colony/library)

(1,1,1) = {"
jK
jK
jK
jK
uM
jK
jK
jK
jK
jK
jK
jK
jK
jK
jK
jK
jK
jK
"}
(2,1,1) = {"
jK
uy
ZY
ZY
qw
uy
UU
uy
rt
uy
UU
uy
ZY
uy
UU
rc
jK
VX
"}
(3,1,1) = {"
jK
uy
ZY
ZY
AA
uy
St
uy
HS
uy
ZY
uy
ZY
uy
HS
ZY
Rn
VX
"}
(4,1,1) = {"
jK
ZY
HS
St
Qv
nL
cM
Jz
FX
ag
CH
cM
PL
cM
Mt
Zn
Rn
VX
"}
(5,1,1) = {"
jK
uy
eV
Yv
iG
eI
SU
so
SU
dx
SU
BC
SU
zM
CM
We
jK
VX
"}
(6,1,1) = {"
jK
RJ
ZY
Qv
XA
rc
XA
ZY
Fz
WZ
HS
uy
eV
nb
WK
Yz
SH
aV
"}
(7,1,1) = {"
jK
Yv
gs
kP
kf
St
Tc
VU
cB
Nb
ZY
yE
ZY
Tr
MR
ZY
ZY
EI
"}
(8,1,1) = {"
jK
lG
jK
jK
jK
yE
Tc
xB
Tw
Ez
fU
uy
ZY
nb
ve
We
jK
VX
"}
(9,1,1) = {"
jK
jI
vX
rO
jK
Kh
ZY
rc
Zn
ZY
ZY
uy
ZY
ka
up
ZY
Rn
VX
"}
(10,1,1) = {"
jK
vN
ZY
ZY
jK
Xq
HS
yE
Jb
de
XA
ZY
cF
ZY
ZY
ZY
Rn
VX
"}
(11,1,1) = {"
jK
jK
jK
jK
jK
jK
jK
rL
rL
jK
rL
rL
jK
rL
rL
jK
jK
VX
"}
