//MAP CONVERTED BY dmm2tgm.py THIS HEADER COMMENT PREVENTS RECONVERSION, DO NOT REMOVE
"al" = (
/obj/effect/decal/cleanable/dirt,
/obj/machinery/atmospherics/pipe/simple/green/hidden,
/obj/structure/cable,
/turf/open/floor/tile/dark,
/area/bigredv2/outside/general_offices)
"ap" = (
/obj/machinery/suit_storage_unit/carbon_unit,
/turf/open/floor/tile/dark,
/area/bigredv2/outside/general_offices)
"at" = (
/obj/machinery/vending/hydronutrients,
/turf/open/floor,
/area/bigredv2/outside/hydroponics)
"az" = (
/turf/open/floor/plating/ground/mars/random/sand,
/area/bigredv2/outside/ne)
"bk" = (
/obj/machinery/atmospherics/pipe/simple/green/hidden,
/obj/structure/cable,
/turf/open/floor/tile/dark,
/area/bigredv2/outside/general_offices)
"bS" = (
/obj/structure/rack,
/obj/effect/spawner/random/engineering/cable,
/obj/effect/spawner/random/engineering/toolbox,
/turf/open/floor/plating,
/area/bigredv2/outside/general_offices)
"bW" = (
/obj/machinery/light{
	dir = 1
	},
/turf/open/floor/plating,
/area/bigredv2/outside/bar)
"ck" = (
/obj/structure/table,
/obj/effect/spawner/random/engineering/toolbox,
/obj/machinery/atmospherics/components/unary/vent_pump,
/turf/open/floor,
/area/bigredv2/outside/general_offices)
"co" = (
/obj/machinery/atmospherics/pipe/simple/green/hidden{
	dir = 9
	},
/obj/structure/cable,
/obj/effect/ai_node,
/turf/open/floor,
/area/bigredv2/outside/general_offices)
"ct" = (
/obj/effect/decal/cleanable/dirt,
/obj/effect/decal/cleanable/dirt,
/obj/machinery/atmospherics/pipe/simple/green/hidden,
/obj/structure/cable,
/turf/open/floor/tile/dark,
/area/bigredv2/outside/general_offices)
"cJ" = (
/turf/closed/wall,
/area/bigredv2/outside/bar)
"dy" = (
/obj/structure/rack,
/obj/item/stack/sheet/mineral/diamond,
/obj/item/stack/sheet/plasteel{
	amount = 30;
	pixel_x = 4;
	pixel_y = 4
	},
/turf/open/floor/tile/dark,
/area/bigredv2/outside/general_offices)
"dA" = (
/turf/open/floor/marking/asteroidwarning{
	dir = 4
	},
/area/bigredv2/outside/ne)
"dD" = (
/obj/machinery/light{
	dir = 1
	},
/obj/effect/decal/cleanable/dirt,
/turf/open/floor,
/area/bigredv2/outside/general_offices)
"dO" = (
/obj/structure/table,
/turf/open/floor/wood,
/area/bigredv2/outside/general_offices)
"eL" = (
/turf/open/floor/plating/ground/mars/random/dirt,
/area/bigredv2/caves/northeast/garbledradio)
"fz" = (
/obj/machinery/atmospherics/pipe/simple/green/hidden{
	dir = 4
	},
/turf/open/floor,
/area/bigredv2/outside/general_offices)
"fJ" = (
/obj/structure/rack,
/obj/effect/spawner/random/engineering/tool,
/obj/effect/spawner/random/engineering/tool,
/obj/effect/decal/cleanable/dirt,
/turf/open/floor/tile/dark,
/area/bigredv2/outside/general_offices)
"fN" = (
/obj/machinery/door/airlock/mainship/maint/free_access{
	name = "\improper Dormitories EVA Maintenance"
	},
/obj/structure/cable,
/turf/open/floor/plating,
/area/bigredv2/outside/general_offices)
"gH" = (
/obj/machinery/door/airlock/multi_tile/mainship/generic{
	name = "\improper Dormitories Tool Storage"
	},
/turf/open/floor,
/area/bigredv2/outside/general_offices)
"hj" = (
/obj/structure/table,
/obj/effect/spawner/random/engineering/toolbox,
/turf/open/floor/plating,
/area/bigredv2/outside/general_offices)
"hS" = (
/obj/docking_port/stationary/crashmode,
/turf/open/floor,
/area/bigredv2/outside/general_offices)
"hU" = (
/obj/machinery/light,
/turf/open/floor/tile/dark,
/area/bigredv2/outside/general_offices)
"in" = (
/obj/effect/decal/cleanable/dirt,
/turf/open/floor/plating/warning{
	dir = 1
	},
/area/bigredv2/outside/general_offices)
"iL" = (
/obj/machinery/atmospherics/pipe/manifold/green/hidden{
	dir = 1
	},
/obj/structure/cable,
/obj/effect/ai_node,
/turf/open/floor/tile/dark,
/area/bigredv2/outside/general_offices)
"ja" = (
/obj/machinery/atmospherics/pipe/simple/green/hidden,
/turf/open/floor,
/area/bigredv2/outside/general_offices)
"jf" = (
/obj/structure/rack,
/obj/item/stack/sheet/mineral/gold,
/turf/open/floor/tile/dark,
/area/bigredv2/outside/general_offices)
"jE" = (
/obj/structure/sign/safety/EVA{
	dir = 1
	},
/obj/effect/landmark/excavation_site_spawner,
/turf/open/floor/tile/dark,
/area/bigredv2/outside/general_offices)
"jG" = (
/obj/machinery/atmospherics/pipe/simple/green/hidden{
	dir = 4
	},
/obj/structure/cable,
/turf/open/floor,
/area/bigredv2/outside/general_offices)
"jS" = (
/obj/machinery/light{
	dir = 4
	},
/obj/structure/rack,
/obj/item/stack/sheet/mineral/silver,
/obj/item/stack/sheet/mineral/silver{
	amount = 20
	},
/obj/item/stack/sheet/mineral/phoron{
	amount = 25
	},
/turf/open/floor/tile/dark,
/area/bigredv2/outside/general_offices)
"kc" = (
/obj/machinery/atmospherics/pipe/manifold/green/hidden{
	dir = 4
	},
/obj/structure/cable,
/obj/effect/ai_node,
/turf/open/floor/asteroidfloor,
/area/bigredv2/outside/ne)
"ke" = (
/turf/closed/wall,
/area/bigredv2/outside/hydroponics)
"kj" = (
/obj/effect/landmark/lv624/fog_blocker,
/turf/open/floor/plating/ground/mars/random/sand,
/area/bigredv2/caves/northeast/garbledradio)
"kv" = (
/obj/machinery/atmospherics/pipe/manifold/green/hidden{
	dir = 4
	},
/obj/structure/cable,
/obj/effect/ai_node,
/turf/open/floor/tile/dark,
/area/bigredv2/outside/general_offices)
"ln" = (
/turf/open/floor/plating,
/area/bigredv2/outside/bar)
"ly" = (
/obj/structure/table,
/turf/open/floor,
/area/bigredv2/outside/hydroponics)
"lz" = (
/obj/effect/decal/cleanable/dirt,
/turf/open/floor,
/area/bigredv2/outside/general_offices)
"nd" = (
/obj/machinery/atmospherics/components/unary/vent_pump{
	dir = 8
	},
/turf/open/floor/plating,
/area/bigredv2/outside/general_offices)
"nv" = (
/obj/machinery/door/airlock/mainship/maint/free_access{
	name = "\improper Dormitories EVA Maintenance"
	},
/turf/open/floor/plating,
/area/bigredv2/outside/general_offices)
"nY" = (
/turf/open/floor/wood,
/area/bigredv2/outside/general_offices)
"oa" = (
/obj/machinery/vending/cigarette/colony,
/turf/open/floor,
/area/bigredv2/outside/general_offices)
"op" = (
/obj/structure/rack,
/obj/effect/spawner/random/engineering/tool,
/obj/effect/spawner/random/engineering/tool,
/turf/open/floor/tile/dark,
/area/bigredv2/outside/general_offices)
"or" = (
/turf/open/floor/plating/ground/mars/random/sand,
/area/bigredv2/caves/northeast/garbledradio)
"oy" = (
/turf/open/floor/plating/ground/mars/dirttosand/autosmooth{
	dir = 10
	},
/area/bigredv2/outside/ne)
"oD" = (
/obj/structure/cable,
/obj/machinery/atmospherics/pipe/simple/green/hidden{
	dir = 4
	},
/obj/effect/decal/cleanable/dirt,
/turf/open/floor/asteroidfloor,
/area/bigredv2/outside/ne)
"ph" = (
/obj/structure/cable,
/obj/machinery/atmospherics/pipe/simple/green/hidden,
/turf/open/floor/asteroidfloor,
/area/bigredv2/outside/general_offices)
"pJ" = (
/obj/structure/window/framed/colony,
/obj/machinery/door/poddoor/shutters/mainship{
	dir = 2;
	id = "Dormitories";
	name = "\improper Dormitories Shutters"
	},
/turf/open/floor/plating,
/area/bigredv2/outside/general_offices)
"qf" = (
/obj/machinery/light{
	dir = 1
	},
/turf/open/floor,
/area/bigredv2/outside/general_offices)
"qi" = (
/obj/structure/rack,
/turf/open/floor/tile/dark,
/area/bigredv2/outside/general_offices)
"qG" = (
/obj/structure/rack,
/obj/effect/spawner/random/weaponry/melee,
/turf/open/floor/plating,
/area/bigredv2/outside/general_offices)
"qP" = (
/obj/structure/table,
/obj/effect/spawner/random/misc/paperbin,
/obj/machinery/atmospherics/pipe/simple/green/hidden{
	dir = 4
	},
/turf/open/floor/tile/dark,
/area/bigredv2/outside/general_offices)
"rc" = (
/obj/machinery/atmospherics/pipe/manifold/green/hidden,
/obj/effect/ai_node,
/turf/open/floor,
/area/bigredv2/outside/general_offices)
"rn" = (
/obj/machinery/door/airlock/mainship/engineering/free_access{
	dir = 1;
	name = "\improper Dormitories EVA"
	},
/obj/machinery/atmospherics/pipe/simple/green/hidden,
/obj/structure/cable,
/turf/open/floor/tile/dark,
/area/bigredv2/outside/general_offices)
"rA" = (
/obj/machinery/vending/engivend,
/turf/open/floor/plating,
/area/bigredv2/outside/general_offices)
"rL" = (
/obj/structure/cable,
/obj/machinery/atmospherics/pipe/simple/green/hidden{
	dir = 4
	},
/obj/effect/ai_node,
/turf/open/floor/asteroidfloor,
/area/bigredv2/outside/ne)
"si" = (
/obj/structure/window/framed/colony,
/obj/machinery/door/poddoor/shutters/mainship{
	id = "Greenhouse";
	name = "\improper Greenhouse Shutters"
	},
/turf/open/floor/plating,
/area/bigredv2/outside/hydroponics)
"sk" = (
/obj/structure/bed/chair{
	dir = 8
	},
/turf/open/floor,
/area/bigredv2/outside/general_offices)
"sz" = (
/obj/effect/decal/cleanable/dirt,
/turf/open/floor/asteroidfloor,
/area/bigredv2/outside/general_offices)
"tf" = (
/obj/machinery/light{
	dir = 1
	},
/obj/machinery/vending/cola,
/turf/open/floor,
/area/bigredv2/outside/general_offices)
"tw" = (
/obj/machinery/door/airlock/mainship/maint/free_access{
	dir = 1;
	name = "\improper Dormitories Tool Storage Maintenance"
	},
/turf/open/floor/plating,
/area/bigredv2/outside/general_offices)
"ty" = (
/obj/structure/table,
/obj/machinery/atmospherics/components/unary/vent_pump{
	dir = 8;
	on = 1
	},
/turf/open/floor/tile/dark,
/area/bigredv2/outside/general_offices)
"tI" = (
/obj/machinery/atmospherics/pipe/simple/green/hidden,
/obj/structure/cable,
/obj/machinery/door/airlock/mainship/medical/glass/free_access{
	dir = 1;
	name = "\improper Greenhouse"
	},
/turf/open/floor,
/area/bigredv2/outside/hydroponics)
"tR" = (
/turf/closed/wall,
/area/bigredv2/caves/rock)
"vm" = (
/obj/machinery/atmospherics/components/unary/vent_pump{
	dir = 4;
	on = 1
	},
/obj/structure/cable,
/turf/open/floor/tile/dark,
/area/bigredv2/outside/general_offices)
"vp" = (
/obj/structure/rack,
/obj/item/stack/sheet/mineral/uranium{
	amount = 50
	},
/turf/open/floor/tile/dark,
/area/bigredv2/outside/general_offices)
"vy" = (
/obj/structure/table,
/obj/item/tool/shovel/spade,
/turf/open/floor,
/area/bigredv2/outside/hydroponics)
"vz" = (
/obj/effect/decal/cleanable/dirt,
/obj/machinery/atmospherics/pipe/simple/green/hidden,
/turf/open/floor,
/area/bigredv2/outside/general_offices)
"vO" = (
/obj/structure/rack,
/obj/item/stack/sheet/mineral/plastic,
/obj/item/stack/sheet/mineral/plastic,
/obj/item/stack/sheet/mineral/plastic,
/obj/effect/decal/cleanable/cobweb,
/turf/open/floor/tile/dark,
/area/bigredv2/outside/general_offices)
"wa" = (
/obj/structure/table,
/obj/item/paper/hydroponics,
/turf/open/floor,
/area/bigredv2/outside/hydroponics)
"wF" = (
/obj/structure/window/framed/colony/reinforced,
/turf/open/floor/plating,
/area/bigredv2/outside/general_offices)
"wK" = (
/obj/structure/rack,
/obj/effect/spawner/random/engineering/tool,
/obj/effect/spawner/random/engineering/tool,
/obj/effect/spawner/random/engineering/tool,
/turf/open/floor,
/area/bigredv2/outside/general_offices)
"xm" = (
/obj/effect/decal/cleanable/dirt,
/obj/machinery/atmospherics/components/unary/vent_pump{
	dir = 4;
	on = 1
	},
/turf/open/floor/tile/dark,
/area/bigredv2/outside/general_offices)
"xV" = (
/obj/structure/sign/safety/EVA{
	dir = 1
	},
/turf/open/floor,
/area/bigredv2/outside/general_offices)
"yb" = (
/turf/open/floor/plating/ground/mars/random/sand,
/area/bigredv2/outside/n)
"yj" = (
/obj/effect/decal/cleanable/dirt,
/obj/machinery/atmospherics/pipe/simple/green/hidden{
	dir = 6
	},
/obj/effect/ai_node,
/turf/open/floor,
/area/bigredv2/outside/general_offices)
"yB" = (
/turf/open/floor/plating/ground/mars/random/dirt,
/area/bigredv2/outside/ne)
"zh" = (
/obj/structure/cable,
/obj/effect/ai_node,
/turf/open/floor/plating,
/area/bigredv2/outside/general_offices)
"zV" = (
/obj/machinery/atmospherics/pipe/simple/green/hidden,
/obj/structure/cable,
/turf/open/floor,
/area/bigredv2/outside/general_offices)
"Al" = (
/obj/structure/rack,
/obj/item/stack/sheet/mineral/phoron{
	amount = 25
	},
/turf/open/floor/tile/dark,
/area/bigredv2/outside/general_offices)
"Ax" = (
/turf/open/floor/plating/warning{
	dir = 4
	},
/area/bigredv2/outside/general_offices)
"AP" = (
/obj/machinery/light{
	dir = 8
	},
/turf/open/floor/wood,
/area/bigredv2/outside/general_offices)
"Bq" = (
/obj/machinery/vending/hydroseeds,
/turf/open/floor,
/area/bigredv2/outside/hydroponics)
"Bu" = (
/turf/open/floor/plating/warning,
/area/bigredv2/outside/general_offices)
"BA" = (
/obj/structure/rack,
/obj/item/stack/sheet/mineral/diamond,
/turf/open/floor/tile/dark,
/area/bigredv2/outside/general_offices)
"BF" = (
/obj/effect/decal/cleanable/dirt,
/turf/open/floor/tile/dark,
/area/bigredv2/outside/general_offices)
"BO" = (
/obj/effect/ai_node,
/turf/open/floor/plating/ground/mars/random/sand,
/area/bigredv2/caves/northeast/garbledradio)
"BZ" = (
/obj/structure/cable,
/obj/machinery/atmospherics/pipe/simple/green/hidden,
/turf/open/floor/asteroidfloor,
/area/bigredv2/outside/ne)
"CE" = (
/obj/structure/cable,
/obj/machinery/atmospherics/pipe/simple/green/hidden{
	dir = 4
	},
/turf/open/floor/asteroidfloor,
/area/bigredv2/outside/ne)
"CH" = (
/obj/effect/decal/cleanable/dirt,
/obj/effect/spawner/random/misc/trash,
/turf/open/floor/plating/warning{
	dir = 4
	},
/area/bigredv2/outside/general_offices)
"CK" = (
/obj/machinery/atmospherics/pipe/simple/green/hidden{
	dir = 4
	},
/turf/open/floor/tile/dark,
/area/bigredv2/outside/general_offices)
"Du" = (
/obj/effect/decal/cleanable/dirt,
/obj/effect/spawner/random/engineering/cable,
/turf/open/floor/plating,
/area/bigredv2/outside/general_offices)
"DM" = (
/obj/machinery/light,
/turf/open/floor,
/area/bigredv2/outside/general_offices)
"DP" = (
/turf/closed/mineral/smooth/bigred,
/area/bigredv2/caves/rock)
"DT" = (
/obj/machinery/light,
/obj/effect/decal/cleanable/dirt,
/turf/open/floor,
/area/bigredv2/outside/general_offices)
"Eb" = (
/turf/closed/wall,
/area/bigredv2/outside/general_offices)
"Ek" = (
/obj/structure/cable,
/turf/open/floor/tile/dark,
/area/bigredv2/outside/general_offices)
"Ey" = (
/obj/machinery/vending/tool,
/turf/open/floor/plating,
/area/bigredv2/outside/general_offices)
"EU" = (
/
/turf/open/floor/tile/dark,
/area/bigredv2/outside/general_offices)
"Fc" = (
/obj/machinery/door/airlock/mainship/engineering/free_access{
	name = "\improper Dormitories EVA"
	},
/obj/machinery/atmospherics/pipe/simple/green/hidden{
	dir = 4
	},
/turf/open/floor/tile/dark,
/area/bigredv2/outside/general_offices)
"FT" = (
/turf/open/floor,
/area/bigredv2/outside/hydroponics)
"Gb" = (
/turf/open/floor,
/area/bigredv2/outside/general_offices)
"Go" = (
/obj/effect/spawner/random/engineering/structure/tank_dispenser/oxygenweighted,
/turf/open/floor/tile/dark,
/area/bigredv2/outside/general_offices)
"Gv" = (
/turf/open/floor/asteroidfloor,
/area/bigredv2/outside/general_offices)
"GJ" = (
/turf/closed/wall,
/area/bigredv2/outside/n)
"GM" = (
/obj/machinery/atmospherics/pipe/manifold/green/hidden,
/turf/open/floor,
/area/bigredv2/outside/general_offices)
"HH" = (
/turf/open/floor/plating/ground/mars/dirttosand/autosmooth,
/area/bigredv2/outside/ne)
"Im" = (
/obj/machinery/atmospherics/pipe/manifold/green/hidden{
	dir = 1
	},
/obj/structure/cable,
/obj/effect/ai_node,
/turf/open/floor,
/area/bigredv2/outside/general_offices)
"IH" = (
/obj/structure/closet/toolcloset,
/turf/open/floor,
/area/bigredv2/outside/general_offices)
"IQ" = (
/obj/machinery/door/airlock/mainship/generic{
	dir = 1;
	name = "\improper Dormitories Bedroom"
	},
/turf/open/floor/wood,
/area/bigredv2/outside/general_offices)
"IS" = (
/obj/effect/decal/cleanable/dirt,
/obj/machinery/atmospherics/pipe/simple/green/hidden{
	dir = 9
	},
/turf/open/floor,
/area/bigredv2/outside/general_offices)
"IT" = (
/obj/machinery/atmospherics/components/unary/vent_pump{
	dir = 8;
	on = 1
	},
/obj/effect/ai_node,
/turf/open/floor/tile/dark,
/area/bigredv2/outside/general_offices)
"Jh" = (
/turf/closed/wall/r_wall,
/area/bigredv2/outside/general_offices)
"JP" = (
/obj/structure/cable,
/obj/machinery/atmospherics/pipe/manifold/green/hidden{
	dir = 8
	},
/turf/open/floor/tile/dark,
/area/bigredv2/outside/general_offices)
"JR" = (
/obj/effect/decal/cleanable/dirt,
/obj/effect/decal/cleanable/dirt,
/turf/open/floor/plating/warning{
	dir = 4
	},
/area/bigredv2/outside/general_offices)
"Kn" = (
/obj/structure/table,
/obj/effect/spawner/random/engineering/toolbox,
/obj/item/stack/cable_coil,
/turf/open/floor,
/area/bigredv2/outside/general_offices)
"KD" = (
/obj/structure/prop/mainship/brokengen,
/obj/machinery/atmospherics/pipe/simple/green/hidden{
	dir = 4
	},
/turf/open/floor/plating,
/area/bigredv2/outside/general_offices)
"KK" = (
/obj/machinery/suit_storage_unit/carbon_unit,
/obj/effect/decal/cleanable/cobweb2,
/turf/open/floor/tile/dark,
/area/bigredv2/outside/general_offices)
"KQ" = (
/obj/effect/decal/cleanable/dirt,
/obj/structure/rack,
/obj/item/stack/sheet/mineral/uranium{
	amount = 50
	},
/turf/open/floor/tile/dark,
/area/bigredv2/outside/general_offices)
"KW" = (
/obj/machinery/atmospherics/pipe/simple/green/hidden,
/obj/structure/cable,
/turf/open/floor/tile/green/whitegreenfull,
/area/bigredv2/outside/hydroponics)
"Lb" = (
/obj/effect/decal/cleanable/dirt,
/turf/open/floor/plating,
/area/bigredv2/outside/general_offices)
"LA" = (
/obj/structure/bed,
/turf/open/floor/wood,
/area/bigredv2/outside/general_offices)
"LY" = (
/obj/effect/decal/cleanable/dirt,
/obj/machinery/computer/intel_computer,
/turf/open/floor/tile/dark,
/area/bigredv2/outside/general_offices)
"Mk" = (
/obj/effect/ai_node,
/turf/open/floor/marking/asteroidwarning{
	dir = 6
	},
/area/bigredv2/outside/ne)
"Mr" = (
/obj/structure/bed/chair{
	dir = 1
	},
/turf/open/floor,
/area/bigredv2/outside/general_offices)
"ML" = (
/obj/effect/ai_node,
/turf/open/floor,
/area/bigredv2/outside/general_offices)
"Ng" = (
/obj/structure/cable,
/obj/machinery/atmospherics/pipe/simple/green/hidden,
/obj/machinery/door/airlock/multi_tile/mainship/generic{
	name = "\improper Dormitories"
	},
/turf/open/floor,
/area/bigredv2/outside/general_offices)
"NV" = (
/obj/effect/landmark/excavation_site_spawner,
/turf/open/floor,
/area/bigredv2/outside/general_offices)
"Oa" = (
/turf/open/floor/marking/asteroidwarning,
/area/bigredv2/outside/ne)
"Ov" = (
/obj/structure/cable,
/obj/machinery/atmospherics/pipe/simple/green/hidden{
	dir = 4
	},
/obj/machinery/door/airlock/mainship/maint/free_access{
	name = "\improper Bar Maintenance"
	},
/turf/open/floor/plating,
/area/bigredv2/outside/bar)
"OK" = (
/obj/machinery/door/airlock/mainship/medical/glass/free_access{
	name = "\improper Dormitories Lavatory"
	},
/obj/machinery/atmospherics/pipe/simple/green/hidden{
	dir = 4
	},
/turf/open/floor/freezer,
/area/bigredv2/outside/general_offices)
"OP" = (
/obj/machinery/vending/snack,
/turf/open/floor,
/area/bigredv2/outside/general_offices)
"OR" = (
/obj/effect/decal/cleanable/dirt,
/obj/machinery/atmospherics/pipe/simple/green/hidden{
	dir = 4
	},
/turf/open/floor/plating/warning{
	dir = 4
	},
/area/bigredv2/outside/general_offices)
"OT" = (
/obj/machinery/atmospherics/pipe/simple/green/hidden{
	dir = 6
	},
/turf/open/floor,
/area/bigredv2/outside/general_offices)
"Pb" = (
/obj/effect/decal/cleanable/dirt,
/obj/machinery/air_alarm{
	dir = 4
	},
/turf/open/floor/tile/dark,
/area/bigredv2/outside/general_offices)
"Pe" = (
/obj/machinery/light{
	dir = 8
	},
/obj/effect/spawner/random/misc/trash,
/obj/machinery/power/apc/high/ntf{
	dir = 4
	},
/obj/structure/cable,
/turf/open/floor/plating,
/area/bigredv2/outside/general_offices)
"Pi" = (
/obj/effect/spawner/random/engineering/cable,
/turf/open/floor/plating/warning{
	dir = 1
	},
/area/bigredv2/outside/general_offices)
"PE" = (
/obj/machinery/hydroponics,
/turf/open/floor/tile/green/whitegreenfull,
/area/bigredv2/outside/hydroponics)
"PV" = (
/obj/effect/spawner/random/misc/trash,
/turf/open/floor/plating/warning{
	dir = 1
	},
/area/bigredv2/outside/general_offices)
"Qr" = (
/obj/effect/ai_node,
/turf/open/floor/plating/ground/mars/random/dirt,
/area/bigredv2/caves/northeast/garbledradio)
"Rc" = (
/obj/structure/rack,
/obj/effect/spawner/random/engineering/tool,
/obj/effect/spawner/random/engineering/tool,
/turf/open/floor,
/area/bigredv2/outside/general_offices)
"Ro" = (
/obj/structure/table,
/turf/open/floor/tile/dark,
/area/bigredv2/outside/general_offices)
"Rw" = (
/turf/open/floor/plating/ground/mars/dirttosand/autosmooth{
	dir = 8
	},
/area/bigredv2/caves/northeast/garbledradio)
"Rx" = (
/obj/structure/closet/l3closet,
/turf/open/floor/tile/vault{
	dir = 8
	},
/area/bigredv2/outside/general_offices)
"RQ" = (
/obj/structure/window/framed/colony,
/turf/open/floor/plating,
/area/bigredv2/outside/general_offices)
"RW" = (
/obj/effect/decal/cleanable/dirt,
/obj/effect/landmark/excavation_site_spawner,
/turf/open/floor,
/area/bigredv2/outside/general_offices)
"Sd" = (
/obj/machinery/vending/tool,
/turf/open/floor,
/area/bigredv2/outside/general_offices)
"Sj" = (
/obj/structure/prop/mainship/brokengen,
/turf/open/floor/plating,
/area/bigredv2/outside/general_offices)
"Ti" = (
/obj/effect/landmark/lv624/fog_blocker,
/turf/closed/mineral/smooth/bigred,
/area/bigredv2/caves/rock)
"TU" = (
/turf/open/floor/plating/warning{
	dir = 1
	},
/area/bigredv2/outside/general_offices)
"UK" = (
/obj/effect/ai_node,
/turf/open/floor/plating/ground/mars/random/sand,
/area/bigredv2/outside/ne)
"Vr" = (
/turf/open/floor/plating,
/area/bigredv2/outside/general_offices)
"Vs" = (
/turf/open/floor/tile/dark,
/area/bigredv2/outside/general_offices)
"We" = (
/obj/effect/ai_node,
/turf/open/floor/tile/dark,
/area/bigredv2/outside/general_offices)
"Wt" = (
/obj/structure/window/framed/colony,
/turf/open/floor/plating,
/area/bigredv2/outside/hydroponics)
"WM" = (
/obj/effect/spawner/random/misc/trash,
/turf/open/floor/plating,
/area/bigredv2/outside/general_offices)
"WO" = (
/obj/structure/rack,
/obj/item/stack/sheet/mineral/diamond,
/obj/item/clothing/under/redcoat,
/turf/open/floor/tile/dark,
/area/bigredv2/outside/general_offices)
"WW" = (
/obj/structure/cable,
/turf/open/floor/plating,
/area/bigredv2/outside/general_offices)
"Xi" = (
/obj/structure/window/framed/colony,
/obj/machinery/door/poddoor/shutters/mainship{
	dir = 2;
	id = "Greenhouse";
	name = "\improper Greenhouse Shutters"
	},
/turf/open/floor/plating,
/area/bigredv2/outside/hydroponics)
"XG" = (
/obj/machinery/light{
	dir = 8
	},
/obj/structure/cable,
/obj/machinery/atmospherics/pipe/simple/green/hidden,
/turf/open/floor/asteroidfloor,
/area/bigredv2/outside/general_offices)
"XP" = (
/obj/structure/table,
/turf/open/floor,
/area/bigredv2/outside/general_offices)
"Za" = (
/obj/machinery/light{
	dir = 1
	},
/obj/machinery/suit_storage_unit/carbon_unit,
/turf/open/floor/tile/dark,
/area/bigredv2/outside/general_offices)
"Zi" = (
/obj/machinery/atmospherics/pipe/manifold/green/hidden{
	dir = 4
	},
/turf/open/floor,
/area/bigredv2/outside/general_offices)
"Zm" = (
/obj/machinery/vending/engivend,
/turf/open/floor,
/area/bigredv2/outside/general_offices)
"Zx" = (
/obj/machinery/atmospherics/pipe/simple/green/hidden{
	dir = 4
	},
/obj/structure/cable,
/turf/open/floor/plating,
/area/bigredv2/outside/bar)
"ZM" = (
/obj/structure/closet/l3closet,
/obj/effect/decal/cleanable/dirt,
/turf/open/floor/tile/vault{
	dir = 8
	},
/area/bigredv2/outside/general_offices)

(1,1,1) = {"
yb
yb
pJ
Gb
Gb
OT
ja
Zi
ja
ja
ja
ja
ja
ja
GM
Gb
Gb
Mr
cJ
bW
Zx
ln
ln
cJ
"}
(2,1,1) = {"
yb
yb
Eb
Eb
Eb
OK
Eb
Eb
Eb
Eb
Eb
Eb
Eb
qf
fz
Gb
sk
XP
cJ
ln
Zx
ln
ln
cJ
"}
(3,1,1) = {"
yb
yb
Eb
Lb
Ax
OR
Ax
Vr
Eb
wK
Rc
Rc
Eb
Gb
fz
Gb
Eb
Eb
cJ
cJ
Ov
cJ
cJ
cJ
"}
(4,1,1) = {"
yb
GJ
Eb
Bu
Sj
KD
Sj
in
Eb
qf
lz
Gb
Eb
lz
fz
Gb
IQ
nY
AP
Eb
oD
Oa
yB
cJ
"}
(5,1,1) = {"
yb
GJ
rA
Bu
Lb
nd
Lb
Pi
Eb
Gb
lz
Gb
Eb
lz
fz
Gb
Eb
dO
LA
Eb
oD
Oa
yB
cJ
"}
(6,1,1) = {"
yb
GJ
Ey
Bu
Sj
Sj
Sj
TU
Eb
Zm
lz
Gb
Eb
lz
fz
DM
Eb
Eb
Eb
Eb
oD
Oa
yB
cJ
"}
(7,1,1) = {"
DP
tR
hj
Bu
Vr
Du
Vr
PV
Eb
Sd
Gb
Gb
gH
hS
fz
Gb
IQ
nY
AP
Eb
oD
Oa
yB
cJ
"}
(8,1,1) = {"
Ti
tR
Eb
Bu
JR
CH
Ax
in
Eb
Kn
yj
vz
ja
ja
rc
Gb
Eb
dO
LA
Eb
CE
Oa
HH
az
"}
(9,1,1) = {"
DP
Ti
Eb
op
BF
Vs
fJ
LY
Eb
ck
IS
lz
Eb
NV
fz
Gb
Eb
Eb
Eb
Eb
rL
Oa
yB
oy
"}
(10,1,1) = {"
DP
Ti
Eb
Eb
nv
Eb
Eb
Eb
Eb
IH
lz
DT
Eb
RW
fz
Gb
IQ
nY
AP
Eb
oD
Oa
yB
HH
"}
(11,1,1) = {"
or
kj
Eb
qG
Vr
Pe
bS
bS
Eb
IH
lz
lz
Eb
lz
fz
Gb
Eb
dO
LA
Eb
oD
Oa
ke
si
"}
(12,1,1) = {"
BO
kj
tw
WM
zh
WW
Vr
WM
tw
Gb
ML
Gb
Eb
lz
fz
DM
Eb
Eb
Eb
Eb
CE
Oa
Xi
PE
"}
(13,1,1) = {"
or
kj
Eb
Eb
fN
Eb
Eb
Eb
Eb
Eb
Eb
Eb
Eb
dD
Im
zV
Ng
ph
XG
ph
kc
BZ
tI
KW
"}
(14,1,1) = {"
or
kj
Eb
ap
Ek
Pb
Go
Ro
Eb
ZM
ZM
Rx
Eb
Gb
jG
ML
Gb
Gv
Gv
sz
dA
Mk
Xi
PE
"}
(15,1,1) = {"
or
kj
Eb
ap
Ek
BF
Vs
Ro
Eb
BF
BF
Vs
Eb
xV
jG
Gb
Eb
Eb
Eb
Eb
az
az
Xi
PE
"}
(16,1,1) = {"
or
kj
Eb
Za
vm
BF
BF
Ro
RQ
BF
xm
Vs
RQ
Gb
jG
Gb
IQ
nY
AP
Eb
az
az
Xi
PE
"}
(17,1,1) = {"
Rw
Ti
Eb
ap
iL
ct
al
JP
rn
bk
kv
bk
rn
zV
co
Gb
Eb
dO
LA
Eb
az
az
Xi
PE
"}
(18,1,1) = {"
eL
Ti
Eb
ap
CK
BF
Vs
qP
RQ
Vs
Vs
Vs
RQ
lz
Gb
Gb
Eb
Eb
Eb
Eb
az
az
Xi
PE
"}
(19,1,1) = {"
eL
Ti
Eb
ap
CK
Vs
Vs
ty
Eb
jE
Vs
hU
Eb
lz
Gb
Gb
IQ
nY
AP
Eb
az
az
Xi
PE
"}
(20,1,1) = {"
Qr
Ti
Eb
KK
CK
Vs
Go
Ro
Eb
Rx
Rx
Rx
Eb
Gb
Gb
DM
Eb
dO
LA
Eb
az
az
ke
Wt
"}
(21,1,1) = {"
eL
Ti
Jh
wF
Fc
wF
wF
Jh
Jh
Jh
Jh
Jh
Jh
lz
Gb
Gb
Eb
Eb
Eb
Eb
az
UK
ke
at
"}
(22,1,1) = {"
DP
Ti
Jh
vO
CK
Al
BF
KQ
BF
dy
Vs
jf
Jh
lz
Gb
Gb
Eb
DP
az
az
az
az
ke
Bq
"}
(23,1,1) = {"
DP
Ti
Jh
Vs
CK
Vs
BF
BF
BF
Vs
BF
Vs
Jh
lz
Gb
Gb
Eb
DP
az
az
az
az
ke
ly
"}
(24,1,1) = {"
DP
Ti
Jh
Vs
IT
Vs
Vs
EU
Vs
Vs
We
EU
Jh
lz
Gb
Gb
Eb
DP
DP
az
az
az
ke
vy
"}
(25,1,1) = {"
DP
Ti
Jh
qi
Vs
vp
Vs
jS
Vs
WO
Vs
BA
Jh
Gb
Gb
Gb
Eb
DP
DP
az
az
az
ke
wa
"}
(26,1,1) = {"
DP
Ti
Jh
Jh
Jh
Jh
Jh
Jh
Jh
Jh
Jh
Jh
Jh
tf
oa
OP
Eb
DP
DP
az
az
az
ke
FT
"}
