//MAP CONVERTED BY dmm2tgm.py THIS HEADER COMMENT PREVENTS RECONVERSION, DO NOT REMOVE
"j" = (
/obj/effect/ai_node,
/turf/open/floor/plating/ground/mars/random/cave/rock,
/area/bigredv2/caves/southwest)
"m" = (
/obj/effect/landmark/lv624/fog_blocker,
/turf/open/floor/plating/ground/mars/random/cave/rock,
/area/bigredv2/caves/southwest)
"q" = (
/turf/open/floor/plating/ground/mars/random/cave/rock,
/area/bigredv2/caves/south)
"t" = (
/turf/open/floor/plating/ground/mars/random/cave/rock,
/area/bigredv2/caves/southwest)
"x" = (
/obj/effect/ai_node,
/turf/open/floor/plating/ground/mars/random/cave/rock,
/area/bigredv2/caves/south)
"y" = (
/turf/open/floor/plating/ground/mars/random/cave,
/area/bigredv2/caves/southwest)
"z" = (
/obj/effect/landmark/lv624/fog_blocker,
/turf/open/floor/plating/ground/mars/random/cave,
/area/bigredv2/caves/south)
"E" = (
/obj/effect/landmark/excavation_site_spawner,
/turf/open/floor/plating/ground/mars/random/cave,
/area/bigredv2/caves/south)
"G" = (
/turf/closed/mineral/smooth/bigred,
/area/bigredv2/caves/rock)
"K" = (
/obj/effect/landmark/lv624/fog_blocker,
/turf/open/floor/plating/ground/mars/random/cave,
/area/bigredv2/caves/southwest)
"N" = (
/obj/effect/landmark/lv624/fog_blocker,
/turf/closed/mineral/smooth/bigred,
/area/bigredv2/caves/rock)
"O" = (
/turf/open/floor/plating/ground/mars/random/cave,
/area/bigredv2/caves/south)
"X" = (
/obj/effect/ai_node,
/turf/open/floor/plating/ground/mars/random/cave,
/area/bigredv2/caves/southwest)
"Z" = (
/obj/effect/ai_node,
/turf/open/floor/plating/ground/mars/random/cave,
/area/bigredv2/caves/south)

(1,1,1) = {"
N
G
G
G
G
G
t
y
y
y
t
G
G
G
G
y
y
G
G
G
G
G
"}
(2,1,1) = {"
K
G
G
G
G
G
G
y
X
y
t
G
G
G
G
y
y
y
G
G
G
G
"}
(3,1,1) = {"
K
G
G
G
G
G
G
y
y
y
t
G
G
G
t
y
y
G
G
G
G
G
"}
(4,1,1) = {"
K
G
G
G
G
G
y
y
y
y
t
G
G
G
t
y
y
G
G
G
G
G
"}
(5,1,1) = {"
K
t
G
G
G
G
y
y
y
y
y
G
G
t
y
y
y
G
G
G
G
G
"}
(6,1,1) = {"
K
t
G
G
t
t
y
y
y
y
y
G
G
y
y
X
G
G
G
G
G
G
"}
(7,1,1) = {"
K
y
t
j
y
y
y
y
X
y
G
G
G
y
X
G
G
G
G
G
G
G
"}
(8,1,1) = {"
K
y
y
t
y
y
y
y
y
G
G
G
y
y
y
G
G
G
G
G
G
G
"}
(9,1,1) = {"
K
t
y
y
y
y
y
G
G
G
G
G
y
y
y
G
G
G
G
G
G
G
"}
(10,1,1) = {"
m
y
y
X
G
G
G
G
G
G
G
G
y
y
y
G
G
y
G
G
G
G
"}
(11,1,1) = {"
K
y
y
G
G
G
G
G
G
G
G
G
y
y
y
y
y
y
G
G
G
G
"}
(12,1,1) = {"
y
K
y
G
G
G
G
G
G
G
G
G
y
y
y
y
y
y
G
G
G
G
"}
(13,1,1) = {"
y
y
K
N
G
G
G
G
G
G
G
G
y
y
y
y
y
G
G
G
G
G
"}
(14,1,1) = {"
y
y
G
G
N
G
G
G
G
G
G
G
y
y
y
y
G
G
G
G
G
G
"}
(15,1,1) = {"
y
y
G
G
G
N
G
G
G
G
G
G
G
y
y
t
G
G
G
G
G
G
"}
(16,1,1) = {"
y
y
G
G
G
G
N
G
G
G
G
G
G
y
X
t
t
G
G
G
G
G
"}
(17,1,1) = {"
y
y
G
G
G
G
N
G
G
G
G
G
G
y
t
t
G
G
G
G
G
G
"}
(18,1,1) = {"
y
X
G
G
G
G
N
G
G
G
G
G
G
y
y
y
G
G
G
G
G
G
"}
(19,1,1) = {"
y
y
y
G
G
G
N
G
G
G
G
G
y
y
y
y
y
G
G
G
G
G
"}
(20,1,1) = {"
t
y
y
y
G
G
N
G
G
G
y
y
y
y
y
t
y
G
G
G
G
G
"}
(21,1,1) = {"
t
y
y
y
G
G
N
G
G
G
y
y
y
y
y
t
y
G
G
G
G
G
"}
(22,1,1) = {"
y
y
y
y
y
G
N
G
G
G
y
y
y
y
y
G
G
G
G
G
G
G
"}
(23,1,1) = {"
y
y
y
y
y
G
N
G
G
G
y
y
y
y
y
G
G
G
G
G
G
G
"}
(24,1,1) = {"
y
y
y
y
y
G
N
G
G
G
y
y
y
y
y
G
G
G
G
G
G
G
"}
(25,1,1) = {"
y
y
y
y
y
G
N
G
G
G
G
t
y
y
X
y
G
G
G
G
G
G
"}
(26,1,1) = {"
O
O
O
O
O
G
N
G
G
G
G
O
O
q
O
E
G
G
G
G
G
G
"}
(27,1,1) = {"
O
Z
O
O
O
O
N
G
G
G
G
G
O
O
O
O
O
G
G
G
G
G
"}
(28,1,1) = {"
q
O
Z
O
O
O
z
Z
G
G
G
G
G
O
O
O
O
O
O
G
G
G
"}
(29,1,1) = {"
q
O
O
O
O
O
z
O
O
G
G
G
G
O
Z
q
O
Z
O
O
G
G
"}
(30,1,1) = {"
O
O
O
O
O
G
z
O
O
O
G
G
G
G
O
O
O
O
O
O
O
G
"}
(31,1,1) = {"
O
O
O
O
G
G
N
O
O
O
G
G
G
G
G
O
O
O
O
O
O
G
"}
(32,1,1) = {"
O
O
O
G
G
G
N
O
O
O
G
G
G
G
G
O
O
O
O
O
O
O
"}
(33,1,1) = {"
O
O
G
G
G
G
N
Z
O
O
Z
G
G
G
G
O
O
O
O
O
O
O
"}
(34,1,1) = {"
q
O
G
G
G
G
N
G
O
O
O
O
G
G
G
O
O
Z
O
O
Z
O
"}
(35,1,1) = {"
q
O
G
G
G
G
N
G
O
O
O
O
O
G
O
O
O
O
O
O
q
O
"}
(36,1,1) = {"
q
O
G
G
G
G
N
O
O
O
O
O
O
O
O
O
O
O
O
O
O
O
"}
(37,1,1) = {"
O
O
G
G
G
G
N
Z
O
O
Z
O
O
O
O
O
O
Z
O
O
O
O
"}
(38,1,1) = {"
O
Z
O
G
G
G
z
O
O
O
G
O
O
O
O
O
O
O
O
O
O
O
"}
(39,1,1) = {"
O
O
O
G
G
O
z
O
O
G
G
G
O
O
O
O
O
O
O
O
O
O
"}
(40,1,1) = {"
O
Z
O
O
O
O
z
Z
G
G
G
G
G
O
O
O
O
O
O
O
Z
O
"}
(41,1,1) = {"
O
O
O
O
O
O
z
G
G
G
G
G
G
O
O
O
O
O
x
O
O
Z
"}
(42,1,1) = {"
O
O
O
O
O
O
N
G
G
G
G
G
O
O
O
O
O
O
O
E
O
O
"}
(43,1,1) = {"
O
G
G
G
G
G
N
G
G
G
G
O
Z
O
q
Z
O
O
Z
q
G
G
"}
(44,1,1) = {"
G
G
G
G
G
G
N
G
G
G
G
G
O
q
O
O
O
x
G
G
G
G
"}
