//MAP CONVERTED BY dmm2tgm.py THIS HEADER COMMENT PREVENTS RECONVERSION, DO NOT REMOVE
"a" = (
/obj/structure/cable,
/obj/machinery/atmospherics/pipe/simple/green/hidden{
	dir = 5
	},
/turf/open/floor/marking/asteroidwarning{
	dir = 10
	},
/area/bigredv3/outside/directions/central)
"c" = (
/obj/machinery/atmospherics/components/unary/vent_pump{
	dir = 1;
	on = 1
	},
/turf/open/floor,
/area/bigredv3/inside/secondary/auxstore)
"d" = (
/obj/structure/cable,
/obj/machinery/atmospherics/pipe/simple/green/hidden{
	dir = 6
	},
/turf/open/floor,
/area/bigredv3/inside/secondary/auxstore)
"g" = (
/obj/machinery/atmospherics/pipe/simple/green/hidden{
	dir = 9
	},
/obj/structure/cable,
/obj/effect/ai_node,
/turf/open/floor/marking/asteroidwarning{
	dir = 6
	},
/area/bigredv3/outside/directions/central)
"h" = (
/turf/open/floor/marking/asteroidwarning{
	dir = 4
	},
/area/bigredv3/outside/directions/central)
"i" = (
/obj/machinery/atmospherics/pipe/simple/green/hidden{
	dir = 4
	},
/obj/structure/cable,
/turf/open/floor,
/area/bigredv3/inside/secondary/auxstore)
"k" = (
/obj/machinery/atmospherics/pipe/simple/green/hidden{
	dir = 10
	},
/obj/structure/cable,
/turf/open/floor/asteroidfloor,
/area/bigredv3/outside/directions/central)
"l" = (
/obj/machinery/atmospherics/pipe/simple/green/hidden,
/obj/structure/cable,
/turf/open/floor/marking/asteroidwarning{
	dir = 8
	},
/area/bigredv3/outside/directions/central)
"n" = (
/obj/machinery/atmospherics/pipe/simple/green/hidden,
/obj/structure/cable,
/turf/open/floor/asteroidfloor,
/area/bigredv3/outside/directions/central)
"q" = (
/turf/open/floor/asteroidfloor,
/area/bigredv3/outside/directions/central)
"r" = (
/turf/closed/wall/r_wall,
/area/bigredv3/inside/wall)
"s" = (
/obj/structure/rack,
/obj/machinery/light{
	dir = 1
	},
/turf/open/floor,
/area/bigredv3/inside/secondary/auxstore)
"t" = (
/obj/machinery/atmospherics/pipe/simple/green/hidden{
	dir = 4
	},
/obj/structure/cable,
/turf/open/floor/asteroidfloor,
/area/bigredv3/outside/directions/central)
"u" = (
/obj/effect/ai_node,
/turf/open/floor,
/area/bigredv3/inside/secondary/auxstore)
"v" = (
/obj/machinery/atmospherics/pipe/simple/green/hidden{
	dir = 4
	},
/obj/structure/cable,
/turf/open/floor/marking/asteroidwarning,
/area/bigredv3/outside/directions/central)
"w" = (
/obj/structure/cable,
/obj/machinery/light{
	dir = 1
	},
/obj/machinery/power/apc/weak/ntf,
/turf/open/floor,
/area/bigredv3/inside/secondary/auxstore)
"y" = (
/turf/open/floor/plating/ground/mars/random/sand,
/area/bigredv3/outside/directions/central)
"A" = (
/obj/structure/rack,
/obj/machinery/light,
/turf/open/floor,
/area/bigredv3/inside/secondary/auxstore)
"D" = (
/turf/open/floor/marking/asteroidwarning{
	dir = 1
	},
/area/bigredv3/outside/directions/central)
"E" = (
/obj/effect/ai_node,
/obj/structure/cable,
/obj/machinery/atmospherics/pipe/manifold/green/hidden{
	dir = 1
	},
/turf/open/floor/asteroidfloor,
/area/bigredv3/outside/directions/central)
"F" = (
/obj/structure/cable,
/obj/machinery/atmospherics/pipe/simple/green/hidden,
/turf/open/floor/marking/asteroidwarning{
	dir = 8
	},
/area/bigredv3/outside/directions/central)
"G" = (
/turf/open/floor/marking/asteroidwarning{
	dir = 8
	},
/area/bigredv3/outside/directions/central)
"H" = (
/obj/machinery/atmospherics/pipe/simple/green/hidden,
/obj/structure/cable,
/turf/open/floor/marking/asteroidwarning{
	dir = 4
	},
/area/bigredv3/outside/directions/central)
"I" = (
/obj/structure/sign/securearea,
/turf/open/floor/marking/asteroidwarning{
	dir = 1
	},
/area/bigredv3/outside/directions/central)
"J" = (
/turf/open/floor,
/area/bigredv3/inside/secondary/auxstore)
"K" = (
/obj/structure/rack,
/turf/open/floor,
/area/bigredv3/inside/secondary/auxstore)
"M" = (
/obj/machinery/atmospherics/pipe/manifold/green/hidden{
	dir = 1
	},
/obj/structure/cable,
/obj/effect/ai_node,
/turf/open/floor/asteroidfloor,
/area/bigredv3/outside/directions/central)
"O" = (
/obj/machinery/atmospherics/pipe/manifold/green/hidden{
	dir = 1
	},
/obj/structure/cable,
/turf/open/floor/asteroidfloor,
/area/bigredv3/outside/directions/central)
"P" = (
/turf/open/floor/marking/asteroidwarning{
	dir = 5
	},
/area/bigredv3/outside/directions/central)
"S" = (
/obj/machinery/atmospherics/pipe/simple/green/hidden{
	dir = 4
	},
/obj/structure/cable,
/obj/machinery/door/airlock/mainship/secure/locked/free_access{
	name = "\improper Emergency Vault"
	},
/turf/open/floor,
/area/bigredv3/inside/secondary/auxstore)
"V" = (
/obj/structure/rack,
/obj/structure/sign/securearea,
/turf/open/floor,
/area/bigredv3/inside/secondary/auxstore)
"W" = (
/turf/open/floor/marking/asteroidwarning{
	dir = 9
	},
/area/bigredv3/outside/directions/central)
"X" = (
/obj/structure/cable,
/turf/open/floor,
/area/bigredv3/inside/secondary/auxstore)

(1,1,1) = {"
y
W
G
q
M
k
l
F
a
"}
(2,1,1) = {"
y
D
r
r
r
r
r
r
v
"}
(3,1,1) = {"
y
I
r
K
J
J
V
r
v
"}
(4,1,1) = {"
y
D
r
s
J
J
A
r
v
"}
(5,1,1) = {"
y
D
r
K
J
J
K
r
v
"}
(6,1,1) = {"
y
D
r
K
J
J
K
r
v
"}
(7,1,1) = {"
y
D
r
K
u
J
K
r
O
"}
(8,1,1) = {"
y
D
r
w
X
J
A
r
E
"}
(9,1,1) = {"
y
D
r
K
X
J
K
r
t
"}
(10,1,1) = {"
y
D
r
K
d
c
K
r
v
"}
(11,1,1) = {"
y
D
r
K
i
J
K
r
v
"}
(12,1,1) = {"
y
D
r
K
i
J
K
r
v
"}
(13,1,1) = {"
y
D
r
s
i
J
A
r
v
"}
(14,1,1) = {"
y
I
r
K
i
J
V
r
v
"}
(15,1,1) = {"
y
D
r
r
S
r
r
r
v
"}
(16,1,1) = {"
y
P
h
q
M
n
H
H
g
"}
