//MAP CONVERTED BY dmm2tgm.py THIS HEADER COMMENT PREVENTS RECONVERSION, DO NOT REMOVE
"bh" = (
/obj/structure/window/framed/colony,
/obj/machinery/door/poddoor/shutters/mainship{
	id = "Chapel";
	name = "\improper Chapel Shutters"
	},
/turf/open/floor/plating,
/area/bigredv3/inside/wall)
"cb" = (
/obj/machinery/atmospherics/pipe/simple/green/hidden{
	dir = 4
	},
/turf/open/floor/grayscale/darkred,
/area/bigredv3/inside/colony/chapel)
"hE" = (
/obj/machinery/atmospherics/components/unary/vent_pump{
	dir = 8;
	on = 1
	},
/obj/effect/ai_node,
/obj/structure/cable,
/turf/open/floor/grayscale/darkred,
/area/bigredv3/inside/colony/chapel)
"hN" = (
/obj/structure/table/wood,
/turf/open/floor/engine/cult,
/area/bigredv3/inside/colony/chapel)
"im" = (
/obj/structure/table/wood,
/obj/item/radio/headset/survivor,
/turf/open/floor/engine/cult,
/area/bigredv3/inside/colony/chapel)
"je" = (
/obj/structure/closet/wardrobe/chaplain_black,
/turf/open/floor/engine/cult,
/area/bigredv3/inside/colony/chapel)
"jg" = (
/turf/open/floor/tile/darkish,
/area/bigredv3/inside/colony/chapel)
"le" = (
/obj/effect/decal/cleanable/blood,
/turf/open/floor/tile/chapel{
	dir = 4
	},
/area/bigredv3/inside/colony/chapel)
"lU" = (
/turf/open/floor/tile/chapel{
	dir = 4
	},
/area/bigredv3/inside/colony/chapel)
"ns" = (
/obj/item/tool/candle,
/turf/open/floor/tile/chapel,
/area/bigredv3/inside/colony/chapel)
"nQ" = (
/obj/effect/landmark/start/job/survivor,
/obj/effect/landmark/start/latejoinsurvivor,
/obj/structure/bed/chair/wood/wings{
	dir = 8
	},
/turf/open/floor/tile/chapel{
	dir = 4
	},
/area/bigredv3/inside/colony/chapel)
"ow" = (
/obj/item/tool/kitchen/knife/ritual,
/turf/open/floor/grayscale/darkred,
/area/bigredv3/inside/colony/chapel)
"pK" = (
/obj/structure/bed/chair/wood/wings{
	dir = 8
	},
/obj/effect/decal/cleanable/ash,
/turf/open/floor/tile/chapel{
	dir = 8
	},
/area/bigredv3/inside/colony/chapel)
"pS" = (
/obj/structure/stairs/edge,
/turf/open/floor/tile/dark,
/area/bigredv3/inside/colony/chapel)
"qq" = (
/obj/structure/bed/chair/wood/wings{
	dir = 8
	},
/turf/open/floor/tile/chapel{
	dir = 1
	},
/area/bigredv3/inside/colony/chapel)
"rc" = (
/obj/machinery/atmospherics/pipe/simple/green/hidden{
	dir = 4
	},
/obj/effect/decal/cleanable/blood/six{
	dir = 4
	},
/turf/open/floor/grayscale/darkred,
/area/bigredv3/inside/colony/chapel)
"ru" = (
/obj/machinery/atmospherics/components/unary/vent_pump{
	dir = 4;
	on = 1
	},
/obj/effect/decal/cleanable/blood,
/obj/item/clothing/head/cardborg,
/turf/open/floor/engine/cult,
/area/bigredv3/inside/colony/chapel)
"tb" = (
/obj/effect/decal/cleanable/blood/gibs/body,
/turf/open/floor/engine/cult,
/area/bigredv3/inside/colony/chapel)
"tX" = (
/obj/effect/ai_node,
/obj/item/organ/heart,
/turf/open/floor/engine/cult,
/area/bigredv3/inside/colony/chapel)
"uy" = (
/obj/machinery/light{
	dir = 1
	},
/turf/open/floor/grayscale/darkred,
/area/bigredv3/inside/colony/chapel)
"uV" = (
/obj/item/tool/candle,
/turf/open/floor/grayscale/darkred,
/area/bigredv3/inside/colony/chapel)
"vc" = (
/obj/structure/bed/chair/wood/wings{
	dir = 8
	},
/turf/open/floor/tile/chapel,
/area/bigredv3/inside/colony/chapel)
"vg" = (
/obj/machinery/atmospherics/pipe/manifold/green/hidden,
/obj/structure/cable,
/obj/effect/decal/cleanable/blood/six{
	dir = 4
	},
/turf/open/floor/grayscale/darkred,
/area/bigredv3/inside/colony/chapel)
"vJ" = (
/obj/machinery/atmospherics/pipe/simple/green/hidden,
/obj/structure/cable,
/obj/item/tool/candle,
/turf/open/floor/tile/chapel{
	dir = 1
	},
/area/bigredv3/inside/colony/chapel)
"vU" = (
/turf/closed/wall,
/area/bigredv3/inside/wall)
"wa" = (
/obj/item/tool/candle,
/turf/open/floor/tile/chapel{
	dir = 8
	},
/area/bigredv3/inside/colony/chapel)
"xw" = (
/obj/item/trash/candle,
/turf/open/floor/grayscale/darkred,
/area/bigredv3/inside/colony/chapel)
"zF" = (
/obj/machinery/light{
	dir = 4
	},
/obj/machinery/power/apc/weak/ntf{
	dir = 8
	},
/obj/structure/cable,
/turf/open/floor/grayscale/darkred,
/area/bigredv3/inside/colony/chapel)
"zI" = (
/obj/machinery/atmospherics/pipe/simple/green/hidden{
	dir = 4
	},
/obj/item/tool/candle,
/turf/open/floor/grayscale/darkred,
/area/bigredv3/inside/colony/chapel)
"AD" = (
/obj/machinery/door_control{
	dir = 4;
	id = "Chapel";
	name = "Storm Shutters"
	},
/obj/effect/decal/cleanable/blood,
/turf/open/floor/engine/cult,
/area/bigredv3/inside/colony/chapel)
"By" = (
/obj/structure/cable,
/obj/machinery/atmospherics/pipe/simple/green/hidden,
/obj/machinery/door/airlock/multi_tile/mainship/generic{
	name = "\improper Chapel"
	},
/turf/open/floor/tile/darkish,
/area/bigredv3/inside/colony/chapel)
"Cl" = (
/obj/machinery/air_alarm{
	dir = 1
	},
/turf/open/floor/grayscale/darkred,
/area/bigredv3/inside/colony/chapel)
"CO" = (
/obj/structure/stairs/edge{
	dir = 1
	},
/turf/open/floor/tile/dark,
/area/bigredv3/inside/colony/chapel)
"Dk" = (
/obj/structure/table/wood,
/turf/open/floor/tile/darkish,
/area/bigredv3/inside/colony/chapel)
"Ei" = (
/obj/machinery/atmospherics/pipe/simple/green/hidden{
	dir = 4
	},
/obj/structure/table/wood,
/obj/item/storage/bible,
/turf/open/floor/engine/cult,
/area/bigredv3/inside/colony/chapel)
"EZ" = (
/obj/machinery/light,
/turf/open/floor/grayscale/darkred,
/area/bigredv3/inside/colony/chapel)
"FV" = (
/obj/item/trash/candle,
/turf/open/floor/engine/cult,
/area/bigredv3/inside/colony/chapel)
"ID" = (
/turf/open/floor/engine/cult,
/area/bigredv3/inside/colony/chapel)
"JD" = (
/obj/structure/bed/chair/wood/wings{
	dir = 8
	},
/obj/effect/decal/cleanable/ash,
/turf/open/floor/tile/chapel,
/area/bigredv3/inside/colony/chapel)
"Lr" = (
/obj/structure/table/wood,
/obj/item/tool/candle,
/turf/open/floor/tile/darkish,
/area/bigredv3/inside/colony/chapel)
"NF" = (
/obj/structure/bed/chair/wood/wings{
	dir = 8
	},
/obj/effect/decal/cleanable/ash,
/turf/open/floor/tile/chapel{
	dir = 4
	},
/area/bigredv3/inside/colony/chapel)
"Oe" = (
/obj/structure/window/framed/colony,
/obj/machinery/door/poddoor/shutters/mainship{
	dir = 2;
	id = "Chapel";
	name = "\improper Chapel Shutters"
	},
/turf/open/floor/plating,
/area/bigredv3/inside/wall)
"OL" = (
/obj/machinery/atmospherics/pipe/simple/green/hidden,
/obj/structure/cable,
/turf/open/floor/tile/chapel{
	dir = 8
	},
/area/bigredv3/inside/colony/chapel)
"PY" = (
/obj/structure/bed/chair/wood/wings{
	dir = 8
	},
/turf/open/floor/tile/chapel{
	dir = 8
	},
/area/bigredv3/inside/colony/chapel)
"Qt" = (
/obj/machinery/atmospherics/pipe/simple/green/hidden{
	dir = 4
	},
/obj/effect/ai_node,
/obj/effect/decal/cleanable/blood/six{
	dir = 1
	},
/turf/open/floor/grayscale/darkred,
/area/bigredv3/inside/colony/chapel)
"Sg" = (
/turf/open/floor/tile/chapel,
/area/bigredv3/inside/colony/chapel)
"Sv" = (
/obj/structure/table/wood,
/obj/item/weapon/chainofcommand,
/turf/open/floor/engine/cult,
/area/bigredv3/inside/colony/chapel)
"SE" = (
/obj/machinery/atmospherics/pipe/simple/green/hidden,
/obj/structure/cable,
/turf/open/floor/grayscale/darkred,
/area/bigredv3/inside/colony/chapel)
"Te" = (
/turf/open/floor/grayscale/darkred,
/area/bigredv3/inside/colony/chapel)
"TT" = (
/obj/machinery/atmospherics/pipe/simple/green/hidden{
	dir = 4
	},
/obj/item/trash/candle,
/turf/open/floor/grayscale/darkred,
/area/bigredv3/inside/colony/chapel)
"TZ" = (
/obj/effect/decal/cleanable/blood,
/turf/open/floor/grayscale/darkred,
/area/bigredv3/inside/colony/chapel)
"VH" = (
/obj/machinery/light{
	dir = 1
	},
/obj/item/trash/candle,
/turf/open/floor/grayscale/darkred,
/area/bigredv3/inside/colony/chapel)
"VS" = (
/obj/effect/decal/cleanable/blood/six{
	dir = 1
	},
/turf/open/floor/tile/chapel{
	dir = 8
	},
/area/bigredv3/inside/colony/chapel)
"Xm" = (
/turf/open/floor/tile/chapel{
	dir = 1
	},
/area/bigredv3/inside/colony/chapel)
"XR" = (
/obj/effect/decal/cleanable/blood/six{
	dir = 1
	},
/turf/open/floor/tile/chapel{
	dir = 1
	},
/area/bigredv3/inside/colony/chapel)
"Zz" = (
/obj/structure/bed/chair/wood/wings{
	dir = 8
	},
/turf/open/floor/tile/chapel{
	dir = 4
	},
/area/bigredv3/inside/colony/chapel)

(1,1,1) = {"
vU
vU
bh
bh
bh
bh
bh
vU
vU
"}
(2,1,1) = {"
vU
je
ID
FV
tX
FV
ID
AD
vU
"}
(3,1,1) = {"
Oe
Te
pS
tb
ru
tb
CO
Te
vU
"}
(4,1,1) = {"
Oe
Te
im
Sv
Ei
hN
hN
Te
vU
"}
(5,1,1) = {"
vU
VH
XR
VS
Qt
XR
VS
EZ
vU
"}
(6,1,1) = {"
Oe
uV
NF
JD
cb
NF
JD
Te
vU
"}
(7,1,1) = {"
Oe
Te
qq
pK
TT
qq
pK
Te
vU
"}
(8,1,1) = {"
vU
uy
Zz
JD
rc
nQ
vc
EZ
vU
"}
(9,1,1) = {"
Oe
Te
qq
PY
cb
qq
PY
Te
vU
"}
(10,1,1) = {"
Oe
ow
Zz
vc
cb
NF
JD
Te
vU
"}
(11,1,1) = {"
vU
uy
qq
PY
zI
qq
PY
EZ
vU
"}
(12,1,1) = {"
Oe
uV
Zz
vc
rc
Zz
vc
xw
vU
"}
(13,1,1) = {"
Oe
uV
qq
PY
cb
qq
PY
uV
vU
"}
(14,1,1) = {"
vU
uy
Zz
vc
cb
Zz
vc
EZ
vU
"}
(15,1,1) = {"
By
SE
vJ
OL
vg
Xm
wa
Te
vU
"}
(16,1,1) = {"
jg
TZ
lU
Sg
hE
le
ns
Te
vU
"}
(17,1,1) = {"
vU
Te
Lr
Lr
zF
Dk
Dk
Cl
vU
"}
(18,1,1) = {"
vU
vU
vU
vU
vU
vU
vU
vU
vU
"}
