//MAP CONVERTED BY dmm2tgm.py THIS HEADER COMMENT PREVENTS RECONVERSION, DO NOT REMOVE
"ab" = (
/turf/open/floor/marking/asteroidwarning{
	dir = 4
	},
/area/bigredv3/outside/directions/s)
"ah" = (
/obj/structure/window/framed/colony/reinforced,
/turf/open/floor/plating,
/area/bigredv3/inside/wall)
"aj" = (
/obj/effect/landmark/lv624/fog_blocker,
/obj/effect/ai_node,
/turf/open/floor,
/area/bigredv3/outside/directions/s)
"ak" = (
/obj/effect/landmark/lv624/fog_blocker,
/obj/machinery/floodlight/outpost/bigred,
/turf/open/floor/plating/ground/mars/random/cave,
/area/bigredv3/outside/directions/se)
"am" = (
/obj/effect/spawner/random/engineering/structure/tank/waterweighted,
/turf/open/floor,
/area/bigredv3/inside/engi/east)
"an" = (
/obj/effect/decal/cleanable/dirt,
/obj/structure/table,
/turf/open/floor,
/area/bigredv3/inside/engi/east)
"aJ" = (
/turf/open/floor/marking/asteroidwarning{
	dir = 5
	},
/area/bigredv3/outside/directions/se)
"bS" = (
/obj/machinery/atmospherics/pipe/simple/green/hidden{
	dir = 9
	},
/obj/effect/decal/cleanable/dirt,
/obj/effect/ai_node,
/obj/structure/cable,
/turf/open/floor,
/area/bigredv3/inside/engi/east)
"cu" = (
/obj/effect/landmark/lv624/fog_blocker,
/turf/closed/wall/r_wall/unmeltable,
/area/bigredv3/inside/wall)
"cw" = (
/obj/machinery/atmospherics/components/unary/vent_pump,
/obj/effect/decal/cleanable/dirt,
/obj/effect/decal/cleanable/dirt,
/obj/structure/cable,
/turf/open/floor,
/area/bigredv3/inside/engi/east)
"dr" = (
/turf/open/floor/asteroidfloor,
/area/bigredv3/outside/directions/s)
"dt" = (
/obj/effect/decal/cleanable/dirt,
/obj/machinery/atmospherics/pipe/simple/green/hidden,
/obj/effect/ai_node,
/turf/open/floor,
/area/bigredv3/inside/engi/east)
"dv" = (
/obj/structure/table,
/obj/effect/spawner/random/engineering/technology_scanner,
/obj/machinery/light,
/turf/open/floor,
/area/bigredv3/inside/engi/east)
"dz" = (
/obj/machinery/atmospherics/pipe/manifold/green/hidden,
/turf/open/floor,
/area/bigredv3/inside/engi/east)
"fx" = (
/obj/machinery/portable_atmospherics/scrubber/huge,
/turf/open/floor/plating,
/area/bigredv3/inside/engi/east)
"fZ" = (
/obj/effect/decal/cleanable/dirt,
/obj/structure/rack,
/obj/effect/spawner/random/engineering/tool,
/turf/open/floor,
/area/bigredv3/inside/engi/east)
"gr" = (
/obj/effect/decal/cleanable/dirt,
/turf/open/floor/marking/asteroidwarning{
	dir = 4
	},
/area/bigredv3/outside/directions/s)
"gs" = (
/obj/machinery/floodlight/outpost/bigred,
/turf/open/floor/plating/ground/mars/random/sand,
/area/bigredv3/outside/directions/se)
"hT" = (
/obj/item/tank/air,
/turf/open/floor,
/area/bigredv3/outside/directions/s)
"hZ" = (
/obj/structure/sign/safety/vent,
/turf/closed/wall/r_wall,
/area/bigredv3/inside/wall)
"jH" = (
/turf/closed/wall,
/area/bigredv3/inside/wall)
"jK" = (
/obj/effect/turf_decal/warning_stripes/box/empty,
/obj/effect/turf_decal/warning_stripes/box/empty,
/turf/open/floor,
/area/bigredv3/outside/directions/s)
"jO" = (
/turf/open/floor/plating/ground/mars/random/sand,
/area/bigredv3/outside/directions/se)
"jV" = (
/obj/machinery/floodlight/outpost/bigred,
/turf/open/floor/asteroidfloor,
/area/bigredv3/outside/directions/s)
"jW" = (
/obj/effect/decal/cleanable/dirt,
/turf/closed/wall,
/area/bigredv3/inside/wall)
"kO" = (
/obj/structure/fence/standard/xenoproof,
/turf/open/floor/plating/ground/mars/random/cave,
/area/bigredv3/outside/directions/se)
"kT" = (
/turf/open/floor/plating/ground/mars/random/cave,
/area/bigredv3/outside/directions/se)
"lc" = (
/obj/machinery/atmospherics/pipe/manifold/green/hidden,
/obj/effect/ai_node,
/obj/structure/cable,
/turf/open/floor,
/area/bigredv3/inside/engi/east)
"mx" = (
/turf/closed/mineral/smooth/bigred,
/area/bigredv3/caves/rock)
"mZ" = (
/obj/machinery/atmospherics/pipe/simple/green/hidden{
	dir = 5
	},
/obj/structure/cable,
/turf/open/floor,
/area/bigredv3/inside/engi/east)
"nU" = (
/obj/structure/window/framed/colony/reinforced/hull,
/obj/effect/forcefield/allow_bullet_travel,
/turf/open/floor/plating,
/area/bigredv3/inside/wall)
"oi" = (
/obj/effect/ai_node,
/turf/open/floor/marking/asteroidwarning{
	dir = 1
	},
/area/bigredv3/outside/directions/se)
"om" = (
/obj/machinery/light,
/turf/open/floor,
/area/bigredv3/inside/engi/east)
"oy" = (
/obj/effect/landmark/lv624/fog_blocker,
/turf/open/floor/marking/asteroidwarning{
	dir = 4
	},
/area/bigredv3/outside/directions/s)
"oU" = (
/obj/effect/landmark/lv624/fog_blocker,
/turf/open/floor,
/area/bigredv3/outside/directions/s)
"oZ" = (
/obj/item/tank/air,
/turf/open/floor/plating/ground/mars/random/cave,
/area/bigredv3/outside/directions/se)
"ph" = (
/obj/effect/spawner/random/misc/structure/supplycrate,
/obj/effect/turf_decal/warning_stripes/box/empty,
/obj/effect/turf_decal/warning_stripes/box/empty,
/turf/open/floor,
/area/bigredv3/inside/engi/east)
"pu" = (
/obj/machinery/atmospherics/pipe/simple/green/hidden{
	dir = 4
	},
/obj/machinery/door/airlock/mainship/engineering{
	name = "\improper Atmospherics Condenser Storage";
	req_one_access = null
	},
/obj/structure/cable,
/turf/open/floor,
/area/bigredv3/inside/engi/east)
"pA" = (
/obj/effect/decal/cleanable/dirt,
/obj/machinery/atmospherics/pipe/simple/green/hidden{
	dir = 4
	},
/obj/structure/cable,
/turf/open/floor,
/area/bigredv3/inside/engi/east)
"pM" = (
/obj/structure/table,
/obj/machinery/door_control/old{
	id = "FiltrationShutters";
	name = "Airlock Shutters";
	pixel_y = 2
	},
/turf/open/floor,
/area/bigredv3/inside/engi/east)
"pN" = (
/obj/item/clothing/head/warning_cone,
/turf/open/floor/plating/ground/mars/random/cave,
/area/bigredv3/outside/directions/se)
"pX" = (
/turf/open/floor,
/area/bigredv3/inside/engi/east)
"pY" = (
/obj/machinery/floodlight/outpost/bigred,
/turf/open/floor/plating/ground/mars/random/cave,
/area/bigredv3/outside/directions/se)
"qd" = (
/obj/machinery/computer/area_atmos/area,
/turf/open/floor,
/area/bigredv3/inside/engi/east)
"qe" = (
/obj/machinery/light,
/turf/open/floor/asteroidfloor,
/area/bigredv3/outside/directions/s)
"qg" = (
/obj/effect/decal/cleanable/dirt,
/obj/effect/spawner/random/engineering/structure/tank/fuelweighted,
/obj/effect/turf_decal/warning_stripes/box/empty,
/obj/effect/turf_decal/warning_stripes/box/empty,
/turf/open/floor,
/area/bigredv3/outside/directions/s)
"qk" = (
/obj/effect/decal/cleanable/dirt,
/obj/machinery/atmospherics/pipe/simple/green/hidden{
	dir = 10
	},
/obj/effect/ai_node,
/obj/structure/cable,
/turf/open/floor,
/area/bigredv3/inside/engi/east)
"qu" = (
/obj/machinery/atmospherics/pipe/simple/green/hidden,
/turf/open/floor,
/area/bigredv3/inside/engi/east)
"qx" = (
/obj/structure/cable,
/turf/open/floor,
/area/bigredv3/inside/engi/east)
"rw" = (
/obj/machinery/atmospherics/pipe/simple/green/hidden,
/obj/effect/ai_node,
/obj/structure/cable,
/turf/open/floor,
/area/bigredv3/inside/engi/east)
"rQ" = (
/obj/machinery/door/poddoor/shutters/mainship{
	dir = 1;
	id = "FiltrationShutters";
	name = "\improper Airlock Shutters"
	},
/turf/open/floor/marking/delivery,
/area/bigredv3/inside/engi/east)
"tF" = (
/obj/structure/window/framed/colony,
/turf/open/floor/plating,
/area/bigredv3/inside/engi/east)
"ug" = (
/obj/machinery/atmospherics/components/unary/vent_pump,
/turf/open/floor,
/area/bigredv3/inside/engi/east)
"uK" = (
/obj/machinery/door/airlock/mainship/engineering{
	dir = 1;
	name = "\improper Filtration Facility";
	req_one_access = null
	},
/turf/open/floor,
/area/bigredv3/inside/engi/east)
"uV" = (
/obj/effect/decal/cleanable/dirt,
/obj/machinery/atmospherics/pipe/manifold/green/hidden{
	dir = 4
	},
/obj/structure/cable,
/turf/open/floor,
/area/bigredv3/inside/engi/east)
"vf" = (
/obj/effect/decal/cleanable/dirt,
/obj/structure/cable,
/turf/open/floor,
/area/bigredv3/inside/engi/east)
"vv" = (
/obj/effect/spawner/random/engineering/structure/tank/waterweighted,
/obj/effect/turf_decal/warning_stripes/box/empty,
/obj/effect/turf_decal/warning_stripes/box/empty,
/turf/open/floor,
/area/bigredv3/inside/engi/east)
"wE" = (
/obj/machinery/door/airlock/mainship/engineering{
	name = "\improper Filtration Facility";
	req_one_access = null
	},
/obj/machinery/atmospherics/pipe/simple/green/hidden{
	dir = 4
	},
/obj/structure/cable,
/turf/open/floor,
/area/bigredv3/inside/engi/east)
"wG" = (
/obj/item/weapon/twohanded/fireaxe,
/turf/open/floor,
/area/bigredv3/inside/engi/east)
"wU" = (
/obj/machinery/atmospherics/components/unary/vent_pump{
	dir = 4
	},
/obj/effect/ai_node,
/turf/open/floor,
/area/bigredv3/inside/engi/east)
"xe" = (
/obj/structure/table,
/obj/effect/spawner/random/engineering/technology_scanner,
/turf/open/floor,
/area/bigredv3/inside/engi/east)
"xg" = (
/obj/machinery/power/geothermal,
/obj/structure/cable,
/obj/machinery/light{
	dir = 4
	},
/turf/open/floor/plating,
/area/bigredv3/inside/engi/east)
"xp" = (
/obj/effect/decal/cleanable/dirt,
/obj/structure/window/framed/colony,
/obj/structure/cable,
/turf/open/floor/plating,
/area/bigredv3/inside/engi/east)
"xr" = (
/obj/machinery/door/airlock/mainship/engineering{
	dir = 1;
	name = "\improper Atmospherics Condenser";
	req_one_access = null
	},
/turf/open/floor,
/area/bigredv3/inside/engi/east)
"xC" = (
/obj/structure/table,
/obj/effect/spawner/random/engineering/tool,
/turf/open/floor,
/area/bigredv3/inside/engi/east)
"xP" = (
/obj/structure/table,
/obj/item/circuitboard/solar_tracker,
/turf/open/floor,
/area/bigredv3/inside/engi/east)
"yq" = (
/obj/effect/ai_node,
/turf/open/floor/marking/asteroidwarning{
	dir = 4
	},
/area/bigredv3/outside/directions/s)
"yP" = (
/obj/machinery/computer3/server/rack,
/obj/effect/turf_decal/warning_stripes/box/threeside{
	dir = 1
	},
/turf/open/floor,
/area/bigredv3/inside/engi/east)
"ze" = (
/obj/structure/cable,
/obj/machinery/power/apc/weak/ntf,
/turf/open/floor,
/area/bigredv3/inside/engi/east)
"zq" = (
/turf/closed/wall/r_wall,
/area/bigredv3/inside/wall)
"zv" = (
/obj/machinery/door_control{
	id = "FiltrationShutters";
	name = "Airlock Shutters"
	},
/turf/open/floor,
/area/bigredv3/outside/directions/s)
"zP" = (
/obj/structure/cargo_container/ch_red{
	dir = 1
	},
/obj/effect/landmark/lv624/fog_blocker,
/obj/effect/turf_decal/warning_stripes/box/empty,
/obj/effect/turf_decal/warning_stripes/box/empty,
/turf/open/floor,
/area/bigredv3/outside/directions/s)
"zX" = (
/obj/effect/ai_node,
/turf/open/floor/plating/ground/mars/random/cave,
/area/bigredv3/outside/directions/se)
"Ab" = (
/obj/machinery/light{
	dir = 1
	},
/obj/item/clothing/head/warning_cone,
/turf/open/floor,
/area/bigredv3/outside/directions/s)
"Ae" = (
/obj/structure/closet/firecloset/full,
/turf/open/floor,
/area/bigredv3/inside/engi/east)
"Ak" = (
/obj/machinery/computer/atmos_alert{
	dir = 8
	},
/obj/structure/table,
/turf/open/floor,
/area/bigredv3/inside/engi/east)
"AY" = (
/obj/machinery/atmospherics/pipe/simple/green/hidden,
/obj/structure/cable,
/turf/open/floor,
/area/bigredv3/inside/engi/east)
"Bf" = (
/obj/machinery/portable_atmospherics/scrubber/huge,
/obj/effect/turf_decal/warning_stripes,
/turf/open/floor/plating,
/area/bigredv3/inside/engi/east)
"Bl" = (
/obj/structure/bed/chair{
	dir = 4
	},
/obj/effect/decal/cleanable/dirt,
/turf/open/floor,
/area/bigredv3/inside/engi/east)
"Bv" = (
/obj/effect/turf_decal/warning_stripes/box/empty,
/obj/effect/turf_decal/warning_stripes/box/empty,
/turf/open/floor,
/area/bigredv3/inside/engi/east)
"Cp" = (
/obj/effect/decal/cleanable/dirt,
/turf/open/floor,
/area/bigredv3/inside/engi/east)
"Cu" = (
/obj/machinery/atmospherics/pipe/simple/green/hidden{
	dir = 4
	},
/turf/open/floor,
/area/bigredv3/inside/engi/east)
"CC" = (
/obj/machinery/light{
	dir = 1
	},
/turf/open/floor,
/area/bigredv3/inside/engi/east)
"CZ" = (
/obj/structure/table,
/obj/machinery/computer/atmos_alert{
	dir = 4
	},
/turf/open/floor,
/area/bigredv3/inside/engi/east)
"Dd" = (
/obj/effect/ai_node,
/turf/open/floor,
/area/bigredv3/inside/engi/east)
"Do" = (
/obj/effect/ai_node,
/turf/open/floor,
/area/bigredv3/outside/directions/s)
"Eg" = (
/obj/machinery/atmospherics/pipe/simple/green/hidden{
	dir = 10
	},
/turf/open/floor,
/area/bigredv3/inside/engi/east)
"Ek" = (
/obj/machinery/atmospherics/pipe/manifold/green/hidden,
/obj/effect/decal/cleanable/dirt,
/obj/structure/cable,
/turf/open/floor,
/area/bigredv3/inside/engi/east)
"Eo" = (
/obj/structure/window/framed/colony,
/obj/structure/sign/safety/vent,
/turf/open/floor/plating,
/area/bigredv3/inside/engi/east)
"Ex" = (
/obj/effect/spawner/random/engineering/structure/tank/fuelweighted,
/obj/effect/turf_decal/warning_stripes/box/empty,
/obj/effect/turf_decal/warning_stripes/box/empty,
/turf/open/floor,
/area/bigredv3/inside/engi/east)
"EN" = (
/turf/open/floor/marking/asteroidwarning{
	dir = 9
	},
/area/bigredv3/outside/directions/se)
"EW" = (
/obj/structure/cable,
/turf/closed/wall/r_wall,
/area/bigredv3/inside/wall)
"FE" = (
/obj/machinery/power/geothermal,
/obj/structure/cable,
/turf/open/floor/plating,
/area/bigredv3/inside/engi/east)
"FN" = (
/obj/structure/table,
/obj/effect/spawner/random/engineering/toolbox,
/turf/open/floor,
/area/bigredv3/inside/engi/east)
"Gl" = (
/obj/effect/landmark/lv624/fog_blocker,
/turf/open/floor/plating/ground/mars/random/cave,
/area/bigredv3/outside/directions/se)
"HZ" = (
/obj/machinery/computer3/server/rack,
/obj/effect/turf_decal/warning_stripes/box/threeside,
/turf/open/floor,
/area/bigredv3/inside/engi/east)
"Ig" = (
/obj/machinery/light,
/turf/open/floor,
/area/bigredv3/outside/directions/s)
"Im" = (
/obj/machinery/atmospherics/pipe/simple/green/hidden{
	dir = 4
	},
/obj/structure/cable,
/turf/open/floor,
/area/bigredv3/inside/engi/east)
"Iu" = (
/obj/effect/landmark/lv624/fog_blocker,
/turf/open/floor/marking/asteroidwarning{
	dir = 8
	},
/area/bigredv3/outside/directions/s)
"JK" = (
/obj/effect/ai_node,
/turf/open/floor/asteroidfloor,
/area/bigredv3/outside/directions/s)
"JO" = (
/obj/structure/cryofeed,
/turf/open/floor/engine,
/area/bigredv3/caves/rock)
"JQ" = (
/obj/effect/ai_node,
/turf/open/floor/plating/ground/mars/random/sand,
/area/bigredv3/outside/directions/se)
"Ka" = (
/obj/structure/cargo_container/ch_red,
/obj/effect/turf_decal/warning_stripes/box/empty,
/obj/effect/turf_decal/warning_stripes/box/empty,
/turf/open/floor,
/area/bigredv3/outside/directions/s)
"Kc" = (
/obj/machinery/atmospherics/pipe/simple/green/hidden{
	dir = 4
	},
/obj/effect/ai_node,
/obj/structure/cable,
/turf/open/floor,
/area/bigredv3/inside/engi/east)
"Kl" = (
/obj/structure/window/framed/colony,
/turf/open/floor/plating,
/area/bigredv3/inside/wall)
"Kq" = (
/turf/closed/wall/r_wall/unmeltable,
/area/bigredv3/inside/wall)
"KI" = (
/obj/effect/spawner/random/engineering/pickaxe,
/turf/open/floor,
/area/bigredv3/outside/directions/s)
"Lc" = (
/obj/effect/landmark/lv624/fog_blocker,
/turf/open/floor/asteroidfloor,
/area/bigredv3/outside/directions/s)
"Lx" = (
/turf/open/floor,
/area/bigredv3/outside/directions/s)
"MA" = (
/obj/effect/spawner/random/engineering/structure/tank_dispenser/oxygenweighted,
/obj/effect/landmark/lv624/fog_blocker,
/turf/open/floor/plating/ground/mars/random/cave,
/area/bigredv3/outside/directions/se)
"MJ" = (
/obj/effect/landmark/lv624/fog_blocker,
/turf/closed/mineral/smooth/bigred,
/area/bigredv3/caves/rock)
"Nw" = (
/obj/item/clothing/head/warning_cone,
/turf/open/floor/plating/ground/mars/random/sand,
/area/bigredv3/outside/directions/se)
"NH" = (
/obj/effect/spawner/random/engineering/structure/tank_dispenser/oxygenweighted,
/obj/effect/turf_decal/warning_stripes/box/empty,
/obj/effect/turf_decal/warning_stripes/box/empty,
/turf/open/floor,
/area/bigredv3/inside/engi/east)
"Oj" = (
/obj/structure/rack,
/obj/item/tank/air,
/obj/effect/spawner/random/engineering/pickaxe,
/turf/open/floor,
/area/bigredv3/inside/engi/east)
"OF" = (
/obj/structure/cryofeed/right{
	name = "\improper coolant feed"
	},
/turf/open/floor/engine,
/area/bigredv3/caves/rock)
"PY" = (
/obj/effect/decal/cleanable/dirt,
/obj/machinery/atmospherics/pipe/simple/green/hidden{
	dir = 10
	},
/turf/open/floor,
/area/bigredv3/inside/engi/east)
"Qh" = (
/obj/effect/turf_decal/warning_stripes/box/threeside,
/obj/machinery/computer3/server/rack,
/turf/open/floor,
/area/bigredv3/inside/engi/east)
"Qk" = (
/obj/structure/closet/wardrobe/atmospherics_yellow,
/turf/open/floor,
/area/bigredv3/inside/engi/east)
"QM" = (
/obj/effect/decal/cleanable/dirt,
/obj/effect/decal/cleanable/dirt,
/obj/structure/cable,
/obj/machinery/atmospherics/pipe/simple/green/hidden{
	dir = 5
	},
/turf/open/floor,
/area/bigredv3/inside/engi/east)
"Rh" = (
/obj/effect/ai_node,
/obj/structure/cable,
/turf/open/floor,
/area/bigredv3/inside/engi/east)
"Rp" = (
/obj/effect/landmark/lv624/fog_blocker,
/obj/effect/turf_decal/warning_stripes/box/empty,
/obj/effect/turf_decal/warning_stripes/box/empty,
/turf/open/floor,
/area/bigredv3/outside/directions/s)
"RA" = (
/obj/effect/decal/cleanable/dirt,
/obj/item/radio/headset,
/turf/open/floor,
/area/bigredv3/inside/engi/east)
"RD" = (
/obj/effect/decal/cleanable/dirt,
/turf/open/floor,
/area/bigredv3/outside/directions/s)
"Sw" = (
/obj/effect/decal/cleanable/dirt,
/obj/effect/forcefield/allow_bullet_travel,
/turf/closed/wall/r_wall/unmeltable,
/area/bigredv3/inside/wall)
"SY" = (
/turf/open/floor/plating,
/area/bigredv3/inside/engi/east)
"Tf" = (
/obj/effect/decal/cleanable/dirt,
/obj/machinery/atmospherics/pipe/simple/green/hidden{
	dir = 4
	},
/turf/open/floor,
/area/bigredv3/inside/engi/east)
"TZ" = (
/obj/effect/forcefield/allow_bullet_travel,
/turf/closed/wall/r_wall/unmeltable,
/area/bigredv3/inside/wall)
"Ub" = (
/obj/machinery/portable_atmospherics/scrubber/huge,
/obj/effect/turf_decal/warning_stripes,
/obj/structure/cable,
/turf/open/floor/plating,
/area/bigredv3/inside/engi/east)
"Ug" = (
/obj/structure/cargo_container/ch_red{
	dir = 4
	},
/obj/effect/turf_decal/warning_stripes/box/empty,
/obj/effect/turf_decal/warning_stripes/box/empty,
/turf/open/floor,
/area/bigredv3/outside/directions/s)
"Uo" = (
/obj/effect/decal/cleanable/dirt,
/obj/effect/decal/cleanable/dirt,
/turf/open/floor,
/area/bigredv3/inside/engi/east)
"UC" = (
/obj/structure/cable,
/turf/open/floor/plating,
/area/bigredv3/inside/engi/east)
"Vy" = (
/obj/structure/table,
/obj/effect/spawner/random/engineering/toolbox,
/obj/machinery/light{
	dir = 1
	},
/turf/open/floor,
/area/bigredv3/inside/engi/east)
"Vz" = (
/obj/machinery/light,
/obj/effect/ai_node,
/turf/open/floor/asteroidfloor,
/area/bigredv3/outside/directions/s)
"VS" = (
/obj/machinery/door/airlock/mainship/engineering{
	dir = 1;
	name = "\improper Atmospherics Condenser";
	req_one_access = null
	},
/obj/machinery/atmospherics/pipe/simple/green/hidden,
/obj/structure/cable,
/turf/open/floor,
/area/bigredv3/inside/engi/east)
"Wc" = (
/turf/open/floor/marking/asteroidwarning{
	dir = 8
	},
/area/bigredv3/outside/directions/s)
"Wf" = (
/obj/structure/table,
/obj/item/tool/lighter/random,
/obj/effect/decal/cleanable/dirt,
/turf/open/floor,
/area/bigredv3/inside/engi/east)
"Wg" = (
/obj/machinery/door/airlock/mainship/engineering{
	dir = 1;
	name = "\improper Filtration Facility";
	req_one_access = null
	},
/obj/machinery/atmospherics/pipe/simple/green/hidden,
/turf/open/floor,
/area/bigredv3/inside/engi/east)
"YQ" = (
/obj/structure/table,
/turf/open/floor,
/area/bigredv3/inside/engi/east)
"YV" = (
/obj/structure/rack,
/obj/effect/spawner/random/engineering/tool,
/obj/machinery/light,
/turf/open/floor,
/area/bigredv3/inside/engi/east)
"Ze" = (
/obj/item/tank/air,
/obj/effect/decal/cleanable/dirt,
/turf/open/floor,
/area/bigredv3/inside/engi/east)
"ZT" = (
/obj/machinery/atmospherics/pipe/simple/green/hidden{
	dir = 5
	},
/turf/open/floor,
/area/bigredv3/inside/engi/east)

(1,1,1) = {"
jH
pu
jH
jH
jH
jH
jH
jH
jH
Kl
Kl
ah
Kq
Kq
Kq
Kq
dr
dr
dr
dr
dr
dr
dr
dr
jH
"}
(2,1,1) = {"
Qk
Im
am
jH
Ex
Bv
Ex
Ex
jH
pX
pX
wG
Kq
mx
mx
Kq
JK
dr
dr
dr
JK
jV
dr
Vz
Kq
"}
(3,1,1) = {"
Qk
Kc
om
jH
CC
Dd
pX
pX
uK
pX
wU
pX
Kq
Kq
Kq
Kq
ab
ab
ab
ab
gr
ab
ab
ab
zq
"}
(4,1,1) = {"
Qk
Im
pX
jH
NH
vv
NH
Bv
jH
pX
Cu
pX
an
CZ
pM
zq
zv
Lx
Lx
RD
Lx
RD
Lx
Lx
zq
"}
(5,1,1) = {"
jH
pu
jH
jH
jH
jH
jH
jH
jH
CC
Cu
pX
pX
pX
om
zq
Ab
RD
RD
RD
Lx
jK
jK
Ig
zq
"}
(6,1,1) = {"
Wf
pA
Cp
jH
ze
HZ
yP
pX
jH
pX
Cu
Bv
Bv
Bv
pX
rQ
Do
RD
RD
Lx
Do
jK
Ka
Lx
Kq
"}
(7,1,1) = {"
Cp
qk
ZT
xr
qx
pX
pX
Rh
uK
qx
Kc
Ex
ph
Bv
pX
rQ
Lx
oU
oU
oU
oU
Rp
zP
oU
cu
"}
(8,1,1) = {"
QM
cw
Ek
Kl
qx
Qh
yP
vf
Kl
Cp
Im
Bv
Bv
ph
pX
rQ
Lx
oU
Lx
Lx
Lx
jK
Ug
Lx
Kq
"}
(9,1,1) = {"
PY
dt
uV
VS
AY
rw
mZ
Rh
Kl
pX
Kc
Bv
Bv
Bv
Dd
rQ
Do
oU
Lx
Lx
hT
qg
jK
Ig
zq
"}
(10,1,1) = {"
Cp
RA
Bl
jH
CC
pX
Tf
YV
jH
CC
Im
pX
pX
pX
om
zq
Ab
aj
Lx
KI
Lx
jK
jK
Do
zq
"}
(11,1,1) = {"
YQ
qd
Ak
jH
Ae
ug
dz
fZ
jH
jH
wE
jH
TZ
nU
nU
TZ
Lx
oU
Lx
Lx
Lx
Lx
Lx
Lx
zq
"}
(12,1,1) = {"
tF
tF
tF
jH
Ae
pX
Cu
pX
jH
pX
Im
xe
TZ
OF
OF
TZ
Wc
Iu
Wc
Wc
Wc
Wc
Wc
Wc
zq
"}
(13,1,1) = {"
fx
SY
fx
jH
pX
Dd
Eg
qu
Wg
qu
lc
xe
Sw
JO
JO
TZ
dr
Lc
dr
dr
dr
jV
dr
qe
zq
"}
(14,1,1) = {"
UC
UC
UC
jH
Vy
pX
pX
om
jW
CC
Im
dv
TZ
OF
OF
TZ
yq
oy
ab
ab
gr
ab
ab
yq
jH
"}
(15,1,1) = {"
FE
xg
FE
jH
xC
FN
YQ
xP
jH
pX
Im
xe
TZ
JO
JO
TZ
kT
Gl
kT
kT
kT
kT
kT
kT
kO
"}
(16,1,1) = {"
jH
jH
jH
jH
jH
jH
jW
jH
jH
pX
Im
pX
TZ
nU
nU
TZ
kT
MA
oZ
kT
kT
kT
kT
kO
kO
"}
(17,1,1) = {"
mx
jO
jO
jO
Nw
zq
CC
Oj
Oj
pX
Im
om
jH
pN
kT
kT
kT
ak
kT
kT
kT
kT
kO
kO
kT
"}
(18,1,1) = {"
mx
jO
jO
jO
EN
pX
pX
pX
pX
pX
Im
Cp
Cp
kT
kT
kT
kT
Gl
kT
kT
kT
kO
kO
kT
kT
"}
(19,1,1) = {"
JQ
jO
jO
jO
oi
pX
pX
pX
pX
ug
bS
pX
pX
kT
kT
kT
zX
Gl
kT
kT
kO
kO
kT
zX
kT
"}
(20,1,1) = {"
jO
jO
jO
jO
aJ
pX
pX
pX
Cp
Ze
qx
Uo
pX
kT
kT
kT
kT
Gl
kT
kO
kO
kT
zX
kT
zX
"}
(21,1,1) = {"
jO
jO
jO
jO
Nw
zq
CC
Ae
Ae
pX
qx
om
zq
pN
kT
kT
kT
Gl
kO
kO
kT
kT
kT
kT
kT
"}
(22,1,1) = {"
jO
jO
gs
jO
jO
zq
zq
hZ
zq
tF
xp
Eo
zq
kT
kT
kT
kT
Gl
kO
kT
kT
kT
kT
kT
kT
"}
(23,1,1) = {"
jO
jO
jO
jO
jO
jO
jO
jO
zq
Bf
Ub
Bf
zq
mx
kT
pY
mx
MJ
kO
kT
kT
kT
kT
kT
kT
"}
(24,1,1) = {"
JQ
jO
jO
jO
JQ
jO
jO
JQ
zq
zq
EW
zq
zq
mx
mx
mx
mx
mx
MJ
kT
kT
kT
kT
kT
kT
"}
