//MAP CONVERTED BY dmm2tgm.py THIS HEADER COMMENT PREVENTS RECONVERSION, DO NOT REMOVE
"a" = (
/turf/open/floor/plating/ground/mars/random/cave,
/area/bigredv2/caves/south/garbledradio)
"h" = (
/obj/effect/landmark/excavation_site_spawner,
/turf/open/floor/plating/ground/mars/random/cave,
/area/bigredv2/caves/south/garbledradio)
"u" = (
/turf/open/floor/plating/ground/mars/random/cave,
/area/bigredv2/caves/south)
"w" = (
/turf/open/floor/plating/ground/mars/random/cave/rock,
/area/bigredv2/caves/south/garbledradio)
"y" = (
/obj/effect/ai_node,
/turf/open/floor/plating/ground/mars/random/cave,
/area/bigredv2/caves/south/garbledradio)
"D" = (
/obj/effect/landmark/lv624/fog_blocker,
/turf/open/floor/plating/ground/mars/random/cave,
/area/bigredv2/caves/southwest)
"H" = (
/obj/effect/landmark/lv624/fog_blocker,
/turf/closed/mineral/smooth/bigred,
/area/bigredv2/caves/rock)
"I" = (
/obj/effect/ai_node,
/turf/open/floor/plating/ground/mars/random/cave/rock,
/area/bigredv2/caves/south/garbledradio)
"M" = (
/obj/effect/ai_node,
/turf/open/floor/plating/ground/mars/random/cave,
/area/bigredv2/caves/southwest)
"P" = (
/turf/open/floor/plating/ground/mars/random/cave/rock,
/area/bigredv2/caves/southwest)
"R" = (
/obj/effect/ai_node,
/turf/open/floor/plating/ground/mars/random/cave/rock,
/area/bigredv2/caves/southwest)
"S" = (
/turf/closed/mineral/smooth/bigred,
/area/bigredv2/caves/rock)
"T" = (
/obj/effect/ai_node,
/turf/open/floor/plating/ground/mars/random/cave,
/area/bigredv2/caves/south)
"U" = (
/obj/effect/landmark/lv624/fog_blocker,
/turf/open/floor/plating/ground/mars/random/cave/rock,
/area/bigredv2/caves/southwest)
"V" = (
/turf/open/floor/plating/ground/mars/random/cave,
/area/bigredv2/caves/southwest)

(1,1,1) = {"
H
S
S
S
S
S
P
V
V
V
P
S
S
S
S
V
V
S
S
S
S
S
"}
(2,1,1) = {"
D
S
S
S
S
S
S
V
M
V
P
S
S
S
S
V
V
V
S
S
S
S
"}
(3,1,1) = {"
D
S
S
S
S
S
S
V
V
V
P
S
S
S
P
V
V
S
S
S
S
S
"}
(4,1,1) = {"
D
S
S
S
S
S
V
V
V
V
P
S
S
S
P
V
V
S
S
S
S
S
"}
(5,1,1) = {"
D
P
S
S
S
S
V
V
V
V
V
S
S
P
V
V
V
S
S
S
S
S
"}
(6,1,1) = {"
D
P
S
S
P
P
V
V
V
V
V
S
S
V
V
M
S
S
S
S
S
S
"}
(7,1,1) = {"
D
V
P
R
V
V
V
V
M
V
S
S
S
V
M
S
S
S
S
S
S
S
"}
(8,1,1) = {"
D
V
V
P
V
V
V
V
V
S
S
S
V
V
V
S
S
S
S
S
S
S
"}
(9,1,1) = {"
D
P
V
V
V
V
V
S
S
S
S
S
V
V
V
S
S
S
S
S
S
S
"}
(10,1,1) = {"
U
V
V
M
S
S
S
S
S
S
S
S
V
V
V
S
S
V
S
S
S
S
"}
(11,1,1) = {"
H
S
S
S
S
S
S
S
S
S
S
S
V
V
V
V
V
V
S
S
S
S
"}
(12,1,1) = {"
S
H
S
S
S
S
S
S
S
S
S
S
V
V
V
V
V
V
S
S
S
S
"}
(13,1,1) = {"
S
S
H
H
S
S
S
S
S
S
S
S
V
V
V
V
V
S
S
S
S
S
"}
(14,1,1) = {"
S
S
S
S
H
S
S
S
S
S
S
S
V
V
V
V
S
S
S
S
S
S
"}
(15,1,1) = {"
S
S
S
S
S
H
S
S
S
S
S
S
S
V
V
P
S
S
S
S
S
S
"}
(16,1,1) = {"
S
S
S
S
S
S
H
S
S
S
S
S
S
V
M
P
P
S
S
S
S
S
"}
(17,1,1) = {"
V
S
S
S
S
S
H
S
S
S
S
S
S
V
P
P
S
S
S
S
S
S
"}
(18,1,1) = {"
V
M
S
S
S
S
H
S
S
S
S
S
S
V
V
V
S
S
S
S
S
S
"}
(19,1,1) = {"
V
V
S
S
S
S
H
S
S
S
S
S
V
V
V
V
V
S
S
S
S
S
"}
(20,1,1) = {"
P
V
S
S
S
S
H
S
S
S
V
V
V
V
V
P
V
S
S
S
S
S
"}
(21,1,1) = {"
P
V
V
S
S
S
H
S
S
S
V
V
V
V
V
P
V
S
S
S
S
S
"}
(22,1,1) = {"
V
V
V
V
V
S
H
S
S
S
V
V
V
V
V
S
S
S
S
S
S
S
"}
(23,1,1) = {"
V
V
V
V
V
S
H
S
S
S
V
V
V
V
V
S
S
S
S
S
S
S
"}
(24,1,1) = {"
V
V
V
V
V
S
H
S
S
S
V
V
V
V
V
S
S
S
S
S
S
S
"}
(25,1,1) = {"
V
V
V
V
V
S
H
S
S
V
V
P
V
V
M
V
S
S
S
S
S
S
"}
(26,1,1) = {"
a
a
a
a
a
S
H
S
S
a
a
a
a
w
a
h
S
S
S
S
S
S
"}
(27,1,1) = {"
a
y
a
a
a
S
H
S
S
S
S
S
a
a
a
a
a
S
S
S
S
S
"}
(28,1,1) = {"
w
a
a
a
a
S
H
S
S
S
S
S
S
a
a
a
a
a
a
S
S
S
"}
(29,1,1) = {"
w
a
a
a
a
S
H
S
S
S
S
S
S
a
y
w
a
y
a
a
S
S
"}
(30,1,1) = {"
a
a
a
a
a
S
H
S
S
S
S
S
S
S
a
a
a
a
a
a
a
S
"}
(31,1,1) = {"
a
a
a
a
a
S
H
S
S
S
S
S
S
S
S
a
a
a
a
a
a
S
"}
(32,1,1) = {"
a
a
a
a
a
S
H
S
S
S
S
S
S
S
S
a
a
a
a
a
u
u
"}
(33,1,1) = {"
a
a
a
a
a
S
H
S
S
S
S
S
S
S
S
S
a
a
a
a
u
u
"}
(34,1,1) = {"
w
a
a
a
S
S
H
S
S
S
S
S
S
S
S
S
S
y
a
a
y
u
"}
(35,1,1) = {"
w
a
a
a
S
S
H
S
S
S
S
S
S
S
S
S
S
a
a
a
w
u
"}
(36,1,1) = {"
w
a
a
a
S
S
H
S
S
S
S
S
S
S
S
S
S
S
a
a
a
u
"}
(37,1,1) = {"
a
a
a
a
S
S
H
S
S
S
S
S
S
S
S
S
S
S
a
a
u
u
"}
(38,1,1) = {"
a
y
a
a
S
S
H
S
S
S
S
S
S
S
S
S
S
a
a
a
u
u
"}
(39,1,1) = {"
a
a
a
S
S
S
H
S
S
S
S
S
S
S
S
a
a
a
a
a
u
u
"}
(40,1,1) = {"
a
a
a
S
S
S
H
S
S
S
S
S
S
S
a
a
a
a
a
a
T
u
"}
(41,1,1) = {"
a
a
a
S
S
S
H
S
S
S
S
S
S
a
a
a
a
a
I
a
u
T
"}
(42,1,1) = {"
a
a
S
S
S
S
H
S
S
S
S
S
a
a
a
a
a
a
a
h
u
u
"}
(43,1,1) = {"
a
S
S
S
S
S
H
S
S
S
S
a
y
a
w
y
a
a
y
w
S
S
"}
(44,1,1) = {"
S
S
S
S
S
S
H
S
S
S
S
S
a
w
a
a
a
w
S
S
S
S
"}
