//MAP CONVERTED BY dmm2tgm.py THIS HEADER COMMENT PREVENTS RECONVERSION, DO NOT REMOVE
"ax" = (
/obj/structure/window/framed/colony,
/obj/machinery/door/poddoor/shutters/mainship{
	dir = 2;
	id = "Cargonia";
	name = "\improper Cargo Shutters"
	},
/turf/open/floor/plating,
/area/bigredv3/inside/wall)
"aS" = (
/obj/effect/decal/cleanable/dirt,
/turf/open/floor,
/area/bigredv3/inside/cargo/cargobay)
"by" = (
/obj/item/reagent_containers/spray/cleaner,
/obj/machinery/atmospherics/pipe/simple/green/hidden,
/turf/open/floor,
/area/bigredv3/inside/cargo/cargobay)
"bL" = (
/obj/effect/spawner/random/misc/structure/supplycrate,
/turf/open/floor/marking/bot,
/area/bigredv3/inside/cargo/cargobay)
"du" = (
/obj/effect/ai_node,
/turf/open/floor,
/area/bigredv3/inside/cargo/cargobay)
"dB" = (
/obj/item/flashlight,
/obj/item/reagent_containers/spray/cleaner,
/turf/open/floor,
/area/bigredv3/inside/cargo/cargobay)
"dU" = (
/obj/effect/decal/cleanable/dirt,
/obj/structure/closet/crate/trashcart,
/turf/open/floor/marking/bot,
/area/bigredv3/inside/cargo/cargobay)
"fg" = (
/obj/machinery/atmospherics/pipe/simple/green/hidden{
	dir = 4
	},
/obj/effect/ai_node,
/obj/structure/cable,
/turf/open/floor,
/area/bigredv3/inside/cargo/cargobay)
"fG" = (
/obj/effect/spawner/random/misc/structure/supplycrate/normalweighted,
/obj/effect/decal/cleanable/dirt,
/turf/open/floor/marking/bot,
/area/bigredv3/inside/cargo/cargobay)
"gi" = (
/obj/machinery/atmospherics/pipe/simple/green/hidden{
	dir = 4
	},
/turf/open/floor,
/area/bigredv3/inside/cargo/cargobay)
"gY" = (
/obj/structure/table,
/obj/effect/spawner/random/engineering/bomb_supply,
/obj/effect/spawner/random/engineering/tool,
/obj/effect/spawner/random/engineering/tool,
/obj/machinery/light{
	dir = 4
	},
/turf/open/floor,
/area/bigredv3/inside/cargo/cargobay)
"hv" = (
/obj/machinery/door/airlock/multi_tile/mainship/generic{
	name = "\improper Engineering Complex"
	},
/turf/open/floor,
/area/bigredv3/inside/cargo/cargobay)
"hF" = (
/obj/structure/table,
/obj/effect/spawner/random/engineering/toolbox,
/obj/effect/spawner/random/engineering/tool,
/turf/open/floor,
/area/bigredv3/inside/cargo/cargobay)
"hG" = (
/obj/effect/spawner/random/misc/structure/supplycrate,
/obj/effect/decal/cleanable/dirt,
/turf/open/floor/marking/bot,
/area/bigredv3/inside/cargo/cargobay)
"ib" = (
/obj/item/reagent_containers/glass/bottle/tramadol,
/turf/open/floor,
/area/bigredv3/inside/cargo/cargobay)
"iP" = (
/obj/effect/decal/cleanable/dirt,
/obj/machinery/atmospherics/pipe/simple/green/hidden,
/obj/structure/cable,
/turf/open/floor,
/area/bigredv3/inside/cargo/cargobay)
"jt" = (
/obj/structure/closet/emcloset,
/turf/open/floor/marking/bot,
/area/bigredv3/inside/cargo/cargobay)
"jM" = (
/obj/machinery/atmospherics/pipe/simple/green/hidden,
/obj/machinery/door/airlock/mainship/engineering/free_access{
	dir = 1;
	name = "\improper Cargo Bay Quartermaster"
	},
/turf/open/floor,
/area/bigredv3/inside/cargo/cargobay)
"jS" = (
/obj/structure/table,
/obj/item/radio/survivor,
/turf/open/floor,
/area/bigredv3/inside/cargo/cargobay)
"lq" = (
/turf/closed/wall,
/area/bigredv3/inside/wall)
"lZ" = (
/obj/machinery/atmospherics/pipe/manifold/green/hidden{
	dir = 1
	},
/obj/structure/cable,
/turf/open/floor,
/area/bigredv3/inside/cargo/cargobay)
"mK" = (
/obj/machinery/atmospherics/pipe/simple/green/hidden{
	dir = 10
	},
/obj/effect/decal/cleanable/dirt,
/turf/open/floor,
/area/bigredv3/inside/cargo/cargobay)
"mV" = (
/turf/open/floor/marking/loadingarea,
/area/bigredv3/inside/cargo/cargobay)
"nz" = (
/obj/machinery/computer/ordercomp,
/turf/open/floor,
/area/bigredv3/inside/cargo/cargobay)
"nA" = (
/obj/machinery/light{
	dir = 4
	},
/turf/open/floor,
/area/bigredv3/inside/cargo/cargobay)
"nU" = (
/obj/machinery/prop/autolathe,
/turf/open/floor,
/area/bigredv3/inside/cargo/cargobay)
"oB" = (
/obj/structure/table,
/obj/effect/spawner/random/engineering/bomb_supply,
/obj/effect/spawner/random/engineering/bomb_supply,
/turf/open/floor,
/area/bigredv3/inside/cargo/cargobay)
"oN" = (
/obj/machinery/light{
	dir = 1
	},
/turf/open/floor,
/area/bigredv3/inside/cargo/cargobay)
"oU" = (
/obj/effect/spawner/random/misc/structure/supplycrate/normalweighted,
/turf/open/floor,
/area/bigredv3/inside/cargo/cargobay)
"pb" = (
/obj/machinery/atmospherics/pipe/manifold/green/hidden,
/obj/structure/cable,
/turf/open/floor,
/area/bigredv3/inside/cargo/cargobay)
"pp" = (
/obj/machinery/atmospherics/pipe/simple/green/hidden,
/turf/open/floor,
/area/bigredv3/inside/cargo/cargobay)
"qi" = (
/obj/effect/spawner/random/misc/structure/supplycrate/normalweighted,
/turf/open/floor/marking/bot,
/area/bigredv3/inside/cargo/cargobay)
"qC" = (
/obj/effect/decal/cleanable/dirt,
/obj/effect/decal/cleanable/dirt,
/obj/effect/ai_node,
/turf/open/floor,
/area/bigredv3/inside/cargo/cargobay)
"qJ" = (
/obj/effect/decal/cleanable/dirt,
/obj/effect/decal/cleanable/dirt,
/turf/open/floor,
/area/bigredv3/inside/cargo/cargobay)
"rD" = (
/obj/effect/ai_node,
/turf/open/floor/marking/delivery,
/area/bigredv3/inside/cargo/cargobay)
"rX" = (
/obj/effect/decal/cleanable/dirt,
/obj/machinery/atmospherics/pipe/simple/green/hidden{
	dir = 5
	},
/obj/structure/cable,
/turf/open/floor,
/area/bigredv3/inside/cargo/cargobay)
"rY" = (
/obj/machinery/light,
/turf/open/floor,
/area/bigredv3/inside/cargo/cargobay)
"sr" = (
/obj/machinery/atmospherics/pipe/manifold/green/hidden{
	dir = 1
	},
/obj/effect/ai_node,
/obj/structure/cable,
/turf/open/floor,
/area/bigredv3/inside/cargo/cargobay)
"sF" = (
/turf/open/floor/plating,
/area/bigredv3/inside/cargo/cargobay)
"tE" = (
/obj/effect/decal/cleanable/dirt,
/obj/machinery/atmospherics/pipe/simple/green/hidden{
	dir = 4
	},
/obj/effect/ai_node,
/obj/structure/cable,
/turf/open/floor,
/area/bigredv3/inside/cargo/cargobay)
"ui" = (
/obj/structure/bed/chair/office/dark,
/turf/open/floor,
/area/bigredv3/inside/cargo/cargobay)
"uu" = (
/obj/effect/decal/cleanable/dirt,
/obj/item/tool/lighter/random,
/turf/open/floor,
/area/bigredv3/inside/cargo/cargobay)
"uD" = (
/obj/machinery/atmospherics/pipe/simple/green/hidden,
/obj/structure/cable,
/turf/open/floor,
/area/bigredv3/inside/cargo/cargobay)
"xw" = (
/turf/open/floor/marking/bot,
/area/bigredv3/inside/cargo/cargobay)
"xV" = (
/obj/effect/spawner/random/engineering/structure/tank/waterweighted,
/turf/open/floor,
/area/bigredv3/inside/cargo/cargobay)
"zu" = (
/obj/structure/filingcabinet,
/turf/open/floor,
/area/bigredv3/inside/cargo/cargobay)
"zP" = (
/obj/structure/table,
/obj/effect/spawner/random/engineering/tech_supply,
/obj/effect/spawner/random/engineering/tool,
/obj/effect/spawner/random/engineering/tool,
/turf/open/floor,
/area/bigredv3/inside/cargo/cargobay)
"As" = (
/obj/machinery/power/apc/weak/ntf,
/obj/structure/cable,
/turf/open/floor,
/area/bigredv3/inside/cargo/cargobay)
"AT" = (
/obj/structure/largecrate/cow,
/turf/open/floor/marking/bot,
/area/bigredv3/inside/cargo/cargobay)
"Cj" = (
/obj/effect/decal/cleanable/blood,
/turf/open/floor,
/area/bigredv3/inside/cargo/cargobay)
"Cu" = (
/obj/machinery/atmospherics/pipe/simple/green/hidden{
	dir = 4
	},
/obj/structure/cable,
/turf/open/floor,
/area/bigredv3/inside/cargo/cargobay)
"Cy" = (
/obj/effect/decal/cleanable/dirt,
/obj/machinery/atmospherics/pipe/simple/green/hidden{
	dir = 4
	},
/obj/structure/cable,
/turf/open/floor,
/area/bigredv3/inside/cargo/cargobay)
"CG" = (
/obj/effect/decal/cleanable/dirt,
/obj/machinery/atmospherics/pipe/simple/green/hidden,
/obj/effect/ai_node,
/turf/open/floor,
/area/bigredv3/inside/cargo/cargobay)
"CN" = (
/obj/structure/table,
/obj/effect/spawner/random/engineering/tool,
/obj/effect/spawner/random/engineering/tool,
/obj/effect/spawner/random/engineering/bomb_supply,
/obj/effect/spawner/random/engineering/bomb_supply,
/turf/open/floor,
/area/bigredv3/inside/cargo/cargobay)
"Dx" = (
/obj/effect/decal/cleanable/dirt,
/obj/machinery/atmospherics/pipe/manifold/green/hidden{
	dir = 8
	},
/turf/open/floor,
/area/bigredv3/inside/cargo/cargobay)
"Eb" = (
/obj/effect/decal/cleanable/dirt,
/obj/machinery/atmospherics/components/unary/vent_pump{
	dir = 4;
	on = 1
	},
/turf/open/floor,
/area/bigredv3/inside/cargo/cargobay)
"Fw" = (
/obj/structure/table,
/obj/effect/spawner/random/engineering/tool,
/turf/open/floor,
/area/bigredv3/inside/cargo/cargobay)
"Hd" = (
/turf/open/floor/marking/delivery,
/area/bigredv3/inside/cargo/cargobay)
"He" = (
/obj/machinery/atmospherics/components/unary/vent_pump{
	on = 1
	},
/turf/open/floor,
/area/bigredv3/inside/cargo/cargobay)
"Id" = (
/obj/structure/table,
/obj/effect/spawner/random/engineering/bomb_supply,
/obj/effect/spawner/random/engineering/bomb_supply,
/obj/effect/spawner/random/engineering/tool,
/turf/open/floor,
/area/bigredv3/inside/cargo/cargobay)
"IP" = (
/obj/structure/closet/emcloset,
/turf/open/floor,
/area/bigredv3/inside/cargo/cargobay)
"Jm" = (
/obj/structure/closet/emcloset/legacy,
/turf/open/floor/marking/bot,
/area/bigredv3/inside/cargo/cargobay)
"JJ" = (
/obj/machinery/door_control{
	dir = 8;
	id = "Cargonia";
	name = "Storm Shutters"
	},
/turf/open/floor,
/area/bigredv3/inside/cargo/cargobay)
"JT" = (
/obj/machinery/atmospherics/pipe/simple/green/hidden,
/obj/effect/decal/cleanable/dirt,
/turf/open/floor,
/area/bigredv3/inside/cargo/cargobay)
"Kl" = (
/obj/machinery/light{
	dir = 4
	},
/obj/machinery/atmospherics/pipe/simple/green/hidden,
/obj/structure/cable,
/turf/open/floor,
/area/bigredv3/inside/cargo/cargobay)
"Lx" = (
/turf/closed/wall,
/area/bigredv3/inside/cargo/cargobay)
"LO" = (
/obj/effect/decal/cleanable/dirt,
/obj/effect/ai_node,
/turf/open/floor,
/area/bigredv3/inside/cargo/cargobay)
"LP" = (
/obj/machinery/atmospherics/pipe/simple/green/hidden{
	dir = 4
	},
/obj/machinery/door/airlock/mainship/security/glass/free_access{
	name = "\improper Cargo Bay Security"
	},
/turf/open/floor,
/area/bigredv3/inside/cargo/cargobay)
"LU" = (
/turf/closed/wall/r_wall,
/area/bigredv3/inside/wall)
"Mo" = (
/turf/open/floor,
/area/bigredv3/inside/cargo/cargobay)
"MF" = (
/obj/effect/spawner/random/misc/structure/supplycrate/normalweighted,
/obj/effect/decal/cleanable/dirt,
/turf/open/floor,
/area/bigredv3/inside/cargo/cargobay)
"Nh" = (
/obj/machinery/atmospherics/components/unary/vent_pump{
	dir = 1;
	on = 1
	},
/obj/effect/ai_node,
/turf/open/floor,
/area/bigredv3/inside/cargo/cargobay)
"Ny" = (
/obj/machinery/door/poddoor/shutters/mainship{
	id = "Cargonia";
	name = "\improper Cargo Shutters"
	},
/obj/structure/window/framed/colony/reinforced,
/turf/open/floor/plating,
/area/bigredv3/inside/wall)
"NJ" = (
/obj/machinery/atmospherics/pipe/simple/green/hidden,
/obj/machinery/door/airlock/multi_tile/mainship/generic{
	name = "\improper Cargo Offices"
	},
/turf/open/floor,
/area/bigredv3/inside/cargo/cargobay)
"NU" = (
/obj/machinery/light{
	dir = 8
	},
/turf/open/floor,
/area/bigredv3/inside/cargo/cargobay)
"OK" = (
/obj/structure/filingcabinet,
/obj/machinery/light{
	dir = 1
	},
/turf/open/floor,
/area/bigredv3/inside/cargo/cargobay)
"OW" = (
/obj/machinery/door/airlock/multi_tile/mainship/generic{
	dir = 1;
	name = "\improper Cargo Bay"
	},
/turf/open/floor,
/area/bigredv3/inside/cargo/cargobay)
"PW" = (
/obj/effect/spawner/random/engineering/structure/tank/fuelweighted,
/turf/open/floor,
/area/bigredv3/inside/cargo/cargobay)
"Qw" = (
/obj/effect/spawner/random/engineering/tool,
/turf/open/floor,
/area/bigredv3/inside/cargo/cargobay)
"Rz" = (
/obj/machinery/atmospherics/pipe/simple/green/hidden{
	dir = 4
	},
/obj/effect/decal/cleanable/dirt,
/obj/effect/ai_node,
/turf/open/floor,
/area/bigredv3/inside/cargo/cargobay)
"RZ" = (
/obj/effect/decal/cleanable/dirt,
/turf/open/floor/marking/bot,
/area/bigredv3/inside/cargo/cargobay)
"Tk" = (
/obj/structure/cable,
/turf/open/floor,
/area/bigredv3/inside/cargo/cargobay)
"Uj" = (
/obj/machinery/atmospherics/pipe/simple/green/hidden,
/obj/effect/ai_node,
/obj/structure/cable,
/turf/open/floor,
/area/bigredv3/inside/cargo/cargobay)
"Ux" = (
/obj/structure/window/framed/colony,
/turf/open/floor/plating,
/area/bigredv3/inside/wall)
"Vw" = (
/obj/structure/table,
/obj/effect/spawner/random/engineering/toolbox,
/turf/open/floor,
/area/bigredv3/inside/cargo/cargobay)
"VX" = (
/obj/structure/table,
/turf/open/floor,
/area/bigredv3/inside/cargo/cargobay)
"Xp" = (
/obj/machinery/atmospherics/components/unary/vent_pump{
	dir = 8;
	on = 1
	},
/turf/open/floor,
/area/bigredv3/inside/cargo/cargobay)
"XB" = (
/obj/effect/decal/cleanable/dirt,
/obj/item/megaphone,
/turf/open/floor,
/area/bigredv3/inside/cargo/cargobay)
"XX" = (
/obj/machinery/door/airlock/mainship/engineering/free_access{
	name = "\improper Cargo Bay Quartermaster"
	},
/turf/open/floor,
/area/bigredv3/inside/cargo/cargobay)
"ZK" = (
/obj/structure/closet/firecloset/full,
/turf/open/floor,
/area/bigredv3/inside/cargo/cargobay)

(1,1,1) = {"
sF
sF
sF
LU
Ny
Ny
Ny
LU
lq
lq
Cu
OW
lq
lq
lq
lq
XX
lq
lq
"}
(2,1,1) = {"
rD
Hd
Hd
NU
Mo
Mo
Mo
PW
Mo
Mo
Cu
Mo
Mo
NU
lq
oN
Mo
zP
lq
"}
(3,1,1) = {"
Qw
Mo
Mo
mV
bL
hG
qi
xw
xw
Mo
fg
Mo
Mo
Mo
lq
Mo
ui
VX
ax
"}
(4,1,1) = {"
uD
uD
rX
Mo
Mo
aS
Mo
Mo
Mo
Mo
lZ
CG
by
pp
jM
pp
Nh
jS
ax
"}
(5,1,1) = {"
oU
Mo
Cu
mV
Jm
fG
jt
bL
xw
Mo
Cu
Mo
aS
aS
Ux
zu
aS
nz
ax
"}
(6,1,1) = {"
aS
Cj
lZ
uD
uD
uD
uD
iP
uD
Kl
pb
Mo
aS
aS
Ux
zu
Mo
Mo
ax
"}
(7,1,1) = {"
MF
Mo
gi
mV
qi
dU
xw
RZ
xw
Lx
Cu
Mo
Mo
Mo
lq
OK
Mo
Mo
lq
"}
(8,1,1) = {"
Mo
Mo
gi
Mo
aS
aS
du
aS
Mo
NU
Cu
LO
Mo
Mo
lq
Ux
XX
Ux
LU
"}
(9,1,1) = {"
Mo
Mo
gi
mV
RZ
qi
qi
RZ
xw
Mo
Cu
XB
Mo
Mo
PW
Mo
Mo
rY
LU
"}
(10,1,1) = {"
Mo
Mo
gi
Mo
Mo
Mo
Mo
Mo
Mo
He
pb
Mo
Mo
Mo
Mo
aS
Mo
Mo
hv
"}
(11,1,1) = {"
Mo
Mo
Xp
mV
qi
AT
AT
AT
xw
Mo
sr
uD
uD
uD
uD
uD
Uj
uD
uD
"}
(12,1,1) = {"
ZK
IP
IP
Mo
Mo
Mo
Mo
Mo
Mo
Mo
Cy
qC
ib
Mo
Mo
Mo
Mo
hF
LU
"}
(13,1,1) = {"
lq
lq
lq
lq
Ux
Ux
Ux
lq
oN
Mo
Cy
qJ
aS
Mo
Mo
aS
Mo
hF
LU
"}
(14,1,1) = {"
Fw
Vw
nU
lq
Mo
Mo
Mo
lq
As
Tk
Cy
qJ
Mo
aS
aS
aS
Mo
Vw
LU
"}
(15,1,1) = {"
LO
Eb
rY
lq
aS
aS
PW
lq
Mo
aS
Cy
aS
Mo
Mo
aS
Mo
Mo
Fw
LU
"}
(16,1,1) = {"
aS
mK
pp
NJ
JT
Dx
pp
NJ
pp
JT
pb
aS
Mo
Mo
Mo
Mo
Mo
CN
LU
"}
(17,1,1) = {"
du
uu
aS
Mo
aS
Rz
Mo
Mo
Mo
aS
tE
Mo
Mo
du
Mo
Mo
Mo
Id
LU
"}
(18,1,1) = {"
Mo
Mo
Mo
lq
oN
gi
Mo
lq
Mo
dB
Cu
Mo
Mo
Mo
Mo
Mo
Mo
oB
LU
"}
(19,1,1) = {"
Ux
Ux
lq
lq
Ux
LP
Ux
lq
Mo
Mo
Cu
gY
JJ
Mo
xV
Mo
Mo
nA
LU
"}
