//MAP CONVERTED BY dmm2tgm.py THIS HEADER COMMENT PREVENTS RECONVERSION, DO NOT REMOVE
"ab" = (
/turf/open/floor/marking/asteroidwarning{
	dir = 4
	},
/area/bigredv2/outside/s)
"ah" = (
/obj/structure/window/framed/colony/reinforced,
/turf/open/floor/plating,
/area/bigredv2/outside/filtration_plant)
"aj" = (
/obj/effect/landmark/lv624/fog_blocker,
/obj/effect/ai_node,
/turf/open/floor,
/area/bigredv2/outside/s)
"am" = (
/obj/effect/spawner/random/engineering/structure/tank/waterweighted,
/turf/open/floor,
/area/bigredv2/outside/filtration_plant)
"an" = (
/obj/effect/decal/cleanable/dirt,
/obj/structure/table,
/turf/open/floor,
/area/bigredv2/outside/filtration_plant)
"aJ" = (
/turf/open/floor/marking/asteroidwarning{
	dir = 5
	},
/area/bigredv2/outside/se)
"bS" = (
/obj/machinery/atmospherics/pipe/simple/green/hidden{
	dir = 9
	},
/obj/effect/decal/cleanable/dirt,
/obj/effect/ai_node,
/obj/structure/cable,
/turf/open/floor,
/area/bigredv2/outside/filtration_plant)
"cu" = (
/obj/effect/landmark/lv624/fog_blocker,
/turf/closed/wall/r_wall/unmeltable,
/area/bigredv2/outside/s)
"cw" = (
/obj/machinery/atmospherics/components/unary/vent_pump,
/obj/effect/decal/cleanable/dirt,
/obj/effect/decal/cleanable/dirt,
/obj/structure/cable,
/turf/open/floor,
/area/bigredv2/outside/filtration_plant)
"dr" = (
/turf/open/floor/asteroidfloor,
/area/bigredv2/outside/s)
"dt" = (
/obj/effect/decal/cleanable/dirt,
/obj/machinery/atmospherics/pipe/simple/green/hidden,
/obj/effect/ai_node,
/turf/open/floor,
/area/bigredv2/outside/filtration_plant)
"dv" = (
/obj/structure/table,
/obj/effect/spawner/random/engineering/technology_scanner,
/obj/machinery/light,
/turf/open/floor,
/area/bigredv2/outside/filtration_plant)
"dz" = (
/obj/machinery/atmospherics/pipe/manifold/green/hidden,
/turf/open/floor,
/area/bigredv2/outside/filtration_plant)
"fx" = (
/obj/machinery/portable_atmospherics/scrubber/huge,
/turf/open/floor/plating,
/area/bigredv2/outside/filtration_plant)
"fZ" = (
/obj/effect/decal/cleanable/dirt,
/obj/structure/rack,
/obj/effect/spawner/random/engineering/tool,
/turf/open/floor,
/area/bigredv2/outside/filtration_plant)
"gr" = (
/obj/effect/decal/cleanable/dirt,
/turf/open/floor/marking/asteroidwarning{
	dir = 4
	},
/area/bigredv2/outside/s)
"hT" = (
/obj/item/tank/air,
/turf/open/floor,
/area/bigredv2/outside/s)
"hZ" = (
/obj/structure/sign/safety/vent,
/turf/closed/wall/r_wall,
/area/bigredv2/outside/filtration_plant)
"jH" = (
/turf/closed/wall,
/area/bigredv2/outside/s)
"jK" = (
/obj/effect/turf_decal/warning_stripes/box/empty,
/obj/effect/turf_decal/warning_stripes/box/empty,
/turf/open/floor,
/area/bigredv2/outside/s)
"jO" = (
/turf/open/floor/plating/ground/mars/random/sand,
/area/bigredv2/outside/se)
"jW" = (
/obj/effect/decal/cleanable/dirt,
/turf/closed/wall,
/area/bigredv2/outside/filtration_plant)
"kO" = (
/obj/structure/fence/standard/xenoproof,
/turf/open/floor/plating/ground/mars/random/cave,
/area/bigredv2/outside/se)
"kT" = (
/turf/open/floor/plating/ground/mars/random/cave,
/area/bigredv2/outside/se)
"lc" = (
/obj/machinery/atmospherics/pipe/manifold/green/hidden,
/obj/effect/ai_node,
/obj/structure/cable,
/turf/open/floor,
/area/bigredv2/outside/filtration_plant)
"mx" = (
/turf/closed/mineral/smooth/bigred,
/area/bigredv2/caves/rock)
"mZ" = (
/obj/machinery/atmospherics/pipe/simple/green/hidden{
	dir = 5
	},
/obj/structure/cable,
/turf/open/floor,
/area/bigredv2/outside/filtration_plant)
"nU" = (
/obj/structure/window/framed/colony/reinforced/hull,
/obj/effect/forcefield/allow_bullet_travel,
/turf/open/floor/plating,
/area/bigredv2/caves/rock)
"oi" = (
/obj/effect/ai_node,
/turf/open/floor/marking/asteroidwarning{
	dir = 1
	},
/area/bigredv2/outside/se)
"om" = (
/obj/machinery/light,
/turf/open/floor,
/area/bigredv2/outside/filtration_plant)
"oy" = (
/obj/effect/landmark/lv624/fog_blocker,
/turf/open/floor/marking/asteroidwarning{
	dir = 4
	},
/area/bigredv2/outside/s)
"oU" = (
/obj/effect/landmark/lv624/fog_blocker,
/turf/open/floor,
/area/bigredv2/outside/s)
"oZ" = (
/obj/item/tank/air,
/turf/open/floor/plating/ground/mars/random/cave,
/area/bigredv2/outside/se)
"ph" = (
/obj/effect/spawner/random/misc/structure/supplycrate,
/obj/effect/turf_decal/warning_stripes/box/empty,
/obj/effect/turf_decal/warning_stripes/box/empty,
/turf/open/floor,
/area/bigredv2/outside/filtration_plant)
"pu" = (
/obj/machinery/atmospherics/pipe/simple/green/hidden{
	dir = 4
	},
/obj/machinery/door/airlock/mainship/engineering{
	name = "\improper Atmospherics Condenser Storage";
	req_one_access = null
	},
/obj/structure/cable,
/turf/open/floor,
/area/bigredv2/outside/filtration_plant)
"pA" = (
/obj/effect/decal/cleanable/dirt,
/obj/machinery/atmospherics/pipe/simple/green/hidden{
	dir = 4
	},
/obj/structure/cable,
/turf/open/floor,
/area/bigredv2/outside/filtration_plant)
"pM" = (
/obj/structure/table,
/obj/machinery/door_control/old{
	id = "FiltrationShutters";
	name = "Airlock Shutters";
	pixel_y = 2
	},
/turf/open/floor,
/area/bigredv2/outside/filtration_plant)
"pN" = (
/obj/item/clothing/head/warning_cone,
/turf/open/floor/plating/ground/mars/random/cave,
/area/bigredv2/outside/se)
"pX" = (
/obj/structure/nuke_disk_candidate,
/turf/open/floor,
/area/bigredv2/outside/filtration_plant)
"qd" = (
/obj/machinery/computer/area_atmos/area,
/turf/open/floor,
/area/bigredv2/outside/filtration_plant)
"qe" = (
/obj/machinery/light,
/turf/open/floor/asteroidfloor,
/area/bigredv2/outside/s)
"qg" = (
/obj/effect/decal/cleanable/dirt,
/obj/effect/spawner/random/engineering/structure/tank/fuelweighted,
/obj/effect/turf_decal/warning_stripes/box/empty,
/obj/effect/turf_decal/warning_stripes/box/empty,
/turf/open/floor,
/area/bigredv2/outside/s)
"qk" = (
/obj/effect/decal/cleanable/dirt,
/obj/machinery/atmospherics/pipe/simple/green/hidden{
	dir = 10
	},
/obj/effect/ai_node,
/obj/structure/cable,
/turf/open/floor,
/area/bigredv2/outside/filtration_plant)
"qu" = (
/obj/machinery/atmospherics/pipe/simple/green/hidden,
/turf/open/floor,
/area/bigredv2/outside/filtration_plant)
"qx" = (
/obj/structure/cable,
/turf/open/floor,
/area/bigredv2/outside/filtration_plant)
"rw" = (
/obj/machinery/atmospherics/pipe/simple/green/hidden,
/obj/effect/ai_node,
/obj/structure/cable,
/turf/open/floor,
/area/bigredv2/outside/filtration_plant)
"rQ" = (
/obj/machinery/door/poddoor/shutters/mainship{
	dir = 1;
	id = "FiltrationShutters";
	name = "\improper Airlock Shutters"
	},
/turf/open/floor/marking/delivery,
/area/bigredv2/outside/filtration_plant)
"tF" = (
/obj/structure/window/framed/colony,
/turf/open/floor/plating,
/area/bigredv2/outside/filtration_plant)
"ug" = (
/obj/machinery/atmospherics/components/unary/vent_pump,
/turf/open/floor,
/area/bigredv2/outside/filtration_plant)
"uK" = (
/obj/machinery/door/airlock/mainship/engineering{
	dir = 1;
	name = "\improper Filtration Facility";
	req_one_access = null
	},
/turf/open/floor,
/area/bigredv2/outside/filtration_plant)
"uV" = (
/obj/effect/decal/cleanable/dirt,
/obj/machinery/atmospherics/pipe/manifold/green/hidden{
	dir = 4
	},
/obj/structure/cable,
/turf/open/floor,
/area/bigredv2/outside/filtration_plant)
"vf" = (
/obj/effect/decal/cleanable/dirt,
/obj/structure/cable,
/turf/open/floor,
/area/bigredv2/outside/filtration_plant)
"vv" = (
/obj/effect/spawner/random/engineering/structure/tank/waterweighted,
/obj/effect/turf_decal/warning_stripes/box/empty,
/obj/effect/turf_decal/warning_stripes/box/empty,
/turf/open/floor,
/area/bigredv2/outside/filtration_plant)
"wE" = (
/obj/machinery/door/airlock/mainship/engineering{
	name = "\improper Filtration Facility";
	req_one_access = null
	},
/obj/machinery/atmospherics/pipe/simple/green/hidden{
	dir = 4
	},
/obj/structure/cable,
/turf/open/floor,
/area/bigredv2/outside/filtration_plant)
"wG" = (
/obj/item/weapon/twohanded/fireaxe,
/turf/open/floor,
/area/bigredv2/outside/filtration_plant)
"wU" = (
/obj/machinery/atmospherics/components/unary/vent_pump{
	dir = 4
	},
/obj/effect/ai_node,
/turf/open/floor,
/area/bigredv2/outside/filtration_plant)
"xe" = (
/obj/structure/table,
/obj/effect/spawner/random/engineering/technology_scanner,
/turf/open/floor,
/area/bigredv2/outside/filtration_plant)
"xm" = (
/turf/closed/mineral/smooth/bigred,
/area/bigredv2/outside/filtration_plant)
"xp" = (
/obj/effect/decal/cleanable/dirt,
/obj/structure/window/framed/colony,
/obj/structure/cable,
/turf/open/floor/plating,
/area/bigredv2/outside/filtration_plant)
"xr" = (
/obj/machinery/door/airlock/mainship/engineering{
	dir = 1;
	name = "\improper Atmospherics Condenser";
	req_one_access = null
	},
/turf/open/floor,
/area/bigredv2/outside/filtration_plant)
"xC" = (
/obj/structure/table,
/obj/effect/spawner/random/engineering/tool,
/turf/open/floor,
/area/bigredv2/outside/filtration_plant)
"xP" = (
/obj/structure/table,
/obj/item/circuitboard/solar_tracker,
/turf/open/floor,
/area/bigredv2/outside/filtration_plant)
"yq" = (
/obj/effect/ai_node,
/turf/open/floor/marking/asteroidwarning{
	dir = 4
	},
/area/bigredv2/outside/s)
"yP" = (
/obj/machinery/computer3/server/rack,
/obj/effect/turf_decal/warning_stripes/box/threeside{
	dir = 1
	},
/turf/open/floor,
/area/bigredv2/outside/filtration_plant)
"ze" = (
/obj/structure/cable,
/obj/machinery/power/apc/high/ntf,
/turf/open/floor,
/area/bigredv2/outside/filtration_plant)
"zq" = (
/turf/closed/wall/r_wall,
/area/bigredv2/outside/s)
"zv" = (
/obj/machinery/door_control{
	id = "FiltrationShutters";
	name = "Airlock Shutters"
	},
/turf/open/floor,
/area/bigredv2/outside/s)
"zP" = (
/obj/structure/cargo_container/ch_red{
	dir = 1
	},
/obj/effect/landmark/lv624/fog_blocker,
/obj/effect/turf_decal/warning_stripes/box/empty,
/obj/effect/turf_decal/warning_stripes/box/empty,
/turf/open/floor,
/area/bigredv2/outside/s)
"zX" = (
/obj/effect/ai_node,
/turf/open/floor/plating/ground/mars/random/cave,
/area/bigredv2/outside/se)
"Ab" = (
/obj/machinery/light{
	dir = 1
	},
/obj/item/clothing/head/warning_cone,
/turf/open/floor,
/area/bigredv2/outside/s)
"Ae" = (
/obj/structure/closet/firecloset/full,
/turf/open/floor,
/area/bigredv2/outside/filtration_plant)
"Ak" = (
/obj/machinery/computer/atmos_alert{
	dir = 8
	},
/obj/structure/table,
/turf/open/floor,
/area/bigredv2/outside/filtration_plant)
"AY" = (
/obj/machinery/atmospherics/pipe/simple/green/hidden,
/obj/structure/cable,
/turf/open/floor,
/area/bigredv2/outside/filtration_plant)
"Bf" = (
/obj/machinery/portable_atmospherics/scrubber/huge,
/obj/effect/turf_decal/warning_stripes,
/turf/open/floor/plating,
/area/bigredv2/outside/filtration_plant)
"Bl" = (
/obj/structure/bed/chair{
	dir = 4
	},
/obj/effect/decal/cleanable/dirt,
/turf/open/floor,
/area/bigredv2/outside/filtration_plant)
"Bv" = (
/obj/effect/turf_decal/warning_stripes/box/empty,
/obj/effect/turf_decal/warning_stripes/box/empty,
/turf/open/floor,
/area/bigredv2/outside/filtration_plant)
"Cp" = (
/obj/effect/decal/cleanable/dirt,
/turf/open/floor,
/area/bigredv2/outside/filtration_plant)
"Cu" = (
/obj/machinery/atmospherics/pipe/simple/green/hidden{
	dir = 4
	},
/turf/open/floor,
/area/bigredv2/outside/filtration_plant)
"CC" = (
/obj/machinery/light{
	dir = 1
	},
/turf/open/floor,
/area/bigredv2/outside/filtration_plant)
"CZ" = (
/obj/structure/table,
/obj/machinery/computer/atmos_alert{
	dir = 4
	},
/turf/open/floor,
/area/bigredv2/outside/filtration_plant)
"Dd" = (
/obj/effect/ai_node,
/turf/open/floor,
/area/bigredv2/outside/filtration_plant)
"Do" = (
/obj/effect/ai_node,
/turf/open/floor,
/area/bigredv2/outside/s)
"Eg" = (
/obj/machinery/atmospherics/pipe/simple/green/hidden{
	dir = 10
	},
/turf/open/floor,
/area/bigredv2/outside/filtration_plant)
"Ek" = (
/obj/machinery/atmospherics/pipe/manifold/green/hidden,
/obj/effect/decal/cleanable/dirt,
/obj/structure/cable,
/turf/open/floor,
/area/bigredv2/outside/filtration_plant)
"Eo" = (
/obj/structure/window/framed/colony,
/obj/structure/sign/safety/vent,
/turf/open/floor/plating,
/area/bigredv2/outside/filtration_plant)
"Ex" = (
/obj/effect/spawner/random/engineering/structure/tank/fuelweighted,
/obj/effect/turf_decal/warning_stripes/box/empty,
/obj/effect/turf_decal/warning_stripes/box/empty,
/turf/open/floor,
/area/bigredv2/outside/filtration_plant)
"EN" = (
/turf/open/floor/marking/asteroidwarning{
	dir = 9
	},
/area/bigredv2/outside/se)
"EW" = (
/obj/structure/cable,
/turf/closed/wall/r_wall,
/area/bigredv2/outside/filtration_plant)
"FE" = (
/obj/machinery/power/geothermal,
/obj/structure/cable,
/turf/open/floor/plating,
/area/bigredv2/outside/filtration_plant)
"FN" = (
/obj/structure/table,
/obj/effect/spawner/random/engineering/toolbox,
/turf/open/floor,
/area/bigredv2/outside/filtration_plant)
"Gf" = (
/turf/closed/wall,
/area/bigredv2/outside/filtration_plant)
"Gl" = (
/obj/effect/landmark/lv624/fog_blocker,
/turf/open/floor/plating/ground/mars/random/cave,
/area/bigredv2/outside/se)
"HZ" = (
/obj/machinery/computer3/server/rack,
/obj/effect/turf_decal/warning_stripes/box/threeside,
/turf/open/floor,
/area/bigredv2/outside/filtration_plant)
"Ig" = (
/obj/machinery/light,
/turf/open/floor,
/area/bigredv2/outside/s)
"Im" = (
/obj/machinery/atmospherics/pipe/simple/green/hidden{
	dir = 4
	},
/obj/structure/cable,
/turf/open/floor,
/area/bigredv2/outside/filtration_plant)
"Iu" = (
/obj/effect/landmark/lv624/fog_blocker,
/turf/open/floor/marking/asteroidwarning{
	dir = 8
	},
/area/bigredv2/outside/s)
"JK" = (
/obj/effect/ai_node,
/turf/open/floor/asteroidfloor,
/area/bigredv2/outside/s)
"JO" = (
/obj/structure/cryofeed,
/obj/effect/forcefield/allow_bullet_travel,
/turf/open/floor/engine,
/area/bigredv2/caves/rock)
"JQ" = (
/obj/effect/ai_node,
/turf/open/floor/plating/ground/mars/random/sand,
/area/bigredv2/outside/se)
"Ka" = (
/obj/structure/cargo_container/ch_red,
/obj/effect/turf_decal/warning_stripes/box/empty,
/obj/effect/turf_decal/warning_stripes/box/empty,
/turf/open/floor,
/area/bigredv2/outside/s)
"Kc" = (
/obj/machinery/atmospherics/pipe/simple/green/hidden{
	dir = 4
	},
/obj/effect/ai_node,
/obj/structure/cable,
/turf/open/floor,
/area/bigredv2/outside/filtration_plant)
"Kl" = (
/turf/closed/wall/r_wall,
/area/bigredv2/outside/filtration_plant)
"Kq" = (
/turf/closed/wall/r_wall/unmeltable,
/area/bigredv2/outside/filtration_plant)
"KI" = (
/obj/effect/spawner/random/engineering/pickaxe,
/turf/open/floor,
/area/bigredv2/outside/s)
"Lc" = (
/obj/effect/landmark/lv624/fog_blocker,
/turf/open/floor/asteroidfloor,
/area/bigredv2/outside/s)
"Lx" = (
/turf/open/floor,
/area/bigredv2/outside/s)
"MA" = (
/obj/effect/spawner/random/engineering/structure/tank_dispenser/oxygenweighted,
/obj/effect/landmark/lv624/fog_blocker,
/turf/open/floor/plating/ground/mars/random/cave,
/area/bigredv2/outside/se)
"MJ" = (
/obj/effect/landmark/lv624/fog_blocker,
/turf/closed/mineral/smooth/bigred,
/area/bigredv2/caves/rock)
"Nw" = (
/obj/item/clothing/head/warning_cone,
/turf/open/floor/plating/ground/mars/random/sand,
/area/bigredv2/outside/se)
"NH" = (
/obj/effect/spawner/random/engineering/structure/tank_dispenser/oxygenweighted,
/obj/effect/turf_decal/warning_stripes/box/empty,
/obj/effect/turf_decal/warning_stripes/box/empty,
/turf/open/floor,
/area/bigredv2/outside/filtration_plant)
"NX" = (
/turf/closed/wall/r_wall/unmeltable,
/area/bigredv2/outside/s)
"Oj" = (
/obj/structure/rack,
/obj/item/tank/air,
/obj/effect/spawner/random/engineering/pickaxe,
/turf/open/floor,
/area/bigredv2/outside/filtration_plant)
"OF" = (
/obj/structure/cryofeed/right{
	name = "\improper coolant feed"
	},
/obj/effect/forcefield/allow_bullet_travel,
/turf/open/floor/engine,
/area/bigredv2/caves/rock)
"PY" = (
/obj/effect/decal/cleanable/dirt,
/obj/machinery/atmospherics/pipe/simple/green/hidden{
	dir = 10
	},
/turf/open/floor,
/area/bigredv2/outside/filtration_plant)
"Qh" = (
/obj/effect/turf_decal/warning_stripes/box/threeside,
/obj/machinery/computer3/server/rack,
/turf/open/floor,
/area/bigredv2/outside/filtration_plant)
"Qk" = (
/obj/structure/closet/wardrobe/atmospherics_yellow,
/turf/open/floor,
/area/bigredv2/outside/filtration_plant)
"QM" = (
/obj/effect/decal/cleanable/dirt,
/obj/effect/decal/cleanable/dirt,
/obj/structure/cable,
/obj/machinery/atmospherics/pipe/simple/green/hidden{
	dir = 5
	},
/turf/open/floor,
/area/bigredv2/outside/filtration_plant)
"Rh" = (
/obj/effect/ai_node,
/obj/structure/cable,
/turf/open/floor,
/area/bigredv2/outside/filtration_plant)
"Rp" = (
/obj/effect/landmark/lv624/fog_blocker,
/obj/effect/turf_decal/warning_stripes/box/empty,
/obj/effect/turf_decal/warning_stripes/box/empty,
/turf/open/floor,
/area/bigredv2/outside/s)
"Rz" = (
/turf/open/floor,
/area/bigredv2/outside/filtration_plant)
"RA" = (
/obj/effect/decal/cleanable/dirt,
/obj/item/radio/headset,
/turf/open/floor,
/area/bigredv2/outside/filtration_plant)
"RD" = (
/obj/effect/decal/cleanable/dirt,
/turf/open/floor,
/area/bigredv2/outside/s)
"Sw" = (
/obj/effect/decal/cleanable/dirt,
/obj/effect/forcefield/allow_bullet_travel,
/turf/closed/wall/r_wall/unmeltable,
/area/bigredv2/caves/rock)
"SY" = (
/turf/open/floor/plating,
/area/bigredv2/outside/filtration_plant)
"Tf" = (
/obj/effect/decal/cleanable/dirt,
/obj/machinery/atmospherics/pipe/simple/green/hidden{
	dir = 4
	},
/turf/open/floor,
/area/bigredv2/outside/filtration_plant)
"TZ" = (
/obj/effect/forcefield/allow_bullet_travel,
/turf/closed/wall/r_wall/unmeltable,
/area/bigredv2/caves/rock)
"Ub" = (
/obj/machinery/portable_atmospherics/scrubber/huge,
/obj/effect/turf_decal/warning_stripes,
/obj/structure/cable,
/turf/open/floor/plating,
/area/bigredv2/outside/filtration_plant)
"Ug" = (
/obj/structure/cargo_container/ch_red{
	dir = 4
	},
/obj/effect/turf_decal/warning_stripes/box/empty,
/obj/effect/turf_decal/warning_stripes/box/empty,
/turf/open/floor,
/area/bigredv2/outside/s)
"Uo" = (
/obj/effect/decal/cleanable/dirt,
/obj/effect/decal/cleanable/dirt,
/turf/open/floor,
/area/bigredv2/outside/filtration_plant)
"UC" = (
/obj/structure/cable,
/turf/open/floor/plating,
/area/bigredv2/outside/filtration_plant)
"Vy" = (
/obj/structure/table,
/obj/effect/spawner/random/engineering/toolbox,
/obj/machinery/light{
	dir = 1
	},
/turf/open/floor,
/area/bigredv2/outside/filtration_plant)
"Vz" = (
/obj/machinery/light,
/obj/effect/ai_node,
/turf/open/floor/asteroidfloor,
/area/bigredv2/outside/s)
"VS" = (
/obj/machinery/door/airlock/mainship/engineering{
	dir = 1;
	name = "\improper Atmospherics Condenser";
	req_one_access = null
	},
/obj/machinery/atmospherics/pipe/simple/green/hidden,
/obj/structure/cable,
/turf/open/floor,
/area/bigredv2/outside/filtration_plant)
"Wc" = (
/turf/open/floor/marking/asteroidwarning{
	dir = 8
	},
/area/bigredv2/outside/s)
"Wf" = (
/obj/structure/table,
/obj/item/tool/lighter/random,
/obj/effect/decal/cleanable/dirt,
/turf/open/floor,
/area/bigredv2/outside/filtration_plant)
"Wg" = (
/obj/machinery/door/airlock/mainship/engineering{
	dir = 1;
	name = "\improper Filtration Facility";
	req_one_access = null
	},
/obj/machinery/atmospherics/pipe/simple/green/hidden,
/turf/open/floor,
/area/bigredv2/outside/filtration_plant)
"YQ" = (
/obj/structure/table,
/turf/open/floor,
/area/bigredv2/outside/filtration_plant)
"YV" = (
/obj/structure/rack,
/obj/effect/spawner/random/engineering/tool,
/obj/machinery/light,
/turf/open/floor,
/area/bigredv2/outside/filtration_plant)
"Ze" = (
/obj/item/tank/air,
/obj/effect/decal/cleanable/dirt,
/turf/open/floor,
/area/bigredv2/outside/filtration_plant)
"ZT" = (
/obj/machinery/atmospherics/pipe/simple/green/hidden{
	dir = 5
	},
/turf/open/floor,
/area/bigredv2/outside/filtration_plant)

(1,1,1) = {"
Gf
pu
Gf
Gf
Gf
Gf
Gf
Gf
Gf
tF
tF
ah
Kq
Kq
Kq
Kq
dr
dr
dr
dr
dr
dr
dr
dr
jH
"}
(2,1,1) = {"
Qk
Im
am
Gf
Ex
Bv
Ex
Ex
Gf
Rz
Rz
wG
Kq
xm
xm
Kq
JK
dr
dr
dr
JK
dr
dr
Vz
NX
"}
(3,1,1) = {"
Qk
Kc
om
Gf
CC
Dd
Rz
Rz
uK
Rz
wU
Rz
Kq
Kq
Kq
Kq
ab
ab
ab
ab
gr
ab
ab
ab
zq
"}
(4,1,1) = {"
Qk
Im
Rz
Gf
NH
vv
NH
Bv
Gf
Rz
Cu
Rz
an
CZ
pM
Kl
zv
Lx
Lx
RD
Lx
RD
Lx
Lx
zq
"}
(5,1,1) = {"
Gf
pu
Gf
Gf
Gf
Gf
Gf
Gf
Gf
CC
Cu
Rz
Rz
Rz
om
Kl
Ab
RD
RD
RD
Lx
jK
jK
Ig
zq
"}
(6,1,1) = {"
Wf
pA
Cp
Gf
ze
HZ
yP
Rz
Gf
Rz
Cu
Bv
Bv
Bv
Rz
rQ
Do
RD
RD
Lx
Do
jK
Ka
Lx
NX
"}
(7,1,1) = {"
Cp
qk
ZT
xr
qx
Rz
Rz
Rh
uK
qx
Kc
Ex
ph
Bv
Rz
rQ
Lx
oU
oU
oU
oU
Rp
zP
oU
cu
"}
(8,1,1) = {"
QM
cw
Ek
tF
qx
Qh
yP
vf
tF
Cp
Im
Bv
Bv
ph
Rz
rQ
Lx
oU
Lx
Lx
Lx
jK
Ug
Lx
NX
"}
(9,1,1) = {"
PY
dt
uV
VS
AY
rw
mZ
Rh
tF
Rz
Kc
Bv
Bv
Bv
Dd
rQ
Do
oU
Lx
Lx
hT
qg
jK
Ig
zq
"}
(10,1,1) = {"
Cp
RA
Bl
Gf
CC
Rz
Tf
YV
Gf
CC
Im
Rz
Rz
Rz
om
Kl
Ab
aj
Lx
KI
Lx
jK
jK
Do
zq
"}
(11,1,1) = {"
YQ
qd
Ak
Gf
Ae
ug
dz
fZ
Gf
Gf
wE
Gf
TZ
nU
nU
TZ
Lx
oU
Lx
Lx
Lx
Lx
Lx
Lx
zq
"}
(12,1,1) = {"
tF
tF
tF
Gf
Ae
Rz
Cu
Rz
Gf
Rz
Im
xe
TZ
OF
OF
TZ
Wc
Iu
Wc
Wc
Wc
Wc
Wc
Wc
zq
"}
(13,1,1) = {"
fx
SY
fx
Gf
pX
Dd
Eg
qu
Wg
qu
lc
xe
Sw
JO
JO
TZ
dr
Lc
dr
dr
dr
dr
dr
qe
zq
"}
(14,1,1) = {"
UC
UC
UC
Gf
Vy
Rz
Rz
om
jW
CC
Im
dv
TZ
OF
OF
TZ
yq
oy
ab
ab
gr
ab
ab
yq
jH
"}
(15,1,1) = {"
FE
FE
FE
Gf
xC
FN
YQ
xP
Gf
Rz
Im
xe
TZ
JO
JO
TZ
kT
Gl
kT
kT
kT
kT
kT
kT
kO
"}
(16,1,1) = {"
Gf
Gf
Gf
Gf
Gf
Gf
jW
Gf
Gf
Rz
Im
Rz
TZ
nU
nU
TZ
kT
MA
oZ
kT
kT
kT
kT
kO
kO
"}
(17,1,1) = {"
mx
jO
jO
jO
Nw
Kl
CC
Oj
Oj
Rz
Im
om
Gf
pN
kT
kT
kT
Gl
kT
kT
kT
kT
kO
kO
kT
"}
(18,1,1) = {"
mx
jO
jO
jO
EN
Rz
Rz
Rz
Rz
Rz
Im
Cp
Cp
kT
kT
kT
kT
Gl
kT
kT
kT
kO
kO
kT
kT
"}
(19,1,1) = {"
JQ
jO
jO
jO
oi
Rz
Rz
Rz
Rz
ug
bS
Rz
Rz
kT
kT
kT
zX
Gl
kT
kT
kO
kO
kT
zX
kT
"}
(20,1,1) = {"
jO
jO
jO
jO
aJ
Rz
Rz
Rz
Cp
Ze
qx
Uo
Rz
kT
kT
kT
kT
Gl
kT
kO
kO
kT
zX
kT
zX
"}
(21,1,1) = {"
jO
jO
jO
jO
Nw
Kl
CC
Ae
Ae
Rz
qx
om
Kl
pN
kT
kT
kT
Gl
kO
kO
kT
kT
kT
kT
kT
"}
(22,1,1) = {"
jO
jO
jO
jO
jO
Kl
Kl
hZ
Kl
tF
xp
Eo
Kl
kT
kT
kT
kT
Gl
kO
kT
kT
kT
kT
kT
kT
"}
(23,1,1) = {"
jO
jO
jO
jO
jO
jO
jO
jO
Kl
Bf
Ub
Bf
Kl
mx
kT
kT
mx
MJ
kO
kT
kT
kT
kT
kT
kT
"}
(24,1,1) = {"
JQ
jO
jO
jO
JQ
jO
jO
JQ
Kl
Kl
EW
Kl
Kl
mx
mx
mx
mx
mx
MJ
kT
kT
kT
kT
kT
kT
"}
