//MAP CONVERTED BY dmm2tgm.py THIS HEADER COMMENT PREVENTS RECONVERSION, DO NOT REMOVE
"aj" = (
/obj/machinery/light{
	dir = 1
	},
/turf/open/floor/tile/dark/red2{
	dir = 9
	},
/area/bigredv3/inside/science/xenolab)
"br" = (
/obj/structure/window/framed/colony/reinforced,
/turf/open/floor/plating,
/area/bigredv3/inside/wall)
"bt" = (
/obj/effect/landmark/lv624/fog_blocker,
/turf/closed/mineral/smooth/bigred,
/area/bigredv3/caves/rock)
"ch" = (
/turf/closed/mineral/smooth/bigred/indestructible,
/area/bigredv3/inside/science/research_office)
"cB" = (
/obj/structure/table,
/obj/item/tool/pen,
/turf/open/floor/tile/dark/red2/corner{
	dir = 4
	},
/area/bigredv3/inside/science/xenolab)
"dk" = (
/obj/machinery/computer/security,
/turf/open/floor/tile/dark/red2/corner{
	dir = 4
	},
/area/bigredv3/inside/science/xenolab)
"eH" = (
/obj/effect/decal/cleanable/dirt,
/turf/open/floor/tile/dark/red2/corner,
/area/bigredv3/inside/science/xenolab)
"fU" = (
/obj/structure/table,
/obj/structure/xenoautopsy,
/turf/open/floor/tile/dark/red2/corner{
	dir = 4
	},
/area/bigredv3/inside/science/xenolab)
"gh" = (
/obj/machinery/light{
	dir = 8
	},
/turf/open/floor/tile/dark/red2/corner{
	dir = 8
	},
/area/bigredv3/inside/science/xenolab)
"gA" = (
/obj/structure/bed/chair{
	dir = 8
	},
/turf/open/floor/tile/dark/red2{
	dir = 8
	},
/area/bigredv3/inside/science/xenolab)
"gG" = (
/obj/structure/cable,
/obj/machinery/power/apc/weak/ntf{
	dir = 1
	},
/turf/open/floor/plating,
/area/bigredv3/inside/science/research_office)
"hJ" = (
/obj/effect/landmark/lv624/fog_blocker/xeno_spawn,
/turf/open/floor/plating/ground/mars/random/cave,
/area/bigredv3/caves/south)
"iu" = (
/obj/effect/landmark/lv624/fog_blocker/xeno_spawn,
/turf/closed/mineral/smooth/bigred,
/area/bigredv3/caves/rock)
"iZ" = (
/turf/open/floor/plating/ground/mars/random/cave,
/area/bigredv3/caves/south)
"ju" = (
/obj/effect/ai_node,
/turf/open/floor/tile/dark,
/area/bigredv3/inside/science/xenolab)
"kj" = (
/obj/machinery/atmospherics/components/unary/vent_pump{
	dir = 4;
	on = 1
	},
/turf/open/floor/tile/dark,
/area/bigredv3/inside/science/xenolab)
"lQ" = (
/turf/open/floor/plating/ground/mars/random/cave/rock,
/area/bigredv3/caves/south)
"mi" = (
/obj/structure/window/framed/colony/reinforced/unbreakable,
/turf/open/floor/plating,
/area/bigredv3/inside/wall)
"mS" = (
/turf/open/floor/tile/darkgreen/darkgreen2{
	dir = 6
	},
/area/bigredv3/inside/science/xenolab)
"oH" = (
/turf/open/floor/plating,
/area/bigredv3/inside/science/research_office)
"oL" = (
/obj/structure/xenoautopsy/tank/hugger,
/turf/open/floor/tile/dark/red2/corner{
	dir = 8
	},
/area/bigredv3/inside/science/xenolab)
"pz" = (
/turf/open/floor/plating/ground/mars/random/sand,
/area/bigredv3/inside/science/xenolab)
"pW" = (
/obj/effect/landmark/xeno_silo_spawn,
/turf/open/floor/plating/ground/mars/random/cave,
/area/bigredv3/caves/south)
"qt" = (
/obj/effect/landmark/lv624/fog_blocker,
/turf/closed/wall/r_wall,
/area/bigredv3/inside/wall)
"qR" = (
/obj/effect/decal/cleanable/dirt,
/obj/effect/ai_node,
/turf/open/floor/tile/dark,
/area/bigredv3/inside/science/xenolab)
"qZ" = (
/turf/open/floor/tile/dark/red2{
	dir = 8
	},
/area/bigredv3/inside/science/xenolab)
"rh" = (
/obj/machinery/atmospherics/pipe/simple/green/hidden{
	dir = 4
	},
/turf/open/floor/tile/dark,
/area/bigredv3/inside/science/xenolab)
"rx" = (
/obj/structure/closet/toolcloset,
/turf/open/floor/plating,
/area/bigredv3/inside/science/research_office)
"rW" = (
/obj/effect/ai_node,
/turf/open/floor/plating/ground/mars/random/sand,
/area/bigredv3/inside/science/xenolab)
"tI" = (
/turf/open/floor/tile/darkgreen/darkgreen2{
	dir = 8
	},
/area/bigredv3/inside/science/xenolab)
"tQ" = (
/obj/structure/fence/standard/xenoproof,
/turf/open/floor/plating/ground/mars/random/cave/rock,
/area/bigredv3/caves/south)
"uH" = (
/obj/structure/fence/standard/xenoproof,
/turf/open/floor/plating/ground/mars/random/cave,
/area/bigredv3/caves/south)
"uL" = (
/turf/open/floor/tile/dark/red2/corner,
/area/bigredv3/inside/science/xenolab)
"uM" = (
/turf/open/ground/jungle/clear,
/area/bigredv3/inside/science/xenolab)
"vm" = (
/obj/structure/table,
/obj/item/alienjar,
/turf/open/floor/tile/dark/red2/corner{
	dir = 4
	},
/area/bigredv3/inside/science/xenolab)
"ym" = (
/obj/effect/ai_node,
/turf/open/floor/plating/ground/mars/random/cave,
/area/bigredv3/caves/south)
"zf" = (
/turf/open/floor/tile/darkgreen/darkgreen2{
	dir = 4
	},
/area/bigredv3/inside/science/xenolab)
"zr" = (
/obj/structure/closet/l3closet/scientist,
/turf/open/floor/tile/darkgreen/darkgreen2{
	dir = 1
	},
/area/bigredv3/inside/science/xenolab)
"zV" = (
/turf/open/floor/tile/dark/red2,
/area/bigredv3/inside/science/xenolab)
"Aq" = (
/turf/open/floor/tile/dark/red2{
	dir = 1
	},
/area/bigredv3/inside/science/xenolab)
"AF" = (
/obj/machinery/light{
	dir = 1
	},
/turf/open/floor/tile/dark/red2{
	dir = 5
	},
/area/bigredv3/inside/science/xenolab)
"AQ" = (
/obj/structure/table,
/obj/item/paper,
/turf/open/floor/tile/dark/red2/corner,
/area/bigredv3/inside/science/xenolab)
"Bp" = (
/obj/machinery/atmospherics/pipe/simple/green/hidden{
	dir = 4
	},
/obj/machinery/door/airlock/mainship/research/glass/free_access{
	name = "\improper Eta Lab Xenobiology Lab"
	},
/turf/open/floor/tile/dark,
/area/bigredv3/inside/science/xenolab)
"DB" = (
/obj/machinery/door/airlock/mainship/research/glass/free_access{
	dir = 1;
	name = "\improper Eta Lab Cell"
	},
/turf/open/floor/tile/dark,
/area/bigredv3/inside/science/xenolab)
"En" = (
/turf/closed/mineral/smooth/bigred/indestructible,
/area/bigredv3/inside/wall)
"Eq" = (
/obj/effect/decal/cleanable/dirt,
/turf/open/floor/tile/dark,
/area/bigredv3/inside/science/xenolab)
"EC" = (
/turf/open/floor/tile/dark/red2{
	dir = 4
	},
/area/bigredv3/inside/science/xenolab)
"EF" = (
/turf/closed/mineral/smooth/bigred,
/area/bigredv3/caves/rock)
"EK" = (
/obj/machinery/atmospherics/pipe/manifold/green/hidden{
	dir = 1
	},
/obj/effect/ai_node,
/turf/open/floor/tile/dark,
/area/bigredv3/inside/science/xenolab)
"EW" = (
/turf/closed/wall/r_wall,
/area/bigredv3/inside/wall)
"Gm" = (
/obj/effect/decal/cleanable/dirt,
/turf/open/floor/tile/dark/red2/corner{
	dir = 8
	},
/area/bigredv3/inside/science/xenolab)
"Hc" = (
/turf/open/floor/tile/dark/red2/corner{
	dir = 4
	},
/area/bigredv3/inside/science/xenolab)
"HO" = (
/obj/machinery/atmospherics/pipe/simple/green/hidden{
	dir = 4
	},
/obj/effect/ai_node,
/turf/open/floor/tile/dark,
/area/bigredv3/inside/science/xenolab)
"IA" = (
/obj/machinery/light{
	dir = 4
	},
/obj/effect/decal/cleanable/dirt,
/obj/effect/ai_node,
/turf/open/floor/tile/dark/red2/corner,
/area/bigredv3/inside/science/xenolab)
"Jq" = (
/obj/structure/bed/chair{
	dir = 4
	},
/turf/open/floor/tile/dark/red2{
	dir = 4
	},
/area/bigredv3/inside/science/xenolab)
"JI" = (
/obj/item/target,
/turf/open/floor/tile/dark/red2{
	dir = 1
	},
/area/bigredv3/inside/science/xenolab)
"KI" = (
/turf/open/floor/tile/dark/red2{
	dir = 6
	},
/area/bigredv3/inside/science/xenolab)
"KO" = (
/obj/machinery/light,
/turf/open/floor/tile/darkgreen/darkgreen2,
/area/bigredv3/inside/science/xenolab)
"Lv" = (
/obj/machinery/light{
	dir = 4
	},
/turf/open/ground/jungle/clear,
/area/bigredv3/inside/science/xenolab)
"LO" = (
/obj/structure/table,
/obj/effect/spawner/random/engineering/technology_scanner,
/turf/open/floor/tile/dark/red2/corner{
	dir = 4
	},
/area/bigredv3/inside/science/xenolab)
"LR" = (
/obj/structure/closet/l3closet/scientist,
/turf/open/floor/tile/darkgreen/darkgreen2{
	dir = 9
	},
/area/bigredv3/inside/science/xenolab)
"MK" = (
/obj/structure/cable,
/turf/open/floor/plating,
/area/bigredv3/inside/science/research_office)
"NJ" = (
/turf/closed/mineral/smooth/bigred/indestructible,
/area/space)
"NW" = (
/turf/closed/wall,
/area/bigredv3/inside/wall)
"Og" = (
/obj/machinery/atmospherics/components/unary/vent_pump{
	dir = 1;
	on = 1
	},
/turf/open/floor/tile/dark,
/area/bigredv3/inside/science/xenolab)
"OF" = (
/obj/machinery/door/airlock/mainship/research/glass/free_access{
	name = "\improper Eta Lab Cell"
	},
/turf/open/floor/tile/dark,
/area/bigredv3/inside/science/xenolab)
"OP" = (
/turf/open/floor/tile/darkgreen/darkgreen2{
	dir = 10
	},
/area/bigredv3/inside/science/xenolab)
"PJ" = (
/obj/structure/window/framed/colony,
/turf/open/floor/plating,
/area/bigredv3/inside/wall)
"PO" = (
/obj/effect/spawner/random/engineering/structure/tank/fuelweighted,
/obj/machinery/light/small{
	dir = 1
	},
/turf/open/floor/plating,
/area/bigredv3/inside/science/research_office)
"Sf" = (
/obj/structure/cable,
/obj/effect/ai_node,
/turf/open/floor/plating,
/area/bigredv3/inside/science/research_office)
"Sq" = (
/obj/structure/closet/l3closet/scientist,
/turf/open/floor/tile/darkgreen/darkgreen2{
	dir = 5
	},
/area/bigredv3/inside/science/xenolab)
"TQ" = (
/obj/effect/decal/cleanable/blood/gibs,
/turf/open/floor/plating/ground/mars/random/cave,
/area/bigredv3/caves/south)
"TS" = (
/obj/structure/table,
/obj/machinery/light,
/obj/effect/spawner/random/engineering/technology_scanner,
/obj/item/xenos_claw,
/turf/open/floor/tile/dark/red2/corner{
	dir = 8
	},
/area/bigredv3/inside/science/xenolab)
"Un" = (
/turf/open/floor/tile/dark/red2/corner{
	dir = 8
	},
/area/bigredv3/inside/science/xenolab)
"Uo" = (
/obj/structure/closet/crate/secure,
/turf/open/floor/tile/dark/red2/corner,
/area/bigredv3/inside/science/xenolab)
"UB" = (
/turf/open/floor/tile/dark,
/area/bigredv3/inside/science/xenolab)
"UG" = (
/obj/effect/landmark/lv624/fog_blocker/xeno_spawn,
/turf/open/floor/plating/ground/mars/random/cave/rock,
/area/bigredv3/caves/south)
"VX" = (
/obj/effect/spawner/random/engineering/structure/tank/fuelweighted,
/turf/open/floor/plating,
/area/bigredv3/inside/science/research_office)
"Wn" = (
/obj/structure/closet/firecloset,
/turf/open/floor/plating,
/area/bigredv3/inside/science/research_office)
"WX" = (
/obj/structure/table,
/obj/effect/spawner/random/engineering/technology_scanner,
/turf/open/floor/tile/dark/red2/corner{
	dir = 8
	},
/area/bigredv3/inside/science/xenolab)
"XD" = (
/turf/open/floor/tile/dark/red2{
	dir = 10
	},
/area/bigredv3/inside/science/xenolab)
"Yz" = (
/obj/structure/cable,
/obj/machinery/door/airlock/mainship/maint/free_access{
	name = "\improper Eta Lab Maintenance Storage"
	},
/turf/open/floor/tile/dark,
/area/bigredv3/inside/science/research_office)
"YO" = (
/obj/machinery/light{
	dir = 8
	},
/turf/open/floor/plating/ground/mars/random/sand,
/area/bigredv3/inside/science/xenolab)
"YU" = (
/obj/structure/xenoautopsy/tank,
/turf/open/floor/tile/dark/red2/corner{
	dir = 8
	},
/area/bigredv3/inside/science/xenolab)
"Zi" = (
/obj/effect/ai_node,
/turf/open/floor/plating/ground/mars/random/cave/rock,
/area/bigredv3/caves/south)
"Zl" = (
/obj/effect/ai_node,
/turf/open/ground/jungle/clear,
/area/bigredv3/inside/science/xenolab)

(1,1,1) = {"
NJ
NJ
NJ
NJ
NJ
NJ
NJ
NJ
NJ
NJ
NJ
NJ
NJ
NJ
NJ
NJ
NJ
NJ
NJ
NJ
NJ
NJ
NJ
NJ
NJ
NJ
NJ
NJ
NJ
NJ
NJ
NJ
NJ
NJ
NJ
NJ
NJ
NJ
"}
(2,1,1) = {"
NJ
NJ
NJ
NJ
NJ
NJ
NJ
NJ
NJ
NJ
NJ
NJ
NJ
NJ
NJ
NJ
NJ
NJ
NJ
NJ
NJ
NJ
NJ
NJ
NJ
NJ
NJ
NJ
NJ
NJ
NJ
NJ
NJ
NJ
NJ
NJ
NJ
NJ
"}
(3,1,1) = {"
NJ
NJ
NJ
NJ
NJ
NJ
NJ
NJ
NJ
NJ
NJ
NJ
NJ
NJ
NJ
NJ
NJ
NJ
NJ
NJ
NJ
NJ
NJ
NJ
NJ
NJ
NJ
NJ
NJ
NJ
NJ
NJ
NJ
NJ
NJ
NJ
NJ
NJ
"}
(4,1,1) = {"
NJ
NJ
NJ
NJ
NJ
NJ
NJ
NJ
NJ
NJ
NJ
NJ
NJ
NJ
NJ
NJ
NJ
NJ
NJ
NJ
NJ
NJ
NJ
NJ
NJ
NJ
NJ
NJ
NJ
NJ
NJ
NJ
NJ
NJ
NJ
NJ
NJ
NJ
"}
(5,1,1) = {"
NJ
NJ
NJ
NJ
NJ
NJ
NJ
NJ
NJ
NJ
NJ
NJ
NJ
NJ
NJ
NJ
NJ
NJ
NJ
NJ
NJ
NJ
NJ
NJ
NJ
NJ
NJ
NJ
NJ
NJ
NJ
NJ
NJ
NJ
NJ
NJ
NJ
NJ
"}
(6,1,1) = {"
NJ
NJ
NJ
NJ
NJ
NJ
NJ
ch
NJ
NJ
NJ
NJ
NJ
NJ
NJ
NJ
NJ
NJ
NJ
NJ
NJ
NJ
NJ
NJ
NJ
NJ
NJ
NJ
NJ
NJ
NJ
NJ
NJ
NJ
NJ
NJ
NJ
NJ
"}
(7,1,1) = {"
NJ
NJ
NJ
NJ
NJ
NJ
NJ
En
NJ
NJ
NJ
NJ
NJ
NJ
NJ
NJ
NJ
NJ
NJ
NJ
NJ
NJ
NJ
NJ
NJ
NJ
NJ
NJ
NJ
NJ
NJ
NJ
NJ
NJ
NJ
NJ
NJ
NJ
"}
(8,1,1) = {"
NJ
NJ
NJ
NJ
NJ
NJ
NJ
NJ
NJ
NJ
NJ
NJ
NJ
NJ
NJ
NJ
NJ
NJ
NJ
NJ
NJ
NJ
NJ
NJ
NJ
NJ
NJ
NJ
NJ
NJ
NJ
NJ
NJ
NJ
NJ
NJ
NJ
NJ
"}
(9,1,1) = {"
NJ
NJ
NJ
NJ
NJ
NJ
NJ
NJ
NJ
NJ
NJ
NJ
NJ
NJ
NJ
NJ
NJ
NJ
NJ
NJ
NJ
NJ
NJ
NJ
NJ
NJ
NJ
NJ
NJ
NJ
NJ
NJ
NJ
NJ
NJ
NJ
NJ
NJ
"}
(10,1,1) = {"
NJ
NJ
NJ
NJ
NJ
NJ
NJ
NJ
NJ
NJ
NJ
NJ
NJ
NJ
NJ
NJ
NJ
NJ
NJ
NJ
NJ
NJ
NJ
NJ
NJ
NJ
NJ
NJ
NJ
NJ
NJ
NJ
NJ
NJ
NJ
NJ
NJ
NJ
"}
(11,1,1) = {"
NJ
NJ
NJ
NJ
NJ
NJ
NJ
NJ
NJ
NJ
NJ
NJ
NJ
NJ
NJ
NJ
NJ
NJ
NJ
NJ
NJ
NJ
NJ
NJ
NJ
NJ
NJ
NJ
NJ
NJ
NJ
NJ
NJ
NJ
NJ
NJ
NJ
NJ
"}
(12,1,1) = {"
NJ
NJ
NJ
NJ
NJ
NJ
NJ
NJ
NJ
NJ
NJ
NJ
NJ
NJ
NJ
NJ
NJ
NJ
NJ
NJ
NJ
NJ
NJ
NJ
NJ
NJ
NJ
NJ
NJ
NJ
NJ
NJ
NJ
NJ
NJ
NJ
NJ
NJ
"}
(13,1,1) = {"
NJ
NJ
NJ
NJ
NJ
NJ
NJ
NJ
NJ
NJ
NJ
NJ
NJ
NJ
NJ
NJ
NJ
NJ
NJ
NJ
NJ
NJ
NJ
NJ
NJ
NJ
NJ
NJ
NJ
NJ
NJ
NJ
NJ
NJ
NJ
NJ
NJ
NJ
"}
(14,1,1) = {"
NJ
NJ
NJ
NJ
NJ
NJ
NJ
NJ
NJ
NJ
NJ
NJ
NJ
NJ
NJ
NJ
NJ
NJ
NJ
NJ
NJ
NJ
NJ
NJ
NJ
NJ
NJ
NJ
NJ
NJ
NJ
NJ
NJ
NJ
NJ
NJ
NJ
NJ
"}
(15,1,1) = {"
NJ
NJ
NJ
NJ
NJ
NJ
NJ
NJ
NJ
NJ
NJ
NJ
NJ
NJ
NJ
NJ
NJ
NJ
NJ
NJ
NJ
NJ
NJ
NJ
NJ
NJ
NJ
NJ
NJ
NJ
NJ
NJ
NJ
NJ
NJ
NJ
NJ
NJ
"}
(16,1,1) = {"
NJ
NJ
NJ
NJ
NJ
NJ
NJ
NJ
NJ
NJ
NJ
NJ
NJ
NJ
NJ
NJ
NJ
NJ
NJ
NJ
NJ
NJ
NJ
NJ
NJ
NJ
NJ
NJ
NJ
NJ
NJ
NJ
NJ
NJ
NJ
NJ
NJ
NJ
"}
(17,1,1) = {"
NJ
NJ
NJ
NJ
NJ
NJ
NJ
NJ
NJ
NJ
NJ
NJ
NJ
NJ
NJ
NJ
NJ
NJ
NJ
NJ
NJ
NJ
NJ
NJ
NJ
NJ
NJ
NJ
NJ
NJ
NJ
NJ
NJ
NJ
NJ
NJ
NJ
NJ
"}
(18,1,1) = {"
NJ
NJ
NJ
NJ
NJ
NJ
NJ
NJ
NJ
NJ
NJ
NJ
NJ
NJ
NJ
NJ
NJ
NJ
NJ
NJ
NJ
NJ
NJ
NJ
NJ
NJ
NJ
NJ
NJ
NJ
NJ
NJ
NJ
NJ
NJ
NJ
NJ
NJ
"}
(19,1,1) = {"
NJ
NJ
NJ
NJ
NJ
NJ
NJ
NJ
NJ
NJ
NJ
NJ
NJ
NJ
NJ
NJ
NJ
NJ
NJ
NJ
NJ
NJ
NJ
NJ
NJ
NJ
NJ
NJ
NJ
NJ
NJ
NJ
NJ
NJ
NJ
NJ
NJ
NJ
"}
(20,1,1) = {"
NJ
NJ
NJ
NJ
NJ
NJ
NJ
NJ
NJ
NJ
NJ
NJ
NJ
NJ
NJ
NJ
NJ
NJ
NJ
NJ
NJ
NJ
NJ
NJ
NJ
NJ
NJ
NJ
NJ
NJ
NJ
NJ
NJ
NJ
NJ
NJ
NJ
NJ
"}
(21,1,1) = {"
NJ
NJ
NJ
NJ
NJ
NJ
NJ
NJ
NJ
NJ
NJ
NJ
NJ
NJ
NJ
NJ
NJ
NJ
NJ
NJ
NJ
NJ
NJ
NJ
NJ
NJ
NJ
NJ
NJ
NJ
NJ
NJ
NJ
NJ
NJ
NJ
NJ
NJ
"}
(22,1,1) = {"
NJ
NJ
NJ
NJ
NJ
NJ
NJ
NJ
NJ
NJ
NJ
NJ
NJ
NJ
NJ
NJ
NJ
NJ
NJ
NJ
NJ
NJ
NJ
NJ
NJ
NJ
NJ
NJ
NJ
NJ
NJ
NJ
NJ
NJ
NJ
NJ
NJ
NJ
"}
(23,1,1) = {"
NJ
NJ
NJ
NJ
NJ
NJ
NJ
NJ
NJ
NJ
NJ
NJ
NJ
NJ
NJ
NJ
NJ
NJ
NJ
NJ
NJ
NJ
NJ
NJ
NJ
NJ
NJ
NJ
NJ
NJ
NJ
NJ
NJ
NJ
NJ
NJ
NJ
NJ
"}
(24,1,1) = {"
NJ
NJ
NJ
NJ
NJ
NJ
NJ
NJ
NJ
NJ
NJ
NJ
NJ
NJ
NJ
NJ
NJ
NJ
NJ
NJ
NJ
NJ
NJ
NJ
NJ
NJ
NJ
NJ
NJ
NJ
NJ
NJ
NJ
NJ
NJ
NJ
NJ
NJ
"}
(25,1,1) = {"
NJ
NJ
NJ
NJ
NJ
NJ
NJ
NJ
NJ
NJ
NJ
NJ
NJ
NJ
NJ
NJ
NJ
NJ
NJ
NJ
NJ
NJ
NJ
NJ
NJ
NJ
NJ
NJ
NJ
NJ
NJ
NJ
NJ
NJ
NJ
NJ
NJ
NJ
"}
(26,1,1) = {"
NJ
NJ
NJ
NJ
NJ
NJ
NJ
NJ
NJ
NJ
NJ
NJ
NJ
NJ
NJ
NJ
NJ
NJ
NJ
NJ
NJ
NJ
NJ
NJ
NJ
NJ
NJ
NJ
NJ
NJ
NJ
NJ
NJ
NJ
NJ
NJ
NJ
NJ
"}
(27,1,1) = {"
NJ
NJ
NJ
NJ
NJ
NJ
NJ
NJ
NJ
NJ
NJ
NJ
NJ
NJ
NJ
NJ
NJ
NJ
NJ
NJ
NJ
NJ
NJ
NJ
NJ
NJ
NJ
NJ
NJ
NJ
NJ
NJ
NJ
NJ
NJ
NJ
NJ
NJ
"}
(28,1,1) = {"
NJ
NJ
NJ
NJ
NJ
NJ
NJ
NJ
NJ
NJ
NJ
NJ
NJ
NJ
NJ
NJ
NJ
NJ
NJ
NJ
NJ
NJ
NJ
NJ
NJ
NJ
NJ
NJ
NJ
NJ
NJ
NJ
NJ
NJ
NJ
NJ
NJ
NJ
"}
(29,1,1) = {"
NJ
NJ
NJ
NJ
NJ
NJ
NJ
NJ
NJ
NJ
NJ
NJ
NJ
NJ
NJ
NJ
NJ
NJ
NJ
NJ
NJ
NJ
NJ
NJ
NJ
NJ
NJ
NJ
NJ
NJ
NJ
NJ
NJ
NJ
NJ
NJ
NJ
NJ
"}
(30,1,1) = {"
EF
EF
EF
EF
EF
EF
EF
EF
EF
EF
EF
EF
EF
EF
EF
EF
EF
EF
EF
EF
EF
EF
EF
EF
EF
EF
EF
EF
EF
EF
EF
EF
EF
EF
EF
EF
EF
NJ
"}
(31,1,1) = {"
EF
EF
iu
iu
iu
iu
iu
iu
iu
iu
iu
iu
iu
iu
iu
EF
EF
EF
EF
EF
EF
EF
EF
EF
EF
EF
EF
EF
EF
EF
EF
EF
EF
EF
EF
EF
EF
NJ
"}
(32,1,1) = {"
EF
EF
iu
EF
EF
EF
EF
EF
EF
lQ
lQ
EF
EF
EF
iu
EF
EF
EF
EF
EF
EF
EF
EF
EF
EF
EF
EF
EF
EF
EF
EF
EF
EF
EF
EF
EF
EF
NJ
"}
(33,1,1) = {"
EF
EF
iu
EF
EF
EF
EF
EF
lQ
iZ
iZ
lQ
EF
EF
iu
EF
EF
EF
EF
EF
EF
EF
EF
EF
EF
EF
EF
EF
EF
EF
EF
EF
EF
EF
EF
EF
EF
NJ
"}
(34,1,1) = {"
EF
EF
iu
EF
EF
EF
EF
lQ
iZ
iZ
pW
iZ
lQ
lQ
iu
EF
EF
EF
EF
EF
EF
EF
EF
EF
EF
EF
EF
EF
EF
EF
EF
EF
EF
EF
EF
EF
EF
NJ
"}
(35,1,1) = {"
EF
EF
iu
EF
EF
EF
lQ
iZ
iZ
ym
iZ
iZ
iZ
lQ
iu
EF
EF
EF
EF
EF
EF
EF
EF
EF
EF
EF
EF
EF
EF
EF
EF
EF
EF
EF
EF
EF
EF
NJ
"}
(36,1,1) = {"
EF
EF
iu
EF
EF
EF
iZ
iZ
iZ
iZ
iZ
iZ
iZ
iZ
iu
EF
EF
EF
EF
EF
EF
EF
EF
EF
EF
EF
EF
EF
EF
EF
EF
EF
EF
EF
EF
EF
EF
NJ
"}
(37,1,1) = {"
EF
EF
iu
EF
iZ
iZ
iZ
iZ
iZ
iZ
iZ
iZ
iZ
iZ
iu
EF
EF
EF
EF
EF
EF
EF
EF
EF
EF
EF
EF
EF
EF
EF
EF
EF
EF
EF
EF
EF
EF
NJ
"}
(38,1,1) = {"
EF
EF
iu
iZ
iZ
iZ
iZ
iZ
iZ
iZ
iZ
iZ
iZ
iZ
hJ
iZ
EF
EF
EF
EF
EF
EF
EF
EF
EF
EF
EF
EF
EF
EF
EF
EF
EF
EF
EF
EF
EF
NJ
"}
(39,1,1) = {"
iZ
iZ
hJ
iZ
iZ
iZ
iZ
iZ
iZ
iZ
iZ
iZ
iZ
iZ
hJ
iZ
iZ
iZ
iZ
iZ
iZ
iZ
EF
EF
EF
EF
EF
EF
EF
EF
EF
EF
EF
EF
EF
EF
EF
NJ
"}
(40,1,1) = {"
iZ
lQ
hJ
iZ
lQ
lQ
iZ
iZ
iZ
iZ
iZ
lQ
iZ
iZ
hJ
iZ
iZ
iZ
iZ
iZ
iZ
iZ
iZ
EF
EF
EF
EF
EF
EF
EF
EF
EF
EF
EF
EF
EF
EF
NJ
"}
(41,1,1) = {"
iZ
iZ
hJ
iZ
iZ
iZ
iZ
iZ
iZ
ym
iZ
iZ
lQ
lQ
UG
lQ
lQ
lQ
iZ
lQ
Zi
lQ
iZ
iZ
iZ
ym
EF
EF
EF
EF
EF
EF
EF
EF
EF
EF
EF
NJ
"}
(42,1,1) = {"
iZ
iZ
hJ
iZ
iZ
iZ
iZ
iZ
iZ
iZ
iZ
iZ
iZ
iZ
hJ
iZ
iZ
iZ
iZ
iZ
iZ
iZ
lQ
iZ
iZ
iZ
iZ
EF
EF
EF
EF
EF
EF
EF
EF
EF
EF
NJ
"}
(43,1,1) = {"
iZ
EF
iu
EF
EF
EF
EF
lQ
iZ
iZ
iZ
iZ
iZ
iZ
hJ
iZ
iZ
iZ
iZ
iZ
iZ
iZ
iZ
iZ
iZ
iZ
iZ
iZ
EF
EF
EF
EF
EF
EF
EF
EF
EF
NJ
"}
(44,1,1) = {"
EF
EF
iu
iu
iu
iu
iu
iu
iu
iu
iu
iu
iu
iu
iu
EF
EF
iZ
EF
EF
lQ
lQ
EF
lQ
iZ
iZ
iZ
iZ
EF
EF
EF
EF
EF
EF
EF
EF
EF
NJ
"}
(45,1,1) = {"
EF
EF
EF
EF
EF
EF
EF
EF
EF
EF
EF
EF
EF
EF
EF
EF
EF
EF
EF
EF
EF
EF
EF
EF
iZ
iZ
iZ
iZ
iZ
EF
EF
EF
EF
EF
EF
EF
EF
NJ
"}
(46,1,1) = {"
bt
bt
bt
bt
bt
bt
bt
bt
bt
bt
bt
bt
bt
bt
bt
bt
bt
bt
bt
bt
bt
bt
EF
EF
EF
iZ
iZ
iZ
iZ
iZ
EF
EF
EF
EF
EF
EF
EF
NJ
"}
(47,1,1) = {"
EW
EW
EW
EW
EW
EW
EW
EW
EW
EW
EW
EW
EW
EW
EW
EW
EW
EW
EW
EW
EW
EW
qt
EF
EF
iZ
iZ
iZ
iZ
iZ
iZ
EF
EF
EF
EF
EF
EF
NJ
"}
(48,1,1) = {"
aj
qZ
qZ
XD
EW
YU
oL
YU
oL
YU
EW
pz
YO
pz
EW
pz
YO
pz
EW
pz
YO
pz
qt
EF
EF
ym
iZ
iZ
iZ
iZ
iZ
EF
EF
EF
EF
EF
EF
NJ
"}
(49,1,1) = {"
Aq
ju
UB
UB
DB
UB
UB
ju
UB
Gm
EW
pz
rW
pz
EW
pz
rW
pz
EW
pz
rW
pz
qt
EF
EF
iZ
iZ
iZ
iZ
iZ
iZ
EF
EF
EF
EF
EF
EF
NJ
"}
(50,1,1) = {"
Aq
UB
UB
zV
EW
Hc
Eq
Eq
Eq
WX
EW
pz
pz
pz
EW
pz
pz
pz
EW
pz
pz
pz
qt
EF
EF
iZ
iZ
iZ
iZ
iZ
iZ
EF
EF
EF
EF
EF
EF
NJ
"}
(51,1,1) = {"
JI
UB
UB
zV
br
dk
Eq
Eq
UB
TS
EW
mi
OF
mi
EW
mi
OF
mi
EW
mi
OF
mi
qt
EF
EF
iZ
iZ
lQ
iZ
iZ
iZ
iZ
EF
EF
EF
EF
EF
NJ
"}
(52,1,1) = {"
Aq
UB
UB
zV
br
LO
Eq
Eq
UB
Un
NW
gA
Eq
gA
NW
gA
UB
gA
NW
gA
UB
gA
qt
EF
EF
iZ
iZ
lQ
iZ
iZ
iZ
iZ
iZ
EF
EF
EF
EF
NJ
"}
(53,1,1) = {"
JI
UB
UB
zV
br
vm
UB
Eq
Eq
UB
Un
Gm
UB
Un
gh
Un
UB
Un
Un
Un
Eq
Un
qt
EF
uH
iZ
iZ
lQ
iZ
iZ
iZ
iZ
iZ
EF
EF
EF
EF
NJ
"}
(54,1,1) = {"
Aq
ju
UB
zV
br
fU
UB
kj
Eq
Eq
UB
Eq
Eq
Eq
UB
Eq
Eq
Eq
UB
Eq
UB
Eq
qt
iZ
uH
iZ
iZ
lQ
iZ
iZ
iZ
iZ
iZ
EF
EF
EF
EF
NJ
"}
(55,1,1) = {"
Aq
UB
UB
zV
br
cB
UB
HO
Eq
Eq
IA
eH
qR
eH
eH
eH
qR
eH
IA
uL
ju
uL
qt
iZ
uH
ym
iZ
iZ
iZ
iZ
iZ
iZ
ym
EF
EF
EF
EF
NJ
"}
(56,1,1) = {"
AF
EC
EC
KI
br
AQ
uL
rh
uL
Uo
NW
Jq
UB
Jq
NW
Jq
UB
Jq
NW
Jq
Eq
Jq
qt
EF
tQ
iZ
iZ
iZ
iZ
iZ
iZ
iZ
iZ
iZ
EF
EF
EF
NJ
"}
(57,1,1) = {"
EW
EW
EW
EW
EW
NW
PJ
Bp
PJ
NW
EW
mi
OF
mi
EW
mi
OF
mi
EW
mi
OF
mi
qt
EF
EF
EF
EF
iZ
iZ
iZ
iZ
iZ
iZ
iZ
EF
EF
EF
NJ
"}
(58,1,1) = {"
VX
MK
MK
gG
NW
LR
tI
rh
tI
OP
EW
uM
uM
uM
EW
uM
uM
uM
EW
uM
uM
uM
qt
EF
EF
EF
EF
iZ
EF
EF
iZ
iZ
iZ
iZ
iZ
EF
EF
NJ
"}
(59,1,1) = {"
PO
Sf
oH
Wn
NW
zr
UB
EK
Og
KO
EW
uM
Zl
uM
EW
uM
Zl
uM
EW
uM
Zl
uM
qt
EF
EF
EF
EF
EF
EF
EF
EF
iZ
iZ
iZ
iZ
EF
EF
NJ
"}
(60,1,1) = {"
VX
MK
oH
rx
NW
Sq
zf
rh
zf
mS
EW
uM
Lv
uM
EW
uM
Lv
uM
EW
uM
Lv
uM
qt
bt
bt
bt
bt
bt
bt
bt
EF
iZ
ym
TQ
iZ
EF
EF
NJ
"}
(61,1,1) = {"
NW
Yz
NW
NW
NW
NW
PJ
Bp
PJ
NW
EW
EW
EW
EW
EW
EW
EW
EW
EW
EW
EW
EW
EW
EW
EW
EW
EW
EW
EW
bt
EF
iZ
iZ
iZ
iZ
EF
EF
NJ
"}
