//MAP CONVERTED BY dmm2tgm.py THIS HEADER COMMENT PREVENTS RECONVERSION, DO NOT REMOVE
"ad" = (
/obj/structure/cargo_container/gorg{
	dir = 4
	},
/turf/open/floor,
/area/bigredv3/inside/cargo/cargobay)
"ar" = (
/obj/machinery/atmospherics/pipe/simple/green/hidden,
/obj/machinery/door/airlock/multi_tile/mainship/generic{
	name = "\improper Cargo Offices"
	},
/turf/open/floor,
/area/bigredv3/inside/cargo/cargobay)
"at" = (
/obj/structure/cargo_container/green{
	dir = 1
	},
/turf/open/floor,
/area/bigredv3/inside/cargo/cargobay)
"aw" = (
/obj/machinery/atmospherics/pipe/simple/green/hidden{
	dir = 10
	},
/obj/effect/decal/cleanable/dirt,
/turf/open/floor,
/area/bigredv3/inside/cargo/cargobay)
"aU" = (
/obj/structure/table,
/obj/effect/spawner/random/engineering/tool,
/obj/effect/spawner/random/engineering/tool,
/obj/effect/spawner/random/engineering/bomb_supply,
/obj/effect/spawner/random/engineering/bomb_supply,
/turf/open/floor,
/area/bigredv3/inside/cargo/cargobay)
"aV" = (
/obj/machinery/light{
	dir = 4
	},
/obj/effect/spawner/random/engineering/structure/tank/waterweighted,
/turf/open/floor,
/area/bigredv3/inside/cargo/cargobay)
"ba" = (
/obj/machinery/atmospherics/pipe/simple/green/hidden,
/obj/structure/cable,
/turf/open/floor/tile/dark,
/area/bigredv3/inside/cargo/cargobay)
"bm" = (
/obj/machinery/atmospherics/pipe/manifold/green/hidden,
/obj/structure/cable,
/turf/open/floor,
/area/bigredv3/inside/cargo/cargobay)
"bw" = (
/obj/structure/closet/firecloset/full,
/turf/open/floor,
/area/bigredv3/inside/cargo/cargobay)
"bE" = (
/obj/machinery/atmospherics/pipe/simple/green/hidden{
	dir = 4
	},
/obj/effect/ai_node,
/obj/structure/cable,
/turf/open/floor,
/area/bigredv3/inside/cargo/cargobay)
"bH" = (
/obj/machinery/atmospherics/components/unary/vent_pump{
	dir = 8;
	on = 1
	},
/turf/open/floor,
/area/bigredv3/inside/cargo/cargobay)
"bK" = (
/obj/machinery/door/poddoor/shutters/mainship{
	id = "Cargonia";
	name = "\improper Cargo Shutters"
	},
/obj/structure/window/framed/colony/reinforced,
/turf/open/floor/plating,
/area/bigredv3/inside/wall)
"bR" = (
/obj/structure/table,
/obj/effect/spawner/random/engineering/toolbox,
/obj/effect/spawner/random/engineering/tool,
/turf/open/floor,
/area/bigredv3/inside/cargo/cargobay)
"bX" = (
/obj/effect/decal/cleanable/dirt,
/obj/effect/turf_decal/warning_stripes/box/empty,
/obj/structure/cargo_container/gorg,
/turf/open/floor,
/area/bigredv3/inside/cargo/cargobay)
"cf" = (
/obj/machinery/atmospherics/pipe/simple/green/hidden{
	dir = 4
	},
/obj/structure/cable,
/turf/open/floor,
/area/bigredv3/inside/cargo/cargobay)
"cq" = (
/obj/machinery/atmospherics/pipe/simple/green/hidden,
/turf/open/floor,
/area/bigredv3/inside/cargo/cargobay)
"cD" = (
/obj/structure/window/framed/colony,
/turf/open/floor/plating,
/area/bigredv3/inside/wall)
"dx" = (
/turf/closed/wall,
/area/bigredv3/inside/wall)
"eS" = (
/turf/closed/wall/r_wall,
/area/bigredv3/inside/wall)
"fe" = (
/obj/effect/spawner/random/misc/structure/supplycrate/normalweighted,
/obj/effect/decal/cleanable/dirt,
/turf/open/floor,
/area/bigredv3/inside/cargo/cargobay)
"fj" = (
/obj/effect/spawner/random/engineering/structure/tank/fuelweighted,
/turf/open/floor,
/area/bigredv3/inside/cargo/cargobay)
"fl" = (
/obj/structure/cargo_container/hd_blue{
	dir = 1
	},
/turf/open/floor,
/area/bigredv3/inside/cargo/cargobay)
"gg" = (
/obj/effect/decal/cleanable/dirt,
/obj/effect/spawner/random/engineering/structure/tank/fuelweighted,
/turf/open/floor/marking/bot,
/area/bigredv3/inside/cargo/cargobay)
"hf" = (
/obj/structure/table,
/obj/effect/spawner/random/engineering/bomb_supply,
/obj/effect/spawner/random/engineering/tool,
/obj/effect/spawner/random/engineering/tool,
/obj/machinery/light{
	dir = 4
	},
/turf/open/floor,
/area/bigredv3/inside/cargo/cargobay)
"hG" = (
/obj/effect/decal/cleanable/dirt,
/obj/machinery/atmospherics/pipe/simple/green/hidden,
/obj/structure/cable,
/turf/open/floor,
/area/bigredv3/inside/cargo/cargobay)
"hM" = (
/obj/machinery/atmospherics/pipe/simple/green/hidden,
/obj/effect/spawner/random/misc/structure/supplycrate/normalweighted,
/obj/structure/cable,
/turf/open/floor,
/area/bigredv3/inside/cargo/cargobay)
"hS" = (
/turf/open/floor/marking/bot,
/area/bigredv3/inside/cargo/cargobay)
"iZ" = (
/obj/structure/cargo_container/ch_green{
	dir = 4
	},
/turf/open/floor/marking/bot,
/area/bigredv3/inside/cargo/cargobay)
"jd" = (
/obj/machinery/atmospherics/pipe/simple/green/hidden,
/obj/effect/ai_node,
/obj/structure/cable,
/turf/open/floor,
/area/bigredv3/inside/cargo/cargobay)
"la" = (
/obj/machinery/computer/ordercomp,
/turf/open/floor,
/area/bigredv3/inside/cargo/cargobay)
"li" = (
/obj/machinery/atmospherics/pipe/simple/green/hidden,
/obj/machinery/door/airlock/mainship/engineering/free_access{
	dir = 1;
	name = "\improper Cargo Bay Quartermaster"
	},
/turf/open/floor,
/area/bigredv3/inside/cargo/cargobay)
"lj" = (
/obj/machinery/atmospherics/pipe/simple/green/hidden{
	dir = 4
	},
/obj/effect/ai_node,
/obj/effect/decal/cleanable/dirt,
/turf/open/floor,
/area/bigredv3/inside/cargo/cargobay)
"lz" = (
/obj/effect/spawner/random/misc/structure/barrel,
/turf/open/floor,
/area/bigredv3/inside/cargo/cargobay)
"lA" = (
/obj/effect/decal/cleanable/dirt,
/turf/open/floor,
/area/bigredv3/inside/cargo/cargobay)
"lI" = (
/obj/structure/window/framed/colony,
/obj/machinery/door/poddoor/shutters/mainship{
	dir = 2;
	id = "Cargonia";
	name = "\improper Cargo Shutters"
	},
/turf/open/floor/plating,
/area/bigredv3/inside/wall)
"nn" = (
/obj/machinery/atmospherics/pipe/simple/green/hidden{
	dir = 4
	},
/obj/machinery/light,
/obj/structure/cable,
/turf/open/floor,
/area/bigredv3/inside/cargo/cargobay)
"nH" = (
/obj/effect/spawner/random/misc/structure/supplycrate,
/turf/open/floor,
/area/bigredv3/inside/cargo/cargobay)
"nS" = (
/obj/machinery/atmospherics/pipe/simple/green/hidden{
	dir = 4
	},
/turf/open/floor,
/area/bigredv3/inside/cargo/cargobay)
"nX" = (
/obj/machinery/door/airlock/multi_tile/mainship/generic{
	name = "\improper Engineering Complex"
	},
/turf/open/floor/tile/dark,
/area/bigredv3/inside/cargo/cargobay)
"oo" = (
/obj/machinery/light,
/turf/open/floor,
/area/bigredv3/inside/cargo/cargobay)
"or" = (
/obj/machinery/door_control{
	dir = 8;
	id = "Cargonia";
	name = "Storm Shutters"
	},
/turf/open/floor,
/area/bigredv3/inside/cargo/cargobay)
"ou" = (
/obj/effect/decal/cleanable/dirt,
/obj/effect/spawner/random/misc/structure/barrel,
/turf/open/floor/marking/bot,
/area/bigredv3/inside/cargo/cargobay)
"pt" = (
/obj/effect/turf_decal/warning_stripes/box/empty,
/obj/structure/cargo_container/gorg,
/turf/open/floor,
/area/bigredv3/inside/cargo/cargobay)
"pE" = (
/obj/effect/decal/cleanable/dirt,
/obj/machinery/atmospherics/pipe/simple/green/hidden{
	dir = 4
	},
/obj/effect/ai_node,
/obj/structure/cable,
/turf/open/floor,
/area/bigredv3/inside/cargo/cargobay)
"pF" = (
/obj/machinery/atmospherics/pipe/manifold/green/hidden{
	dir = 1
	},
/obj/effect/ai_node,
/obj/structure/cable,
/turf/open/floor,
/area/bigredv3/inside/cargo/cargobay)
"pI" = (
/obj/effect/decal/cleanable/dirt,
/obj/effect/spawner/random/misc/structure/supplycrate,
/turf/open/floor,
/area/bigredv3/inside/cargo/cargobay)
"pV" = (
/obj/machinery/atmospherics/pipe/manifold/green/hidden{
	dir = 1
	},
/obj/structure/cable,
/turf/open/floor,
/area/bigredv3/inside/cargo/cargobay)
"qP" = (
/obj/structure/closet/crate/trashcart,
/turf/open/floor/marking/bot,
/area/bigredv3/inside/cargo/cargobay)
"qU" = (
/obj/structure/cargo_container/nt{
	dir = 4
	},
/turf/open/floor/marking/bot,
/area/bigredv3/inside/cargo/cargobay)
"rB" = (
/obj/structure/cargo_container/ch_green{
	dir = 1
	},
/turf/open/floor,
/area/bigredv3/inside/cargo/cargobay)
"sR" = (
/obj/item/flashlight,
/obj/item/reagent_containers/spray/cleaner,
/turf/open/floor,
/area/bigredv3/inside/cargo/cargobay)
"ts" = (
/obj/structure/table,
/obj/effect/spawner/random/engineering/tech_supply,
/obj/effect/spawner/random/engineering/tool,
/obj/effect/spawner/random/engineering/tool,
/turf/open/floor,
/area/bigredv3/inside/cargo/cargobay)
"uf" = (
/turf/open/floor/marking/loadingarea,
/area/bigredv3/inside/cargo/cargobay)
"uR" = (
/obj/machinery/prop/autolathe,
/turf/open/floor,
/area/bigredv3/inside/cargo/cargobay)
"uY" = (
/turf/open/floor/marking/delivery,
/area/bigredv3/inside/cargo/cargobay)
"vw" = (
/obj/structure/filingcabinet,
/turf/open/floor,
/area/bigredv3/inside/cargo/cargobay)
"vM" = (
/obj/effect/decal/cleanable/dirt,
/obj/machinery/atmospherics/pipe/simple/green/hidden{
	dir = 5
	},
/obj/structure/cable,
/turf/open/floor,
/area/bigredv3/inside/cargo/cargobay)
"vU" = (
/obj/structure/cargo_container/hd_blue{
	dir = 4
	},
/turf/open/floor/marking/bot,
/area/bigredv3/inside/cargo/cargobay)
"wh" = (
/obj/structure/cargo_container/green{
	dir = 4
	},
/turf/open/floor/marking/bot,
/area/bigredv3/inside/cargo/cargobay)
"wn" = (
/obj/effect/decal/cleanable/dirt,
/obj/effect/decal/cleanable/dirt,
/turf/open/floor,
/area/bigredv3/inside/cargo/cargobay)
"wH" = (
/obj/effect/decal/cleanable/dirt,
/obj/machinery/atmospherics/pipe/simple/green/hidden,
/obj/effect/ai_node,
/turf/open/floor,
/area/bigredv3/inside/cargo/cargobay)
"xB" = (
/obj/machinery/light{
	dir = 1
	},
/obj/effect/spawner/random/misc/structure/supplycrate,
/turf/open/floor,
/area/bigredv3/inside/cargo/cargobay)
"xE" = (
/obj/structure/cargo_container/ch_green,
/turf/open/floor/marking/bot,
/area/bigredv3/inside/cargo/cargobay)
"xO" = (
/obj/item/reagent_containers/glass/bottle/tramadol,
/turf/open/floor,
/area/bigredv3/inside/cargo/cargobay)
"yl" = (
/obj/machinery/door/airlock/mainship/engineering/free_access{
	name = "\improper Cargo Bay Quartermaster"
	},
/turf/open/floor,
/area/bigredv3/inside/cargo/cargobay)
"yP" = (
/obj/effect/turf_decal/warning_stripes/box/empty,
/obj/structure/cargo_container/gorg{
	dir = 4
	},
/turf/open/floor,
/area/bigredv3/inside/cargo/cargobay)
"zb" = (
/obj/machinery/atmospherics/components/unary/vent_pump{
	dir = 1;
	on = 1
	},
/obj/effect/ai_node,
/turf/open/floor,
/area/bigredv3/inside/cargo/cargobay)
"zT" = (
/obj/machinery/atmospherics/components/unary/vent_pump{
	on = 1
	},
/turf/open/floor,
/area/bigredv3/inside/cargo/cargobay)
"BG" = (
/obj/effect/decal/cleanable/blood,
/turf/open/floor,
/area/bigredv3/inside/cargo/cargobay)
"BP" = (
/obj/item/reagent_containers/spray/cleaner,
/obj/machinery/atmospherics/pipe/simple/green/hidden,
/turf/open/floor,
/area/bigredv3/inside/cargo/cargobay)
"CI" = (
/obj/machinery/door/airlock/multi_tile/mainship/generic{
	dir = 1;
	name = "\improper Cargo Bay"
	},
/turf/open/floor,
/area/bigredv3/inside/cargo/cargobay)
"Et" = (
/obj/effect/decal/cleanable/dirt,
/turf/open/floor/marking/bot,
/area/bigredv3/inside/cargo/cargobay)
"EI" = (
/obj/effect/spawner/random/misc/structure/supplycrate/normalweighted,
/turf/open/floor/marking/bot,
/area/bigredv3/inside/cargo/cargobay)
"Fu" = (
/obj/structure/filingcabinet,
/obj/machinery/light{
	dir = 1
	},
/turf/open/floor,
/area/bigredv3/inside/cargo/cargobay)
"FA" = (
/obj/effect/decal/cleanable/dirt,
/obj/effect/turf_decal/warning_stripes/box/empty,
/obj/structure/cargo_container/gorg{
	dir = 4
	},
/turf/open/floor,
/area/bigredv3/inside/cargo/cargobay)
"FH" = (
/obj/effect/ai_node,
/turf/open/floor/marking/delivery,
/area/bigredv3/inside/cargo/cargobay)
"FX" = (
/obj/structure/cargo_container/nt,
/turf/open/floor/marking/bot,
/area/bigredv3/inside/cargo/cargobay)
"Gu" = (
/obj/effect/decal/cleanable/dirt,
/obj/item/megaphone,
/turf/open/floor,
/area/bigredv3/inside/cargo/cargobay)
"GC" = (
/obj/machinery/light{
	dir = 8
	},
/turf/open/floor,
/area/bigredv3/inside/cargo/cargobay)
"Hu" = (
/obj/machinery/atmospherics/pipe/simple/green/hidden,
/obj/effect/decal/cleanable/dirt,
/turf/open/floor,
/area/bigredv3/inside/cargo/cargobay)
"Hw" = (
/obj/structure/cargo_container/hd_blue,
/turf/open/floor/marking/bot,
/area/bigredv3/inside/cargo/cargobay)
"HW" = (
/obj/structure/bed/chair/office/dark,
/turf/open/floor,
/area/bigredv3/inside/cargo/cargobay)
"Ik" = (
/obj/machinery/light{
	dir = 1
	},
/turf/open/floor,
/area/bigredv3/inside/cargo/cargobay)
"Iw" = (
/obj/structure/cargo_container/gorg,
/turf/open/floor/marking/bot,
/area/bigredv3/inside/cargo/cargobay)
"IE" = (
/obj/effect/turf_decal/warning_stripes/box/small{
	dir = 4
	},
/obj/effect/turf_decal/warning_stripes/box/arrow{
	dir = 4
	},
/turf/open/floor,
/area/bigredv3/inside/cargo/cargobay)
"IF" = (
/obj/effect/ai_node,
/turf/open/floor,
/area/bigredv3/inside/cargo/cargobay)
"IP" = (
/obj/structure/table,
/obj/effect/spawner/random/engineering/toolbox,
/turf/open/floor,
/area/bigredv3/inside/cargo/cargobay)
"Jd" = (
/turf/open/floor/plating,
/area/bigredv3/inside/cargo/cargobay)
"Je" = (
/obj/effect/decal/cleanable/dirt,
/obj/structure/closet/crate/trashcart,
/turf/open/floor/marking/bot,
/area/bigredv3/inside/cargo/cargobay)
"Jf" = (
/obj/effect/spawner/random/engineering/tool,
/turf/open/floor,
/area/bigredv3/inside/cargo/cargobay)
"Jg" = (
/obj/structure/table,
/obj/effect/spawner/random/engineering/bomb_supply,
/obj/effect/spawner/random/engineering/bomb_supply,
/obj/effect/spawner/random/engineering/tool,
/turf/open/floor,
/area/bigredv3/inside/cargo/cargobay)
"Ji" = (
/obj/effect/spawner/random/misc/structure/supplycrate/normalweighted,
/turf/open/floor,
/area/bigredv3/inside/cargo/cargobay)
"Js" = (
/obj/structure/table,
/turf/open/floor,
/area/bigredv3/inside/cargo/cargobay)
"JL" = (
/obj/effect/decal/cleanable/dirt,
/obj/effect/ai_node,
/turf/open/floor,
/area/bigredv3/inside/cargo/cargobay)
"JU" = (
/obj/effect/decal/cleanable/dirt,
/obj/effect/decal/cleanable/dirt,
/obj/effect/ai_node,
/turf/open/floor,
/area/bigredv3/inside/cargo/cargobay)
"KD" = (
/obj/machinery/atmospherics/pipe/simple/green/hidden{
	dir = 4
	},
/obj/machinery/door/airlock/mainship/security/glass/free_access{
	name = "\improper Cargo Bay Security"
	},
/turf/open/floor,
/area/bigredv3/inside/cargo/cargobay)
"LD" = (
/obj/effect/spawner/random/misc/structure/supplycrate/normalweighted,
/turf/open/floor/marking/loadingarea,
/area/bigredv3/inside/cargo/cargobay)
"Mw" = (
/obj/structure/closet/emcloset,
/turf/open/floor,
/area/bigredv3/inside/cargo/cargobay)
"NF" = (
/obj/structure/cable,
/turf/open/floor,
/area/bigredv3/inside/cargo/cargobay)
"NZ" = (
/obj/machinery/atmospherics/pipe/simple/green/hidden,
/obj/structure/cable,
/turf/open/floor,
/area/bigredv3/inside/cargo/cargobay)
"Op" = (
/obj/structure/table,
/obj/effect/spawner/random/engineering/tool,
/turf/open/floor,
/area/bigredv3/inside/cargo/cargobay)
"Ov" = (
/obj/structure/table,
/obj/effect/spawner/random/engineering/bomb_supply,
/obj/effect/spawner/random/engineering/bomb_supply,
/turf/open/floor,
/area/bigredv3/inside/cargo/cargobay)
"OL" = (
/obj/machinery/power/apc/weak/ntf,
/obj/structure/cable,
/turf/open/floor,
/area/bigredv3/inside/cargo/cargobay)
"Pf" = (
/obj/effect/decal/cleanable/dirt,
/obj/machinery/atmospherics/pipe/manifold/green/hidden{
	dir = 8
	},
/turf/open/floor,
/area/bigredv3/inside/cargo/cargobay)
"PF" = (
/obj/effect/decal/cleanable/dirt,
/obj/effect/spawner/random/misc/structure/supplycrate/normalweighted,
/turf/open/floor,
/area/bigredv3/inside/cargo/cargobay)
"Qn" = (
/obj/machinery/light{
	dir = 4
	},
/turf/open/floor,
/area/bigredv3/inside/cargo/cargobay)
"QV" = (
/obj/structure/cargo_container/nt{
	dir = 1
	},
/turf/open/floor,
/area/bigredv3/inside/cargo/cargobay)
"Sh" = (
/obj/effect/decal/cleanable/dirt,
/obj/machinery/atmospherics/components/unary/vent_pump{
	dir = 4;
	on = 1
	},
/turf/open/floor,
/area/bigredv3/inside/cargo/cargobay)
"TG" = (
/obj/effect/decal/cleanable/dirt,
/obj/item/tool/lighter/random,
/turf/open/floor,
/area/bigredv3/inside/cargo/cargobay)
"Ut" = (
/obj/effect/turf_decal/warning_stripes/box/small{
	dir = 8
	},
/obj/effect/turf_decal/warning_stripes/box/arrow{
	dir = 8
	},
/turf/open/floor,
/area/bigredv3/inside/cargo/cargobay)
"VF" = (
/obj/effect/decal/cleanable/dirt,
/obj/structure/cargo_container/green,
/turf/open/floor/marking/bot,
/area/bigredv3/inside/cargo/cargobay)
"Wb" = (
/turf/open/floor,
/area/bigredv3/inside/cargo/cargobay)
"WM" = (
/turf/closed/wall,
/area/bigredv3/inside/cargo/cargobay)
"Xm" = (
/obj/effect/decal/cleanable/dirt,
/obj/effect/ai_node,
/obj/machinery/light{
	dir = 8
	},
/turf/open/floor,
/area/bigredv3/inside/cargo/cargobay)
"ZE" = (
/obj/effect/decal/cleanable/dirt,
/obj/machinery/atmospherics/pipe/simple/green/hidden{
	dir = 4
	},
/obj/structure/cable,
/turf/open/floor,
/area/bigredv3/inside/cargo/cargobay)
"ZF" = (
/obj/effect/turf_decal/warning_stripes/box/empty,
/turf/open/floor,
/area/bigredv3/inside/cargo/cargobay)
"ZT" = (
/obj/effect/decal/cleanable/dirt,
/obj/effect/spawner/random/misc/structure/supplycrate/normalweighted,
/turf/open/floor/marking/bot,
/area/bigredv3/inside/cargo/cargobay)

(1,1,1) = {"
Jd
Jd
Jd
eS
bK
bK
bK
eS
dx
dx
cf
CI
dx
dx
dx
dx
yl
dx
dx
"}
(2,1,1) = {"
FH
uY
uY
GC
Wb
Wb
Wb
Wb
Wb
Wb
cf
Wb
Wb
GC
dx
Ik
Wb
ts
dx
"}
(3,1,1) = {"
Jf
Wb
Wb
uf
xE
ou
hS
FX
Iw
Wb
bE
Wb
Wb
Wb
dx
Wb
HW
Op
lI
"}
(4,1,1) = {"
NZ
NZ
vM
Wb
rB
PF
Wb
QV
ad
Wb
pV
wH
BP
cq
li
cq
zb
Op
lI
"}
(5,1,1) = {"
Ji
Wb
cf
uf
iZ
gg
hS
qU
qP
Wb
cf
Wb
lA
pI
cD
vw
lA
la
lI
"}
(6,1,1) = {"
lA
BG
pV
hM
NZ
NZ
NZ
hG
NZ
NZ
bm
Qn
lA
lA
cD
vw
Wb
Wb
lI
"}
(7,1,1) = {"
fe
Wb
nS
uf
EI
Je
hS
ZT
hS
Wb
nn
WM
xB
Wb
dx
Fu
Wb
Wb
dx
"}
(8,1,1) = {"
Wb
Wb
nS
Wb
lA
lA
IF
lA
Wb
Wb
cf
Xm
Wb
nH
dx
cD
yl
cD
eS
"}
(9,1,1) = {"
Wb
Wb
nS
uf
Et
Hw
hS
VF
hS
Wb
cf
Gu
Wb
Wb
fj
Wb
Wb
oo
eS
"}
(10,1,1) = {"
Wb
Wb
nS
Wb
Wb
fl
Wb
at
lz
zT
bm
Wb
Wb
Wb
Wb
lA
Wb
Wb
nX
"}
(11,1,1) = {"
Wb
Wb
bH
LD
hS
vU
hS
wh
EI
Wb
pF
NZ
NZ
NZ
NZ
NZ
jd
NZ
ba
"}
(12,1,1) = {"
bw
Mw
Mw
Wb
Wb
Wb
Wb
Wb
Wb
Wb
ZE
JU
xO
Wb
Wb
Wb
Wb
bR
eS
"}
(13,1,1) = {"
dx
dx
dx
dx
cD
cD
cD
dx
Ik
Wb
ZE
wn
IE
Wb
IE
lA
Wb
bR
eS
"}
(14,1,1) = {"
Js
Js
uR
dx
Wb
Wb
Wb
dx
OL
NF
ZE
wn
ZF
Wb
bX
lA
Wb
IP
eS
"}
(15,1,1) = {"
JL
Sh
oo
dx
lA
lA
fj
dx
Wb
lA
ZE
lA
pt
Wb
FA
Wb
Wb
Op
eS
"}
(16,1,1) = {"
lA
aw
cq
ar
Hu
Pf
cq
ar
cq
Hu
bm
lA
yP
Wb
pt
Wb
Wb
aU
eS
"}
(17,1,1) = {"
IF
TG
lA
Wb
lA
lj
Wb
Wb
Wb
lA
pE
Wb
ZF
IF
yP
Wb
Wb
Jg
eS
"}
(18,1,1) = {"
Wb
Wb
Wb
dx
Ik
nS
Wb
dx
Wb
sR
cf
Wb
Ut
Wb
Ut
Wb
Wb
Ov
eS
"}
(19,1,1) = {"
cD
cD
dx
dx
cD
KD
cD
dx
Wb
Wb
cf
hf
or
Wb
fj
fj
fj
aV
eS
"}
