//MAP CONVERTED BY dmm2tgm.py THIS HEADER COMMENT PREVENTS RECONVERSION, DO NOT REMOVE
"c" = (
/obj/effect/ai_node,
/turf/open/floor/plating/ground/mars/random/cave,
/area/bigredv2/caves/southwest)
"h" = (
/obj/effect/ai_node,
/turf/open/floor/plating/ground/mars/random/cave,
/area/bigredv2/caves/south/garbledradio)
"j" = (
/obj/effect/ai_node,
/turf/open/floor/plating/ground/mars/random/cave/rock,
/area/bigredv2/caves/southwest)
"t" = (
/turf/open/floor/plating/ground/mars/random/cave/rock,
/area/bigredv2/caves/southwest)
"u" = (
/obj/effect/landmark/lv624/fog_blocker,
/obj/effect/ai_node,
/turf/open/floor/plating/ground/mars/random/cave,
/area/bigredv2/caves/south/garbledradio)
"y" = (
/obj/effect/landmark/lv624/fog_blocker,
/turf/closed/mineral/smooth/bigred,
/area/bigredv2/caves/rock)
"z" = (
/obj/effect/landmark/lv624/fog_blocker,
/turf/open/floor/plating/ground/mars/random/cave,
/area/bigredv2/caves/southwest)
"B" = (
/obj/effect/ai_node,
/turf/open/floor/plating/ground/mars/random/cave,
/area/bigredv2/caves/south)
"G" = (
/turf/closed/mineral/smooth/bigred,
/area/bigredv2/caves/rock)
"J" = (
/turf/open/floor/plating/ground/mars/random/cave,
/area/bigredv2/caves/south)
"K" = (
/turf/open/floor/plating/ground/mars/random/cave,
/area/bigredv2/caves/southwest)
"L" = (
/turf/open/floor/plating/ground/mars/random/cave/rock,
/area/bigredv2/caves/south)
"T" = (
/obj/effect/landmark/lv624/fog_blocker,
/turf/open/floor/plating/ground/mars/random/cave,
/area/bigredv2/caves/south/garbledradio)
"V" = (
/obj/effect/landmark/excavation_site_spawner,
/obj/effect/ai_node,
/turf/open/floor/plating/ground/mars/random/cave,
/area/bigredv2/caves/south/garbledradio)
"X" = (
/turf/open/floor/plating/ground/mars/random/cave,
/area/bigredv2/caves/south/garbledradio)
"Y" = (
/turf/open/floor/plating/ground/mars/random/cave/rock,
/area/bigredv2/caves/south/garbledradio)
"Z" = (
/obj/effect/landmark/lv624/fog_blocker,
/turf/open/floor/plating/ground/mars/random/cave/rock,
/area/bigredv2/caves/southwest)

(1,1,1) = {"
y
G
G
G
G
G
t
K
K
K
t
G
G
G
G
K
K
G
G
G
G
G
"}
(2,1,1) = {"
z
G
G
G
G
G
G
K
c
K
t
G
G
G
G
K
K
K
G
G
G
G
"}
(3,1,1) = {"
z
G
G
G
G
G
G
K
K
K
t
G
G
G
t
K
K
G
G
G
G
G
"}
(4,1,1) = {"
z
G
G
G
G
G
K
K
K
K
t
G
G
G
t
K
K
G
G
G
G
G
"}
(5,1,1) = {"
z
t
G
G
G
G
K
K
K
K
K
G
G
t
K
K
K
G
G
G
G
G
"}
(6,1,1) = {"
z
t
G
G
t
t
K
K
K
K
K
G
G
K
K
c
G
G
G
G
G
G
"}
(7,1,1) = {"
z
K
t
j
K
K
K
K
c
K
G
G
G
K
c
G
G
G
G
G
G
G
"}
(8,1,1) = {"
z
K
K
t
K
K
K
K
K
G
G
G
K
K
K
G
G
G
G
G
G
G
"}
(9,1,1) = {"
z
t
K
K
K
K
K
G
G
G
G
G
K
K
K
G
G
G
G
G
G
G
"}
(10,1,1) = {"
Z
K
K
c
G
G
G
G
G
G
G
G
K
K
K
G
G
K
G
G
G
G
"}
(11,1,1) = {"
y
G
G
G
G
G
G
G
G
G
G
G
K
K
K
K
K
K
G
G
G
G
"}
(12,1,1) = {"
G
y
G
G
G
G
G
G
G
G
G
G
K
K
K
K
K
K
G
G
G
G
"}
(13,1,1) = {"
G
G
y
y
G
G
G
G
G
G
G
G
K
K
K
K
K
G
G
G
G
G
"}
(14,1,1) = {"
G
G
G
G
y
G
G
G
G
G
G
G
K
K
K
K
G
G
G
G
G
G
"}
(15,1,1) = {"
G
G
G
G
G
y
G
G
G
G
G
G
G
K
K
t
G
G
G
G
G
G
"}
(16,1,1) = {"
G
G
G
G
G
G
y
G
G
G
G
G
G
K
c
t
t
G
G
G
G
G
"}
(17,1,1) = {"
K
G
G
G
G
G
y
G
G
G
G
G
G
K
t
t
G
G
G
G
G
G
"}
(18,1,1) = {"
K
c
G
G
G
G
y
G
G
G
G
G
G
K
K
K
G
G
G
G
G
G
"}
(19,1,1) = {"
K
K
G
G
G
G
y
G
G
G
G
G
K
K
K
K
K
G
G
G
G
G
"}
(20,1,1) = {"
t
K
G
G
G
G
y
G
G
G
K
K
K
K
K
t
K
G
G
G
G
G
"}
(21,1,1) = {"
t
K
K
G
G
G
y
G
G
G
K
K
K
K
K
t
K
G
G
G
G
G
"}
(22,1,1) = {"
K
K
K
K
K
G
y
G
G
G
K
K
K
K
K
G
G
G
G
G
G
G
"}
(23,1,1) = {"
K
K
K
K
K
G
y
G
G
G
K
K
K
K
K
G
G
G
G
G
G
G
"}
(24,1,1) = {"
K
K
K
K
K
G
y
K
K
K
K
K
K
K
K
G
G
G
G
G
G
G
"}
(25,1,1) = {"
K
K
K
K
K
c
z
K
K
K
K
t
K
K
c
G
G
G
G
G
G
G
"}
(26,1,1) = {"
X
X
X
X
X
X
T
X
X
X
X
X
X
Y
G
G
G
G
G
G
G
G
"}
(27,1,1) = {"
X
h
X
X
X
h
T
X
X
G
G
G
G
G
G
G
G
G
G
G
G
G
"}
(28,1,1) = {"
Y
X
X
X
X
X
y
G
G
G
G
G
G
G
G
G
G
G
G
G
G
G
"}
(29,1,1) = {"
Y
X
X
X
X
G
y
G
G
G
G
G
G
G
G
G
X
h
X
X
G
G
"}
(30,1,1) = {"
X
X
X
X
X
G
y
G
G
G
G
G
G
G
G
G
X
X
X
X
X
G
"}
(31,1,1) = {"
X
X
X
X
X
G
y
G
G
G
G
G
G
G
G
X
X
X
X
X
J
G
"}
(32,1,1) = {"
X
X
X
X
X
G
y
G
G
G
G
G
G
G
G
X
X
X
X
X
J
J
"}
(33,1,1) = {"
X
X
X
X
X
G
y
G
G
G
G
G
G
G
G
G
X
X
X
X
J
J
"}
(34,1,1) = {"
Y
X
X
X
G
G
y
G
G
G
G
G
G
G
G
G
G
h
X
X
B
J
"}
(35,1,1) = {"
Y
X
X
X
G
G
y
G
G
G
G
G
G
G
G
G
G
X
X
X
L
J
"}
(36,1,1) = {"
Y
X
X
X
G
G
y
G
G
G
G
G
G
G
G
G
G
G
X
X
X
J
"}
(37,1,1) = {"
X
X
X
X
G
G
y
G
G
G
G
G
G
G
G
G
G
G
X
X
J
J
"}
(38,1,1) = {"
X
h
X
X
X
X
u
G
G
G
G
G
G
G
G
G
G
X
X
X
X
J
"}
(39,1,1) = {"
X
X
X
X
X
X
T
X
X
G
G
G
G
G
G
X
X
X
X
h
J
J
"}
(40,1,1) = {"
X
X
X
X
X
X
T
X
X
X
X
G
G
G
X
X
X
X
X
X
B
J
"}
(41,1,1) = {"
X
X
X
G
G
X
u
X
X
X
X
X
h
X
X
X
X
X
Y
X
X
J
"}
(42,1,1) = {"
X
X
G
G
G
G
y
X
X
X
X
X
X
X
X
X
X
X
X
V
J
J
"}
(43,1,1) = {"
X
G
G
G
G
G
y
G
G
G
G
X
h
X
Y
h
X
X
h
Y
G
G
"}
(44,1,1) = {"
G
G
G
G
G
G
y
G
G
G
G
G
X
Y
X
X
X
Y
G
G
G
G
"}
