//MAP CONVERTED BY dmm2tgm.py THIS HEADER COMMENT PREVENTS RECONVERSION, DO NOT REMOVE
"d" = (
/obj/effect/landmark/lv624/fog_blocker,
/turf/open/floor/plating/ground/mars/random/cave,
/area/bigredv2/caves/southwest)
"f" = (
/obj/effect/landmark/xeno_silo_spawn,
/turf/open/floor/plating/ground/mars/random/cave,
/area/bigredv2/caves/southwest)
"j" = (
/obj/effect/landmark/lv624/fog_blocker/xeno_spawn,
/turf/closed/mineral/smooth/bigred,
/area/bigredv2/caves/rock)
"s" = (
/turf/open/floor/plating/ground/mars/random/cave,
/area/bigredv2/caves/southwest)
"t" = (
/turf/closed/mineral/smooth/bigred/indestructible,
/area/space)
"y" = (
/obj/effect/ai_node,
/turf/open/floor/plating/ground/mars/random/cave,
/area/bigredv2/caves/southwest)
"B" = (
/obj/effect/landmark/lv624/fog_blocker/xeno_spawn,
/turf/open/floor/plating/ground/mars/random/cave,
/area/bigredv2/caves/southwest)
"E" = (
/obj/effect/ai_node,
/turf/open/floor/plating/ground/mars/random/cave/rock,
/area/bigredv2/caves/southwest)
"H" = (
/obj/effect/landmark/patrol_point/som/som_11,
/turf/open/floor/plating/ground/mars/random/cave,
/area/bigredv2/caves/southwest)
"J" = (
/obj/effect/landmark/excavation_site_spawner,
/turf/open/floor/plating/ground/mars/random/cave,
/area/bigredv2/caves/southwest)
"L" = (
/turf/open/floor/plating/ground/mars/random/cave/rock,
/area/bigredv2/caves/southwest)
"M" = (
/obj/effect/landmark/lv624/fog_blocker,
/turf/closed/mineral/smooth/bigred,
/area/bigredv2/caves/rock)
"N" = (
/obj/effect/landmark/xeno_tunnel_spawn,
/turf/open/floor/plating/ground/mars/random/cave,
/area/bigredv2/caves/southwest)
"P" = (
/turf/closed/mineral/smooth/bigred,
/area/bigredv2/caves/rock)
"W" = (
/obj/effect/landmark/excavation_site_spawner,
/obj/effect/ai_node,
/turf/open/floor/plating/ground/mars/random/cave,
/area/bigredv2/caves/southwest)

(1,1,1) = {"
t
t
t
t
t
t
t
t
t
t
t
t
t
t
t
t
t
t
t
t
t
t
t
t
t
t
t
t
t
t
t
t
t
t
t
t
t
t
t
t
t
t
t
"}
(2,1,1) = {"
P
P
P
P
P
P
P
P
P
P
P
P
j
P
P
P
P
P
P
P
P
P
P
P
P
P
P
P
P
P
P
P
P
P
P
t
t
t
t
t
t
t
t
"}
(3,1,1) = {"
P
P
P
P
P
P
P
P
P
P
P
P
j
P
P
P
P
P
P
P
P
P
P
P
P
P
P
P
P
P
P
P
P
P
P
t
t
t
t
t
t
t
t
"}
(4,1,1) = {"
P
P
P
P
P
P
P
P
P
P
P
P
j
P
P
P
P
P
P
P
P
P
P
P
P
P
P
P
P
P
P
P
P
P
P
t
t
t
t
t
t
t
t
"}
(5,1,1) = {"
P
P
P
P
P
P
P
P
P
P
P
P
j
P
P
P
P
P
P
P
P
P
P
P
P
P
P
P
P
P
P
P
P
P
P
t
t
t
t
t
t
t
t
"}
(6,1,1) = {"
P
P
P
P
P
P
P
P
P
P
P
P
j
P
P
P
P
s
L
L
L
L
L
P
P
P
P
P
P
P
P
P
P
P
P
t
t
t
t
t
t
t
t
"}
(7,1,1) = {"
P
P
P
P
s
s
s
s
s
P
P
P
j
P
P
L
s
s
s
s
s
s
N
L
P
P
P
P
P
P
P
P
P
P
P
t
t
t
t
t
t
t
t
"}
(8,1,1) = {"
P
P
s
s
s
s
s
s
s
s
s
P
j
P
L
s
s
s
s
s
s
s
s
L
P
P
P
P
P
P
P
P
P
P
P
t
t
t
t
t
t
t
t
"}
(9,1,1) = {"
P
s
s
s
s
s
s
s
s
s
s
s
B
s
s
s
s
s
s
s
f
s
s
L
P
P
P
P
P
P
P
P
P
P
P
t
t
t
t
t
t
t
t
"}
(10,1,1) = {"
s
s
y
s
s
s
s
s
s
s
s
y
B
s
s
y
s
s
s
s
y
s
s
s
L
P
P
P
P
P
P
P
P
P
P
t
t
t
t
t
t
t
t
"}
(11,1,1) = {"
s
s
s
s
s
s
s
s
s
s
s
s
B
s
s
s
s
s
s
s
s
s
s
s
L
P
P
P
P
P
P
P
P
P
P
t
t
t
t
t
t
t
t
"}
(12,1,1) = {"
s
s
s
s
s
s
s
s
s
s
P
P
j
s
s
s
s
s
s
s
s
s
s
s
s
s
s
P
P
P
P
P
P
P
P
t
t
t
t
t
t
t
t
"}
(13,1,1) = {"
s
L
E
P
P
P
P
P
P
P
P
P
j
s
s
s
s
s
s
s
s
s
s
s
s
s
s
P
P
P
P
P
P
P
P
t
t
t
t
t
t
t
t
"}
(14,1,1) = {"
s
s
L
P
P
P
P
P
P
P
P
P
j
s
s
s
s
s
s
s
s
s
s
s
s
s
s
L
P
P
P
P
P
P
P
t
t
t
t
t
t
t
t
"}
(15,1,1) = {"
s
s
s
L
L
P
P
P
P
P
P
P
j
L
s
s
s
s
s
H
s
s
s
s
s
s
s
s
P
P
P
P
P
P
P
t
t
t
t
t
t
t
t
"}
(16,1,1) = {"
s
s
s
s
L
P
P
P
P
P
P
P
j
P
s
y
s
s
s
s
y
s
s
s
s
y
s
s
P
P
P
P
P
P
P
t
t
t
t
t
t
t
t
"}
(17,1,1) = {"
s
s
s
s
L
P
P
P
P
P
P
P
j
P
s
s
s
s
s
J
s
s
s
s
s
s
s
L
P
P
P
P
P
P
P
t
t
t
t
t
t
t
t
"}
(18,1,1) = {"
s
s
s
s
L
P
P
P
P
P
P
P
j
P
s
s
s
s
s
s
s
s
s
s
s
s
P
P
P
P
P
P
P
P
P
t
t
t
t
t
t
t
t
"}
(19,1,1) = {"
s
s
y
s
E
P
P
P
P
P
P
P
j
j
B
B
B
B
s
s
s
s
s
L
s
s
P
P
P
P
P
P
P
P
P
t
t
t
t
t
t
t
t
"}
(20,1,1) = {"
P
s
s
s
s
L
P
P
P
P
P
L
L
L
s
s
s
B
s
s
s
s
s
L
s
s
s
P
P
P
P
P
P
P
P
t
t
t
t
t
t
t
t
"}
(21,1,1) = {"
P
P
P
s
s
L
P
P
P
P
P
L
s
s
s
s
s
B
s
s
s
s
L
s
s
s
s
P
P
P
P
P
P
P
P
t
t
t
t
t
t
t
t
"}
(22,1,1) = {"
P
P
P
s
s
s
L
s
P
P
P
s
y
s
s
y
L
j
L
s
s
s
L
P
P
s
s
P
P
P
P
P
P
P
P
t
t
t
t
t
t
t
t
"}
(23,1,1) = {"
P
P
P
s
s
s
s
s
s
P
s
s
s
s
s
L
P
j
j
j
j
j
j
j
j
B
B
B
j
j
j
j
j
j
j
t
t
t
t
t
t
t
t
"}
(24,1,1) = {"
P
P
P
s
s
s
s
s
L
s
s
L
s
s
s
L
P
P
P
P
P
P
P
P
s
s
s
s
P
P
P
P
P
P
P
t
t
t
t
t
t
t
t
"}
(25,1,1) = {"
P
P
P
L
s
s
s
s
s
s
L
s
s
s
s
P
P
P
P
P
P
P
P
P
s
y
s
s
P
P
P
P
P
P
P
t
t
t
t
t
t
t
t
"}
(26,1,1) = {"
P
P
P
P
y
s
s
s
s
s
s
s
L
s
s
P
P
P
P
P
P
P
P
P
P
s
y
s
P
P
P
P
P
P
P
t
t
t
t
t
t
t
t
"}
(27,1,1) = {"
P
P
P
s
s
y
s
s
s
s
s
s
y
s
s
P
P
P
P
P
P
P
P
P
P
s
s
s
s
P
P
P
P
P
P
t
t
t
t
t
t
t
t
"}
(28,1,1) = {"
P
P
s
s
s
s
s
s
s
s
s
s
s
s
L
P
P
P
P
P
P
P
P
P
P
P
s
s
s
P
P
P
P
P
P
t
t
t
t
t
t
t
t
"}
(29,1,1) = {"
P
P
s
s
s
s
s
s
s
s
s
s
s
s
s
P
P
P
P
P
P
P
P
P
P
P
s
s
s
P
P
P
P
P
P
t
t
t
t
t
t
t
t
"}
(30,1,1) = {"
P
s
s
s
s
s
s
s
s
L
P
L
y
s
s
s
P
P
P
P
P
P
P
P
P
P
s
s
s
s
P
P
P
P
P
t
t
t
t
t
t
t
t
"}
(31,1,1) = {"
P
s
s
s
s
s
s
s
s
L
P
P
L
y
s
s
s
P
P
P
P
P
P
P
P
P
E
s
s
s
P
P
P
P
P
t
t
t
t
t
t
t
t
"}
(32,1,1) = {"
P
s
y
s
s
y
P
s
s
L
P
P
P
s
y
s
s
y
s
P
P
P
P
P
P
P
L
E
s
s
P
P
P
P
P
t
t
t
t
t
t
t
t
"}
(33,1,1) = {"
P
s
s
s
P
P
P
L
L
P
P
P
P
s
s
s
s
s
s
s
L
P
P
P
P
P
P
L
y
s
s
P
P
P
P
t
t
t
t
t
t
t
t
"}
(34,1,1) = {"
P
s
s
s
P
P
P
P
P
P
P
P
P
P
s
s
s
s
s
s
s
L
P
P
P
P
P
P
s
s
s
s
P
P
P
t
t
t
t
t
t
t
t
"}
(35,1,1) = {"
P
s
s
s
P
P
P
P
P
P
P
P
P
s
s
s
s
s
s
s
L
P
P
P
P
P
P
P
s
s
s
P
P
P
P
t
t
t
t
t
t
t
t
"}
(36,1,1) = {"
P
s
s
s
P
P
P
P
P
P
P
P
P
L
s
s
s
s
s
s
L
P
P
P
P
P
P
P
s
s
s
P
P
P
P
t
t
t
t
t
t
t
t
"}
(37,1,1) = {"
s
s
s
s
P
P
P
P
P
P
P
P
P
P
P
P
s
W
s
s
s
E
P
P
P
P
P
P
s
J
s
P
P
P
P
t
t
t
t
t
t
t
t
"}
(38,1,1) = {"
s
s
s
s
P
P
P
P
P
P
P
P
P
P
P
P
s
s
s
s
s
L
P
P
P
P
L
L
s
s
s
P
P
P
P
t
t
t
t
t
t
t
t
"}
(39,1,1) = {"
s
s
s
s
P
P
P
P
P
P
P
P
P
P
P
P
L
s
s
s
s
L
P
P
P
P
L
L
s
s
P
P
P
P
P
t
t
t
t
t
t
t
t
"}
(40,1,1) = {"
s
s
s
s
P
P
P
P
P
P
P
P
P
P
P
P
P
P
P
s
s
s
L
L
P
P
P
P
s
s
P
P
P
P
P
t
t
t
t
t
t
t
t
"}
(41,1,1) = {"
d
d
d
M
M
M
M
M
M
M
M
M
M
M
P
P
P
P
P
s
s
s
s
L
P
P
P
P
s
s
P
P
P
P
P
t
t
t
t
t
t
t
t
"}
