//MAP CONVERTED BY dmm2tgm.py THIS HEADER COMMENT PREVENTS RECONVERSION, DO NOT REMOVE
"aq" = (
/obj/effect/landmark/lv624/fog_blocker,
/turf/open/floor/plating/ground/mars/random/cave/rock,
/area/bigredv3/outside/directions/s)
"ar" = (
/obj/structure/cable,
/turf/open/floor/marking/asteroidwarning,
/area/bigredv3/outside/directions/se)
"az" = (
/turf/closed/wall,
/area/bigredv3/inside/wall)
"bj" = (
/turf/open/floor/plating/ground/mars/random/cave,
/area/bigredv3/outside/directions/se)
"bN" = (
/obj/structure/window/framed/colony/reinforced,
/obj/effect/forcefield/allow_bullet_travel,
/turf/open/floor/plating,
/area/bigredv3/inside/wall)
"cY" = (
/turf/open/floor/plating/ground/mars/dirttosand/autosmooth{
	dir = 9
	},
/area/bigredv3/outside/directions/s)
"di" = (
/obj/effect/ai_node,
/turf/open/floor/plating/ground/mars/random/cave,
/area/bigredv3/outside/directions/s)
"dq" = (
/obj/structure/cable,
/obj/machinery/atmospherics/pipe/simple/green/hidden{
	dir = 4
	},
/obj/effect/ai_node,
/turf/open/floor,
/area/bigredv3/inside/engi/east)
"dV" = (
/obj/structure/window/framed/colony,
/obj/machinery/door/poddoor/shutters/mainship{
	dir = 2;
	id = "Filtration Plant";
	name = "\improper Filtration Plant Shutters"
	},
/turf/open/floor/plating,
/area/bigredv3/inside/wall)
"dZ" = (
/obj/machinery/power/geothermal,
/obj/structure/cable,
/turf/open/floor/plating,
/area/bigredv3/inside/engi/east)
"ef" = (
/turf/open/floor/plating/ground/mars/random/dirt,
/area/bigredv3/outside/directions/se)
"eu" = (
/obj/machinery/power/geothermal,
/obj/structure/cable,
/obj/machinery/light{
	dir = 4
	},
/turf/open/floor/plating,
/area/bigredv3/inside/engi/east)
"fc" = (
/obj/effect/ai_node,
/obj/structure/window/framed/colony,
/obj/machinery/door/poddoor/shutters/mainship{
	id = "Filtration Plant";
	name = "\improper Filtration Plant Shutters"
	},
/turf/open/floor/plating,
/area/bigredv3/inside/wall)
"fK" = (
/obj/machinery/atmospherics/pipe/simple/green/hidden{
	dir = 4
	},
/obj/effect/ai_node,
/obj/structure/cable,
/turf/open/floor/marking/asteroidwarning,
/area/bigredv3/outside/directions/s)
"fO" = (
/turf/open/floor/marking/asteroidwarning{
	dir = 4
	},
/area/bigredv3/outside/directions/se)
"gp" = (
/obj/item/clothing/head/warning_cone,
/turf/open/floor/asteroidfloor,
/area/bigredv3/outside/directions/se)
"gW" = (
/obj/effect/spawner/random/engineering/structure/tank/waterweighted,
/turf/open/floor,
/area/bigredv3/inside/engi/east)
"ik" = (
/turf/open/floor/plating/ground/mars/random/sand,
/area/bigredv3/outside/directions/se)
"jb" = (
/obj/machinery/floodlight/outpost/bigred,
/turf/open/floor/plating/ground/mars/random/dirt,
/area/bigredv3/outside/directions/s)
"jp" = (
/obj/structure/cable,
/obj/effect/decal/cleanable/dirt,
/obj/machinery/atmospherics/pipe/simple/green/hidden{
	dir = 4
	},
/turf/open/floor,
/area/bigredv3/inside/engi/east)
"jI" = (
/turf/open/floor/plating,
/area/bigredv3/inside/engi/east)
"jW" = (
/obj/machinery/atmospherics/pipe/simple/green/hidden{
	dir = 9
	},
/obj/structure/cable,
/turf/open/floor/marking/asteroidwarning{
	dir = 6
	},
/area/bigredv3/outside/directions/se)
"kI" = (
/turf/open/floor/plating/ground/mars/dirttosand/autosmooth{
	dir = 9
	},
/area/bigredv3/outside/directions/se)
"kQ" = (
/obj/effect/landmark/lv624/fog_blocker,
/turf/open/floor/plating/ground/mars/random/cave,
/area/bigredv3/outside/directions/s)
"lj" = (
/obj/effect/decal/cleanable/dirt,
/obj/item/radio/headset/survivor,
/turf/open/floor,
/area/bigredv3/inside/engi/east)
"ll" = (
/obj/structure/cable,
/turf/open/floor/plating,
/area/bigredv3/inside/engi/east)
"lN" = (
/obj/structure/fence/standard/xenoproof,
/turf/open/floor/plating/ground/mars/cavetodirt{
	dir = 1
	},
/area/bigredv3/outside/directions/s)
"mv" = (
/obj/structure/cable,
/obj/effect/decal/cleanable/dirt,
/obj/machinery/atmospherics/pipe/simple/green/hidden,
/turf/open/floor,
/area/bigredv3/inside/engi/east)
"mw" = (
/obj/structure/cable,
/obj/machinery/atmospherics/pipe/simple/green/hidden{
	dir = 4
	},
/obj/machinery/door/airlock/mainship/engineering/free_access{
	name = "\improper Atmospherics Condenser Storage"
	},
/turf/open/floor,
/area/bigredv3/inside/engi/east)
"mK" = (
/obj/structure/cable,
/obj/machinery/atmospherics/pipe/simple/green/hidden{
	dir = 4
	},
/turf/open/floor,
/area/bigredv3/inside/engi/east)
"mT" = (
/turf/open/floor/plating/ground/mars/random/cave,
/area/bigredv3/caves/east/garbledradio)
"mY" = (
/turf/open/floor/plating/ground/mars/random/cave/rock,
/area/bigredv3/outside/directions/s)
"nP" = (
/obj/item/clothing/head/warning_cone,
/turf/open/floor/asteroidfloor,
/area/bigredv3/outside/directions/s)
"pa" = (
/turf/open/floor/plating/ground/mars/cavetodirt{
	dir = 8
	},
/area/bigredv3/outside/directions/s)
"pP" = (
/obj/structure/fence/standard/xenoproof,
/turf/open/floor/plating/ground/mars/random/dirt,
/area/bigredv3/outside/directions/se)
"qD" = (
/obj/structure/fence/standard/xenoproof,
/turf/open/floor/plating/ground/mars/cavetodirt{
	dir = 5
	},
/area/bigredv3/outside/directions/s)
"rg" = (
/turf/open/liquid/water/river,
/area/bigredv3/caves/rock)
"rC" = (
/turf/open/floor/plating/ground/mars/dirttosand/autosmooth{
	dir = 1
	},
/area/bigredv3/outside/directions/se)
"rE" = (
/turf/open/floor/marking/asteroidwarning{
	dir = 5
	},
/area/bigredv3/outside/directions/se)
"sp" = (
/obj/effect/decal/cleanable/dirt,
/obj/effect/ai_node,
/turf/open/floor/asteroidfloor,
/area/bigredv3/outside/directions/s)
"sr" = (
/obj/structure/window/framed/colony,
/turf/open/floor/plating,
/area/bigredv3/inside/wall)
"st" = (
/obj/structure/bed/chair{
	dir = 4
	},
/obj/effect/decal/cleanable/dirt,
/turf/open/floor,
/area/bigredv3/inside/engi/east)
"sw" = (
/obj/machinery/computer/area_atmos/area,
/turf/open/floor,
/area/bigredv3/inside/engi/east)
"sK" = (
/obj/machinery/light,
/turf/open/floor,
/area/bigredv3/inside/engi/east)
"tX" = (
/obj/machinery/atmospherics/pipe/simple/green/hidden,
/obj/effect/ai_node,
/obj/structure/cable,
/turf/open/floor/marking/asteroidwarning{
	dir = 4
	},
/area/bigredv3/outside/directions/se)
"tY" = (
/obj/structure/table,
/turf/open/floor,
/area/bigredv3/inside/engi/east)
"ug" = (
/turf/open/floor/plating/ground/mars/cavetodirt{
	dir = 1
	},
/area/bigredv3/outside/directions/se)
"uG" = (
/obj/effect/forcefield/allow_bullet_travel,
/turf/closed/wall/r_wall/unmeltable,
/area/bigredv3/inside/wall)
"vg" = (
/obj/structure/table,
/obj/item/tool/lighter/random,
/obj/effect/decal/cleanable/dirt,
/turf/open/floor,
/area/bigredv3/inside/engi/east)
"vC" = (
/obj/effect/ai_node,
/turf/open/floor/marking/asteroidwarning{
	dir = 4
	},
/area/bigredv3/outside/directions/se)
"vK" = (
/obj/machinery/atmospherics/pipe/simple/green/hidden{
	dir = 4
	},
/obj/structure/cable,
/turf/open/floor/marking/asteroidwarning,
/area/bigredv3/outside/directions/s)
"xO" = (
/obj/structure/closet/wardrobe/atmospherics_yellow,
/turf/open/floor,
/area/bigredv3/inside/engi/east)
"yi" = (
/obj/machinery/floodlight/outpost/bigred,
/turf/open/floor/plating/ground/mars/random/sand,
/area/bigredv3/outside/directions/s)
"yu" = (
/obj/effect/decal/cleanable/dirt,
/turf/open/floor,
/area/bigredv3/inside/engi/east)
"yR" = (
/obj/effect/ai_node,
/turf/open/floor/marking/asteroidwarning{
	dir = 1
	},
/area/bigredv3/outside/directions/se)
"zG" = (
/obj/structure/fence/standard/xenoproof,
/turf/open/floor/plating/ground/mars/dirttosand/autosmooth{
	dir = 1
	},
/area/bigredv3/outside/directions/s)
"zW" = (
/obj/effect/decal/cleanable/dirt,
/turf/open/floor/asteroidfloor,
/area/bigredv3/outside/directions/s)
"Af" = (
/obj/structure/fence/standard/xenoproof,
/turf/open/floor/plating/ground/mars/cavetodirt{
	dir = 8
	},
/area/bigredv3/outside/directions/s)
"Bs" = (
/turf/open/floor/plating/ground/mars/cavetodirt{
	dir = 5
	},
/area/bigredv3/outside/directions/s)
"BN" = (
/turf/open/floor/asteroidfloor,
/area/bigredv3/outside/directions/s)
"BY" = (
/obj/effect/ai_node,
/turf/open/floor/plating/ground/mars/random/sand,
/area/bigredv3/outside/directions/se)
"Eo" = (
/obj/structure/cable,
/obj/effect/decal/cleanable/dirt,
/obj/machinery/power/apc/weak/ntf{
	dir = 1
	},
/turf/open/floor,
/area/bigredv3/inside/engi/east)
"FP" = (
/obj/effect/decal/cleanable/dirt,
/obj/machinery/atmospherics/pipe/simple/green/hidden{
	dir = 4
	},
/obj/structure/cable,
/turf/open/floor/marking/asteroidwarning,
/area/bigredv3/outside/directions/s)
"FV" = (
/obj/effect/decal/cleanable/dirt,
/obj/machinery/atmospherics/components/unary/vent_pump{
	dir = 8;
	on = 1
	},
/turf/open/floor,
/area/bigredv3/inside/engi/east)
"Gc" = (
/obj/machinery/miner/damaged,
/turf/open/floor/plating/ground/mars/random/sand,
/area/bigredv3/outside/directions/s)
"GX" = (
/turf/closed/mineral/smooth/bigred,
/area/bigredv3/caves/rock)
"Hr" = (
/obj/machinery/floodlight/outpost/bigred,
/turf/open/floor/plating/ground/mars/random/sand,
/area/bigredv3/outside/directions/se)
"Hz" = (
/obj/effect/landmark/lv624/fog_blocker,
/turf/closed/mineral/smooth/bigred,
/area/bigredv3/caves/rock)
"HC" = (
/obj/machinery/atmospherics/pipe/simple/green/hidden,
/obj/structure/cable,
/turf/open/floor/marking/asteroidwarning{
	dir = 4
	},
/area/bigredv3/outside/directions/se)
"JL" = (
/turf/open/floor,
/area/bigredv3/inside/engi/east)
"MW" = (
/turf/open/floor/asteroidfloor,
/area/bigredv3/outside/directions/se)
"Oq" = (
/turf/open/floor/plating/ground/mars/random/dirt,
/area/bigredv3/outside/directions/s)
"OC" = (
/obj/effect/decal/cleanable/blood/drip,
/turf/open/floor/asteroidfloor,
/area/bigredv3/outside/directions/s)
"QS" = (
/obj/machinery/floodlight/outpost/bigred,
/turf/open/floor/plating/ground/mars/random/dirt,
/area/bigredv3/outside/directions/se)
"Rf" = (
/turf/open/floor/marking/asteroidwarning{
	dir = 1
	},
/area/bigredv3/outside/directions/se)
"Rv" = (
/obj/machinery/atmospherics/pipe/simple/green/hidden{
	dir = 6
	},
/obj/structure/cable,
/turf/open/floor/marking/asteroidwarning{
	dir = 4
	},
/area/bigredv3/outside/directions/se)
"RF" = (
/obj/effect/landmark/lv624/fog_blocker,
/turf/open/floor/plating/ground/mars/cavetodirt{
	dir = 1
	},
/area/bigredv3/outside/directions/se)
"SS" = (
/obj/structure/window/framed/colony,
/obj/machinery/door/poddoor/shutters/mainship{
	id = "Filtration Plant";
	name = "\improper Filtration Plant Shutters"
	},
/turf/open/floor/plating,
/area/bigredv3/inside/wall)
"Tj" = (
/obj/effect/ai_node,
/turf/open/floor/asteroidfloor,
/area/bigredv3/outside/directions/s)
"Tr" = (
/obj/effect/ai_node,
/turf/open/floor/plating/ground/mars/random/cave,
/area/bigredv3/outside/directions/se)
"TQ" = (
/obj/structure/fence/standard/xenoproof,
/turf/open/floor/plating/ground/mars/cavetodirt{
	dir = 10
	},
/area/bigredv3/outside/directions/s)
"Uk" = (
/obj/machinery/atmospherics/pipe/simple/green/hidden{
	dir = 4
	},
/obj/structure/cable,
/turf/open/floor/marking/asteroidwarning,
/area/bigredv3/outside/directions/se)
"Uy" = (
/turf/open/floor/plating/ground/mars/cavetodirt{
	dir = 9
	},
/area/bigredv3/outside/directions/s)
"UK" = (
/obj/effect/landmark/lv624/fog_blocker,
/turf/open/floor/plating/ground/mars/random/cave,
/area/bigredv3/outside/directions/se)
"Va" = (
/turf/open/floor/plating/ground/mars/random/sand,
/area/bigredv3/outside/directions/s)
"Wh" = (
/turf/open/floor/plating/ground/mars/cavetodirt{
	dir = 1
	},
/area/bigredv3/outside/directions/s)
"WO" = (
/turf/open/floor/plating/ground/mars/random/cave,
/area/bigredv3/outside/directions/s)
"Xi" = (
/turf/open/floor/plating/ground/mars/dirttosand/autosmooth{
	dir = 1
	},
/area/bigredv3/outside/directions/s)
"XD" = (
/obj/structure/fence/standard/xenoproof,
/turf/open/floor/plating/ground/mars/random/dirt,
/area/bigredv3/outside/directions/s)
"Yd" = (
/turf/open/floor/plating/ground/mars/cavetodirt{
	dir = 9
	},
/area/bigredv3/outside/directions/se)
"Yr" = (
/obj/structure/cable,
/obj/effect/decal/cleanable/dirt,
/obj/machinery/atmospherics/pipe/manifold/green/hidden,
/obj/effect/ai_node,
/turf/open/floor,
/area/bigredv3/inside/engi/east)

(1,1,1) = {"
az
mw
az
az
fc
SS
SS
az
az
SS
SS
SS
az
az
fK
Va
Va
GX
GX
GX
Af
TQ
XD
lN
GX
"}
(2,1,1) = {"
xO
mK
gW
az
BN
Tj
BN
BN
BN
BN
BN
zW
zW
sp
vK
Va
yi
GX
GX
GX
GX
WO
pa
mY
GX
"}
(3,1,1) = {"
xO
dq
sK
az
BN
BN
BN
BN
BN
BN
BN
BN
BN
nP
vK
Va
Va
GX
GX
GX
GX
WO
mY
GX
GX
"}
(4,1,1) = {"
xO
mK
JL
az
OC
BN
uG
bN
bN
bN
bN
uG
zW
zW
vK
Va
cY
qD
Oq
Uy
WO
WO
mY
GX
GX
"}
(5,1,1) = {"
az
mw
az
az
BN
BN
bN
rg
rg
rg
rg
bN
zW
BN
vK
Va
Xi
XD
Oq
Wh
WO
WO
mY
GX
GX
"}
(6,1,1) = {"
vg
jp
Eo
az
BN
BN
bN
rg
rg
rg
rg
bN
zW
BN
FP
Va
Xi
zG
Oq
Wh
WO
WO
WO
mY
GX
"}
(7,1,1) = {"
yu
jp
JL
dV
BN
BN
bN
rg
rg
rg
rg
bN
zW
zW
FP
Va
Xi
zG
Oq
Bs
WO
WO
WO
mY
Hz
"}
(8,1,1) = {"
mv
Yr
yu
dV
BN
BN
bN
rg
rg
rg
rg
bN
BN
zW
FP
Va
Xi
zG
Oq
Oq
Wh
WO
WO
aq
GX
"}
(9,1,1) = {"
yu
FV
yu
dV
BN
BN
uG
bN
bN
bN
bN
uG
zW
BN
vK
Va
Xi
zG
Oq
Uy
WO
kQ
kQ
mY
GX
"}
(10,1,1) = {"
yu
lj
st
dV
BN
Tj
BN
BN
BN
zW
zW
zW
BN
Tj
vK
Va
Xi
zG
Oq
Wh
kQ
di
WO
mY
GX
"}
(11,1,1) = {"
tY
sw
JL
az
BN
BN
BN
zW
zW
BN
BN
BN
zW
BN
vK
Va
Xi
XD
Uy
kQ
WO
WO
WO
mY
GX
"}
(12,1,1) = {"
sr
sr
sr
az
BN
BN
uG
bN
bN
bN
bN
uG
zW
BN
vK
Gc
Xi
GX
mY
kQ
WO
WO
mY
GX
GX
"}
(13,1,1) = {"
jI
jI
jI
az
BN
BN
bN
rg
rg
rg
rg
bN
BN
BN
vK
Va
Oq
GX
Hz
WO
WO
WO
mY
GX
GX
"}
(14,1,1) = {"
ll
ll
ll
az
BN
BN
bN
rg
rg
rg
rg
bN
BN
BN
vK
Va
jb
GX
Hz
WO
WO
WO
WO
mY
mY
"}
(15,1,1) = {"
dZ
eu
dZ
az
BN
BN
bN
rg
rg
rg
rg
bN
BN
BN
vK
Va
Xi
GX
aq
WO
WO
WO
WO
WO
WO
"}
(16,1,1) = {"
az
az
az
az
BN
BN
bN
rg
rg
rg
rg
bN
BN
BN
vK
Va
Xi
XD
Bs
kQ
WO
WO
WO
WO
WO
"}
(17,1,1) = {"
GX
ik
ik
ik
Rf
MW
uG
bN
bN
bN
bN
uG
MW
MW
Uk
ik
rC
pP
ef
RF
bj
bj
bj
bj
bj
"}
(18,1,1) = {"
GX
GX
ik
ik
Rf
gp
MW
MW
MW
MW
MW
MW
MW
gp
Uk
ik
rC
pP
ef
ug
UK
bj
bj
bj
bj
"}
(19,1,1) = {"
GX
GX
ik
ik
rE
vC
fO
vC
Rv
HC
HC
HC
HC
tX
jW
kI
ef
pP
Yd
UK
bj
Tr
bj
bj
Tr
"}
(20,1,1) = {"
GX
ik
ik
ik
ik
ik
ik
Rf
Uk
ik
ik
ik
ik
ik
ik
rC
ef
pP
ug
bj
UK
bj
bj
bj
bj
"}
(21,1,1) = {"
ik
ik
ik
ik
ik
ik
ik
Rf
Uk
ik
ik
ik
ik
ik
kI
ef
ef
pP
ug
GX
Hz
bj
bj
bj
bj
"}
(22,1,1) = {"
ik
ik
ik
ik
Hr
ik
ik
Rf
Uk
ik
ik
Hr
ik
ik
rC
ef
ef
GX
GX
Hz
GX
bj
bj
bj
bj
"}
(23,1,1) = {"
BY
ik
ik
ik
ik
ik
ik
yR
ar
ik
ik
ik
ik
kI
ef
ef
QS
GX
GX
Hz
GX
bj
bj
bj
bj
"}
(24,1,1) = {"
ik
ik
ik
ik
ik
ik
ik
Rf
ar
ik
ik
ik
kI
ef
ef
ef
ef
GX
GX
Hz
GX
mT
mT
mT
mT
"}
