//MAP CONVERTED BY dmm2tgm.py THIS HEADER COMMENT PREVENTS RECONVERSION, DO NOT REMOVE
"d" = (
/obj/effect/landmark/lv624/fog_blocker/xeno_spawn,
/turf/closed/mineral/smooth/bigred,
/area/bigredv3/caves/rock)
"m" = (
/obj/effect/landmark/patrol_point/som/som_11,
/turf/open/floor/plating/ground/mars/random/cave/rock,
/area/bigredv3/caves/southwest)
"n" = (
/turf/closed/wall/r_wall,
/area/bigredv3/inside/wall)
"p" = (
/obj/effect/ai_node,
/turf/open/floor/plating/ground/mars/random/cave/rock,
/area/bigredv3/caves/southwest)
"r" = (
/turf/open/floor/plating/ground/mars/random/cave,
/area/bigredv3/caves/southwest)
"w" = (
/obj/effect/landmark/lv624/fog_blocker,
/turf/closed/mineral/smooth/bigred,
/area/bigredv3/caves/rock)
"E" = (
/turf/open/floor/plating/ground/mars/random/cave/rock,
/area/bigredv3/caves/southwest)
"F" = (
/obj/effect/ai_node,
/turf/open/floor/plating/ground/mars/random/cave,
/area/bigredv3/caves/southwest)
"K" = (
/turf/closed/mineral/smooth/bigred/indestructible,
/area/space)
"L" = (
/obj/effect/landmark/xeno_tunnel_spawn,
/turf/open/floor/plating/ground/mars/random/cave,
/area/bigredv3/caves/southwest)
"N" = (
/obj/effect/landmark/lv624/fog_blocker,
/turf/open/floor/plating/ground/mars/random/cave,
/area/bigredv3/caves/southwest)
"Q" = (
/turf/closed/mineral/smooth/bigred,
/area/bigredv3/caves/rock)
"S" = (
/obj/effect/landmark/xeno_silo_spawn,
/turf/open/floor/plating/ground/mars/random/cave,
/area/bigredv3/caves/southwest)
"V" = (
/obj/effect/landmark/lv624/fog_blocker/xeno_spawn,
/turf/open/floor/plating/ground/mars/random/cave,
/area/bigredv3/caves/southwest)
"W" = (
/obj/structure/fence/standard/xenoproof,
/turf/open/floor/plating/ground/mars/random/cave,
/area/bigredv3/caves/southwest)

(1,1,1) = {"
K
K
K
K
K
K
K
K
K
K
K
K
K
K
K
K
K
K
K
K
K
K
K
K
K
K
K
K
K
K
K
K
K
K
K
K
K
K
K
K
K
K
K
"}
(2,1,1) = {"
Q
Q
Q
Q
Q
Q
Q
Q
Q
Q
Q
Q
Q
Q
Q
Q
Q
Q
Q
Q
Q
Q
Q
Q
Q
Q
Q
Q
Q
Q
Q
Q
Q
Q
Q
Q
Q
Q
Q
Q
Q
Q
K
"}
(3,1,1) = {"
Q
Q
Q
Q
Q
Q
Q
Q
Q
Q
Q
Q
Q
Q
Q
Q
Q
Q
Q
Q
Q
Q
Q
Q
Q
Q
Q
Q
d
d
d
d
d
d
d
d
d
d
d
d
Q
Q
K
"}
(4,1,1) = {"
Q
Q
Q
Q
Q
Q
Q
Q
Q
Q
Q
Q
Q
Q
Q
Q
Q
Q
Q
Q
Q
Q
Q
Q
Q
Q
Q
Q
d
Q
Q
Q
Q
Q
Q
Q
Q
Q
Q
d
Q
Q
K
"}
(5,1,1) = {"
Q
Q
Q
Q
Q
Q
Q
Q
Q
Q
Q
Q
Q
Q
Q
Q
Q
Q
Q
Q
Q
Q
Q
Q
Q
Q
Q
Q
d
Q
Q
Q
Q
Q
r
r
F
r
Q
d
Q
Q
K
"}
(6,1,1) = {"
Q
Q
Q
Q
Q
Q
Q
Q
Q
Q
Q
Q
Q
Q
Q
Q
Q
Q
Q
Q
Q
Q
Q
Q
Q
Q
Q
Q
d
Q
Q
Q
Q
r
r
r
S
r
r
d
Q
Q
K
"}
(7,1,1) = {"
Q
Q
Q
Q
r
r
r
r
r
Q
Q
Q
Q
Q
Q
Q
Q
Q
Q
Q
Q
Q
Q
Q
Q
Q
Q
r
V
r
E
Q
r
r
r
r
r
r
r
d
Q
Q
K
"}
(8,1,1) = {"
Q
Q
r
r
r
r
E
r
r
r
r
Q
Q
Q
Q
Q
Q
r
r
r
r
E
r
r
r
r
r
r
V
r
E
r
r
r
r
r
r
r
L
d
Q
Q
K
"}
(9,1,1) = {"
Q
r
E
r
r
r
r
r
r
r
r
r
r
r
r
r
r
r
r
r
r
r
r
r
r
r
r
r
V
r
E
r
r
r
r
r
r
r
Q
d
Q
Q
K
"}
(10,1,1) = {"
r
r
F
r
r
r
r
r
r
r
r
F
r
r
r
r
r
F
r
r
r
r
F
r
r
r
r
F
V
r
r
E
r
F
r
r
F
r
Q
d
Q
Q
K
"}
(11,1,1) = {"
r
r
r
r
r
r
r
r
E
r
r
r
r
E
E
r
r
r
r
E
r
r
r
r
r
r
r
r
V
r
r
m
r
r
r
r
r
Q
Q
d
Q
Q
K
"}
(12,1,1) = {"
r
r
r
r
r
r
r
r
r
r
Q
Q
Q
r
r
r
E
r
r
r
r
r
r
r
r
r
r
r
V
r
r
r
r
r
Q
Q
Q
Q
Q
d
Q
Q
K
"}
(13,1,1) = {"
r
E
p
Q
Q
Q
Q
Q
Q
Q
Q
Q
Q
Q
r
r
r
F
r
r
r
r
r
r
r
r
r
r
V
r
r
r
r
r
Q
Q
Q
Q
Q
d
Q
Q
K
"}
(14,1,1) = {"
r
r
E
Q
Q
Q
Q
Q
Q
Q
Q
Q
Q
Q
Q
Q
Q
Q
r
r
r
r
r
r
r
r
r
r
V
r
r
r
r
r
E
Q
Q
Q
Q
d
Q
Q
K
"}
(15,1,1) = {"
r
r
r
E
E
Q
Q
Q
Q
Q
Q
Q
Q
Q
Q
Q
Q
Q
Q
Q
r
r
r
r
r
r
r
r
V
V
V
V
V
V
V
d
d
d
d
d
Q
Q
K
"}
(16,1,1) = {"
r
r
r
r
E
Q
Q
Q
Q
Q
Q
Q
Q
Q
Q
Q
Q
Q
Q
Q
r
r
F
r
r
r
r
F
r
r
r
r
F
r
r
Q
Q
Q
Q
Q
Q
Q
K
"}
(17,1,1) = {"
r
r
r
r
E
Q
Q
Q
Q
Q
Q
Q
Q
Q
Q
Q
Q
Q
Q
Q
r
r
r
r
r
r
r
r
r
r
r
r
r
r
E
Q
Q
Q
Q
Q
Q
Q
K
"}
(18,1,1) = {"
r
r
r
r
E
Q
Q
Q
Q
Q
Q
Q
Q
Q
Q
Q
Q
Q
Q
r
r
r
r
r
r
r
r
r
r
r
r
r
r
Q
Q
Q
Q
Q
Q
Q
Q
Q
K
"}
(19,1,1) = {"
r
r
F
r
p
Q
Q
Q
Q
Q
Q
Q
Q
Q
Q
Q
Q
r
r
E
r
r
r
r
r
r
r
r
r
r
E
r
r
Q
Q
Q
Q
Q
Q
Q
Q
Q
K
"}
(20,1,1) = {"
Q
r
r
r
r
E
Q
Q
Q
Q
Q
Q
Q
Q
Q
r
r
r
r
r
r
r
r
r
r
E
r
r
r
r
E
r
r
r
Q
Q
Q
Q
Q
Q
Q
Q
K
"}
(21,1,1) = {"
Q
Q
Q
r
r
E
Q
Q
Q
Q
Q
E
r
r
r
r
r
E
r
r
r
r
r
r
r
r
r
r
r
E
r
r
F
r
Q
Q
Q
Q
Q
Q
Q
Q
K
"}
(22,1,1) = {"
Q
Q
Q
r
r
r
E
r
Q
Q
Q
r
F
r
r
r
r
r
r
r
r
r
F
E
Q
E
r
r
r
E
Q
Q
r
F
r
r
F
Q
Q
Q
Q
Q
K
"}
(23,1,1) = {"
Q
Q
Q
r
r
r
r
r
r
Q
r
r
r
r
r
E
Q
Q
Q
Q
Q
Q
Q
Q
Q
r
r
F
Q
Q
Q
Q
Q
r
r
r
r
Q
Q
Q
Q
Q
K
"}
(24,1,1) = {"
Q
Q
Q
r
r
r
r
r
E
r
r
E
r
r
r
E
Q
Q
Q
Q
Q
Q
Q
Q
r
r
r
r
Q
Q
Q
Q
Q
r
E
r
r
r
r
Q
Q
Q
K
"}
(25,1,1) = {"
Q
Q
Q
E
r
r
r
r
r
r
E
r
r
r
r
Q
Q
Q
Q
Q
Q
Q
Q
Q
r
F
r
r
Q
Q
Q
Q
Q
Q
r
r
r
r
r
r
Q
Q
K
"}
(26,1,1) = {"
Q
Q
Q
Q
F
r
r
r
r
r
r
r
E
r
r
Q
Q
Q
Q
Q
Q
Q
Q
Q
Q
r
F
r
Q
Q
Q
Q
Q
Q
Q
r
r
r
E
r
Q
Q
K
"}
(27,1,1) = {"
Q
Q
Q
r
r
F
r
r
r
r
r
r
F
r
r
Q
Q
Q
Q
Q
Q
Q
Q
Q
Q
r
r
r
r
Q
Q
Q
Q
Q
Q
r
r
r
r
r
Q
Q
K
"}
(28,1,1) = {"
Q
Q
r
r
r
r
r
r
r
r
r
r
r
r
E
Q
Q
Q
Q
Q
Q
Q
Q
Q
Q
Q
r
r
r
Q
Q
Q
Q
Q
Q
r
E
r
r
r
Q
Q
K
"}
(29,1,1) = {"
Q
r
r
r
r
r
r
r
r
r
r
r
r
r
r
Q
Q
Q
Q
Q
Q
Q
Q
Q
Q
Q
r
r
r
Q
Q
Q
Q
Q
Q
r
r
r
r
r
Q
Q
K
"}
(30,1,1) = {"
Q
r
r
r
r
r
r
r
r
E
Q
E
F
r
r
r
Q
Q
Q
Q
Q
Q
Q
Q
Q
Q
r
r
r
r
Q
Q
Q
F
r
r
F
r
r
Q
Q
Q
K
"}
(31,1,1) = {"
Q
r
r
r
r
r
r
r
r
E
Q
Q
E
F
r
r
r
Q
Q
Q
Q
Q
Q
Q
Q
Q
p
r
r
r
r
r
r
r
r
r
Q
Q
Q
Q
Q
Q
K
"}
(32,1,1) = {"
Q
r
F
r
r
F
Q
r
r
E
Q
Q
Q
r
F
r
r
F
r
Q
Q
Q
Q
Q
Q
Q
E
p
r
r
r
r
r
r
Q
Q
Q
Q
Q
Q
Q
Q
K
"}
(33,1,1) = {"
Q
r
r
r
Q
Q
Q
E
E
Q
Q
Q
Q
r
r
r
r
r
r
r
E
Q
Q
Q
Q
Q
Q
E
F
r
r
r
r
F
Q
K
K
K
K
K
K
K
K
"}
(34,1,1) = {"
Q
W
W
W
Q
Q
Q
Q
Q
Q
Q
Q
Q
Q
r
r
r
r
r
r
r
E
Q
Q
Q
Q
Q
Q
r
r
r
r
r
Q
Q
K
K
K
K
K
K
K
K
"}
(35,1,1) = {"
Q
r
r
r
Q
Q
Q
Q
Q
Q
Q
Q
Q
r
r
r
r
r
r
r
E
Q
Q
Q
Q
Q
Q
Q
r
r
r
Q
Q
Q
Q
K
K
K
K
K
K
K
K
"}
(36,1,1) = {"
Q
n
n
n
Q
Q
Q
Q
Q
Q
Q
Q
Q
E
F
r
r
F
r
r
E
Q
Q
Q
Q
Q
Q
Q
r
r
r
Q
Q
Q
Q
K
K
K
K
K
K
K
K
"}
(37,1,1) = {"
r
r
r
r
Q
Q
Q
Q
Q
Q
Q
Q
Q
Q
Q
Q
r
F
r
r
r
p
Q
Q
Q
Q
Q
Q
r
r
r
Q
Q
Q
Q
K
K
K
K
K
K
K
K
"}
(38,1,1) = {"
r
r
r
r
Q
Q
Q
Q
Q
Q
Q
Q
Q
Q
Q
Q
r
r
r
r
r
E
Q
Q
Q
Q
E
E
r
r
r
Q
Q
Q
Q
K
K
K
K
K
K
K
K
"}
(39,1,1) = {"
r
r
r
r
Q
Q
Q
Q
Q
Q
Q
Q
Q
Q
Q
Q
E
r
r
r
r
E
Q
Q
Q
Q
E
E
r
r
Q
Q
Q
Q
Q
K
K
K
K
K
K
K
K
"}
(40,1,1) = {"
r
r
r
r
Q
Q
Q
Q
Q
Q
Q
Q
Q
Q
Q
Q
Q
Q
Q
r
r
r
E
E
Q
Q
Q
Q
F
r
Q
Q
Q
Q
Q
K
K
K
K
K
K
K
K
"}
(41,1,1) = {"
N
N
N
w
w
w
w
w
w
w
w
w
w
w
Q
Q
Q
Q
Q
r
r
r
r
E
Q
Q
Q
Q
r
r
Q
Q
Q
Q
Q
K
K
K
K
K
K
K
K
"}
