//MAP CONVERTED BY dmm2tgm.py THIS HEADER COMMENT PREVENTS RECONVERSION, DO NOT REMOVE
"ab" = (
/obj/effect/ai_node,
/turf/open/floor/plating/ground/mars/random/cave,
/area/bigredv2/caves/southwest)
"ac" = (
/obj/effect/landmark/excavation_site_spawner,
/turf/open/floor/plating/ground/mars/random/cave,
/area/bigredv2/caves/southwest)
"ad" = (
/obj/effect/landmark/lv624/fog_blocker,
/turf/open/floor/plating/ground/mars/random/cave,
/area/bigredv2/caves/southwest)
"ah" = (
/obj/effect/ai_node,
/turf/open/floor/plating/ground/mars/random/cave/rock,
/area/bigredv2/caves/southwest)
"ai" = (
/turf/open/floor/plating/ground/mars/random/cave,
/area/bigredv2/caves/southwest)
"aj" = (
/turf/open/floor/plating/ground/mars/random/cave/rock,
/area/bigredv2/caves/southwest)
"ak" = (
/obj/effect/landmark/xeno_silo_spawn,
/turf/open/floor/plating/ground/mars/random/cave,
/area/bigredv2/caves/southwest)
"an" = (
/obj/effect/landmark/excavation_site_spawner,
/obj/effect/landmark/lv624/fog_blocker/xeno_spawn,
/turf/open/floor/plating/ground/mars/random/cave,
/area/bigredv2/caves/southwest)
"aq" = (
/obj/effect/landmark/lv624/fog_blocker,
/turf/closed/mineral/smooth/bigred,
/area/bigredv2/caves/rock)
"as" = (
/obj/effect/landmark/excavation_site_spawner,
/obj/effect/ai_node,
/turf/open/floor/plating/ground/mars/random/cave,
/area/bigredv2/caves/southwest)
"au" = (
/turf/closed/mineral/smooth/bigred/indestructible,
/area/space)
"aw" = (
/obj/effect/landmark/lv624/fog_blocker/xeno_spawn,
/turf/open/floor/plating/ground/mars/random/cave/rock,
/area/bigredv2/caves/southwest)
"aH" = (
/turf/closed/mineral/smooth/bigred,
/area/bigredv2/caves/rock)
"aJ" = (
/obj/effect/landmark/lv624/fog_blocker/xeno_spawn,
/turf/open/floor/plating/ground/mars/random/cave,
/area/bigredv2/caves/southwest)
"aT" = (
/obj/effect/landmark/lv624/fog_blocker/xeno_spawn,
/turf/closed/mineral/smooth/bigred,
/area/bigredv2/caves/rock)
"gB" = (
/obj/effect/landmark/patrol_point/som/som_11,
/turf/open/floor/plating/ground/mars/random/cave,
/area/bigredv2/caves/southwest)
"hG" = (
/obj/effect/landmark/xeno_tunnel_spawn,
/turf/open/floor/plating/ground/mars/random/cave/rock,
/area/bigredv2/caves/southwest)

(1,1,1) = {"
au
au
au
au
au
au
au
au
au
au
au
au
au
au
au
au
au
au
au
au
au
au
au
au
au
au
au
au
au
au
au
au
au
au
au
au
au
au
au
au
au
au
au
"}
(2,1,1) = {"
aH
aH
aH
aH
aH
aH
aH
aH
aH
aH
aH
aH
aH
aH
aH
aH
aH
aH
aH
aT
aH
aH
aH
aH
aH
aH
aH
aH
aH
aH
aH
aH
aH
aH
aH
au
au
au
au
au
au
au
au
"}
(3,1,1) = {"
aH
aH
aH
aH
aH
aH
aH
aH
aH
aH
aH
aH
aH
aH
aH
aH
aH
aH
aH
aT
aH
aH
aH
aH
aH
aH
aH
aH
aH
aH
aH
aH
aH
aH
aH
au
au
au
au
au
au
au
au
"}
(4,1,1) = {"
aH
aH
aH
aH
aH
aH
aH
aH
aH
aH
aH
aH
aH
aH
aH
aH
aH
aH
aH
aT
aH
aH
aH
aH
aH
aH
aH
aH
aH
aH
aH
aH
aH
aH
aH
au
au
au
au
au
au
au
au
"}
(5,1,1) = {"
aH
aH
aH
aH
aH
aH
aH
aH
aH
aH
aH
aH
aH
aH
aH
aH
aH
aH
aH
aT
aH
aH
aH
aH
aH
aH
aH
aH
aH
aH
aH
aH
aH
aH
aH
au
au
au
au
au
au
au
au
"}
(6,1,1) = {"
aH
aH
aH
aH
aH
aH
aH
aH
aH
aH
aH
aH
aH
aH
aH
aH
aH
aH
aH
aT
aH
aH
ai
aj
aj
hG
aj
aj
aH
aH
aH
aH
aH
aH
aH
au
au
au
au
au
au
au
au
"}
(7,1,1) = {"
aH
aH
aH
aH
ai
ai
ai
ai
ai
aH
aH
aH
aH
aH
aH
aj
ai
ai
ai
aJ
ai
ai
ai
ai
ai
ai
ai
ai
aj
aH
aH
aH
aH
aH
aH
au
au
au
au
au
au
au
au
"}
(8,1,1) = {"
aH
aH
ai
ai
ai
ai
ai
ai
ai
ai
ai
aH
aH
aH
aj
ai
ai
ai
ai
aJ
ai
ai
ai
ai
ai
ai
ai
ai
aj
aH
aH
aH
aH
aH
aH
au
au
au
au
au
au
au
au
"}
(9,1,1) = {"
aH
ai
ai
ai
ai
ai
ai
ai
ai
ai
ai
ai
ai
ai
ai
ai
ai
ai
ai
aJ
ai
ai
ai
ai
ai
ak
ai
ai
aj
aH
aH
aH
aH
aH
aH
au
au
au
au
au
au
au
au
"}
(10,1,1) = {"
ai
ai
ab
ai
ai
ai
ai
ai
ai
ai
ai
ab
ai
ai
ai
ab
ai
ai
ai
aJ
ai
ai
ai
ai
ai
ab
ai
ai
ai
aj
aH
aH
aH
aH
aH
au
au
au
au
au
au
au
au
"}
(11,1,1) = {"
ai
ai
ai
ai
ai
ai
ai
ai
ai
ai
ai
ai
ai
ai
ai
ai
ai
ai
ai
aJ
ai
ai
ai
ai
ai
ai
ai
ai
ai
aj
aH
aH
aH
aH
aH
au
au
au
au
au
au
au
au
"}
(12,1,1) = {"
ai
ai
ai
ai
ai
ai
ai
ai
aH
aH
aH
ai
ai
ai
ai
ai
ai
ai
ai
aJ
ai
ai
ai
ai
gB
ai
ai
ai
ai
ai
ai
ai
aH
aH
aH
au
au
au
au
au
au
au
au
"}
(13,1,1) = {"
ai
ai
aH
aH
aH
aH
aH
aH
aH
aH
aH
ai
ai
ai
ai
ai
ai
ai
ai
aJ
ai
ai
ai
ai
ai
ai
ai
ai
ai
ai
ai
ai
aH
aH
aH
au
au
au
au
au
au
au
au
"}
(14,1,1) = {"
ai
aH
aH
aH
aH
aH
aH
aH
aH
aH
aH
ai
ai
ai
ai
ai
ai
ai
ai
aJ
ai
ai
ai
ai
ai
ai
ai
aj
ai
ai
ai
aH
aH
aH
aH
au
au
au
au
au
au
au
au
"}
(15,1,1) = {"
aH
aH
aH
aH
aH
aH
aH
aH
aH
aH
aH
aj
ai
ai
ai
ai
ai
ai
ai
aJ
ai
ai
ai
ai
ai
ai
ai
ai
ai
ai
ai
aH
aH
aH
aH
au
au
au
au
au
au
au
au
"}
(16,1,1) = {"
aH
aH
aH
aH
aH
aH
aH
aH
aH
aH
aH
aH
ai
ai
ai
ab
ai
ai
ai
aJ
ab
ai
ai
ai
ai
ab
ai
ai
ai
ai
ai
aH
aH
aH
aH
au
au
au
au
au
au
au
au
"}
(17,1,1) = {"
aH
aH
aH
aH
aH
aH
aH
aH
aH
aH
aH
aH
ai
ai
ai
ai
ai
ai
ai
an
aJ
aJ
aJ
aJ
aJ
aJ
aJ
aw
aJ
aJ
aJ
aT
aT
aT
aT
au
au
au
au
au
au
au
au
"}
(18,1,1) = {"
aH
aH
aH
aH
aH
aH
aH
aH
aH
aH
aH
aH
ai
ai
ai
ai
ai
ai
ai
ai
ai
ai
ai
ai
ai
ai
ai
ai
ai
ai
aH
aH
aH
aH
aH
au
au
au
au
au
au
au
au
"}
(19,1,1) = {"
aH
aH
aH
aH
aH
aH
aH
aH
aH
aH
aH
aH
ai
ai
ai
ai
ai
ai
ai
ai
ai
ai
ai
aj
ai
ai
ai
ai
aH
aH
aH
aH
aH
aH
aH
au
au
au
au
au
au
au
au
"}
(20,1,1) = {"
aH
aH
aH
aH
aH
aH
aH
aH
aH
aH
ai
aj
ai
ai
ai
ai
ai
ai
ai
ai
ai
ai
ai
aj
ai
ai
ai
aH
aH
aH
aH
aH
aH
aH
aH
au
au
au
au
au
au
au
au
"}
(21,1,1) = {"
aH
aH
aH
aH
aH
aH
aH
aH
aH
ai
ai
aj
ai
ai
ai
ai
ai
ai
ai
ai
ai
ai
aj
ai
ai
ai
ai
aH
aH
aH
aH
aH
aH
aH
aH
au
au
au
au
au
au
au
au
"}
(22,1,1) = {"
aH
aH
aH
aH
aH
aH
aH
aH
aH
ai
ai
ai
ab
ai
ai
ab
aj
aH
aj
ai
ai
ai
aj
aH
aH
ai
ai
aH
aH
aH
aH
aH
aH
aH
aH
au
au
au
au
au
au
au
au
"}
(23,1,1) = {"
aH
aH
aH
aH
aH
aH
aH
aH
ai
ai
ai
ai
ai
ai
ai
aj
aH
aH
aH
aH
aH
aH
aH
aH
aH
ai
ai
ai
aH
aH
aH
aH
aH
aH
aH
au
au
au
au
au
au
au
au
"}
(24,1,1) = {"
aH
aH
aH
aH
aH
ai
ai
ai
aj
ai
ai
aj
ai
ai
ai
aj
aH
aH
aH
aH
aH
aH
aH
aH
ai
ai
ai
ai
aH
aH
aH
aH
aH
aH
aH
au
au
au
au
au
au
au
au
"}
(25,1,1) = {"
aH
aH
aH
aH
aH
ai
ai
ai
ai
ai
aj
ai
ai
ai
ai
aH
aH
aH
aH
aH
aH
aH
aH
aH
ai
ab
ai
ai
aH
aH
aH
aH
aH
aH
aH
au
au
au
au
au
au
au
au
"}
(26,1,1) = {"
aH
aH
aH
aH
ab
ai
ai
ai
ai
ai
ai
ai
aj
ai
ai
aH
aH
aH
aH
aH
aH
aH
aH
aH
aH
ai
ab
ai
aH
aH
aH
aH
aH
aH
aH
au
au
au
au
au
au
au
au
"}
(27,1,1) = {"
aH
aH
aH
ai
ai
ab
ai
ai
ai
ai
ai
ai
ab
ai
ai
aH
aH
aH
aH
aH
aH
aH
aH
aH
aH
ai
ai
ai
ai
aH
aH
aH
aH
aH
aH
au
au
au
au
au
au
au
au
"}
(28,1,1) = {"
aH
aH
ai
ai
ai
ai
ai
ai
ai
ai
ai
ai
ai
ai
aj
aH
aH
aH
aH
aH
aH
aH
aH
aH
aH
aH
ai
ai
ai
aH
aH
aH
aH
aH
aH
au
au
au
au
au
au
au
au
"}
(29,1,1) = {"
aH
ai
ai
ai
ai
ai
ai
ai
ai
ai
ai
ai
ai
ai
ai
aH
aH
aH
aH
aH
aH
aH
aH
aH
aH
aH
ai
ai
ai
aH
aH
aH
aH
aH
aH
au
au
au
au
au
au
au
au
"}
(30,1,1) = {"
aH
ai
ai
ai
ai
ai
ai
ai
ai
aj
aH
aj
ab
ai
ai
ai
aH
aH
aH
aH
aH
aH
aH
aH
aH
aH
ai
ai
ai
ai
aH
aH
aH
aH
aH
au
au
au
au
au
au
au
au
"}
(31,1,1) = {"
aH
ai
ai
ai
ai
ai
ai
ai
ai
aj
aH
aH
aj
ab
ai
ai
ai
aH
aH
aH
aH
aH
aH
aH
aH
aH
ah
ai
ai
ai
aH
aH
aH
aH
aH
au
au
au
au
au
au
au
au
"}
(32,1,1) = {"
aH
ai
ab
ai
ai
ab
aH
ai
ai
aj
aH
aH
aH
ai
ab
ai
ai
ab
ai
aH
aH
aH
aH
aH
aH
aH
aj
ah
ai
ai
aH
aH
aH
aH
aH
au
au
au
au
au
au
au
au
"}
(33,1,1) = {"
aH
ai
ai
ai
aH
aH
aH
aj
aj
aH
aH
aH
aH
ai
ai
ai
ai
ai
ai
ai
aj
aH
aH
aH
aH
aH
aH
aj
ab
ai
ai
aH
aH
aH
aH
au
au
au
au
au
au
au
au
"}
(34,1,1) = {"
aH
ai
ai
ai
aH
aH
aH
aH
aH
aH
aH
aH
aH
aH
ai
ai
ai
ai
ai
ai
ai
aj
aH
aH
aH
aH
aH
aH
ai
ai
ai
ai
aH
aH
aH
au
au
au
au
au
au
au
au
"}
(35,1,1) = {"
aH
ai
ai
ai
aH
aH
aH
aH
aH
aH
aH
aH
aH
ai
ai
ai
ai
ai
ai
ai
aj
aH
aH
aH
aH
aH
aH
aH
ai
ai
ai
aH
aH
aH
aH
au
au
au
au
au
au
au
au
"}
(36,1,1) = {"
aH
ai
ai
ai
aH
aH
aH
aH
aH
aH
aH
aH
aH
aj
ai
ai
ai
ai
ai
ai
aj
aH
aH
aH
aH
aH
aH
aH
ai
ai
ai
aH
aH
aH
aH
au
au
au
au
au
au
au
au
"}
(37,1,1) = {"
ai
ai
ai
ai
aH
aH
aH
aH
aH
aH
aH
aH
aH
aH
aH
aH
ai
as
ai
ai
ai
ah
aH
aH
aH
aH
aH
aH
ai
ac
ai
aH
aH
aH
aH
au
au
au
au
au
au
au
au
"}
(38,1,1) = {"
ai
ai
ai
ai
aH
aH
aH
aH
aH
aH
aH
aH
aH
aH
aH
aH
ai
ai
ai
ai
ai
aj
aH
aH
aH
aH
aj
aj
ai
ai
ai
aH
aH
aH
aH
au
au
au
au
au
au
au
au
"}
(39,1,1) = {"
ai
ai
ai
ai
aH
aH
aH
aH
aH
aH
aH
aH
aH
aH
aH
aH
aj
ai
ai
ai
ai
aj
aH
aH
aH
aH
aj
aj
ai
ai
aH
aH
aH
aH
aH
au
au
au
au
au
au
au
au
"}
(40,1,1) = {"
ai
ai
ai
ai
aH
aH
aH
aH
aH
aH
aH
aH
aH
aH
aH
aH
aH
aH
aH
ai
ai
ai
aj
aj
aH
aH
aH
aH
ai
ai
aH
aH
aH
aH
aH
au
au
au
au
au
au
au
au
"}
(41,1,1) = {"
ad
ad
ad
aq
aq
aq
aq
aq
aq
aq
aq
aq
aq
aq
aH
aH
aH
aH
aH
ai
ai
ai
ai
aj
aH
aH
aH
aH
ai
ai
aH
aH
aH
aH
aH
au
au
au
au
au
au
au
au
"}
