//MAP CONVERTED BY dmm2tgm.py THIS HEADER COMMENT PREVENTS RECONVERSION, DO NOT REMOVE
"am" = (
/turf/open/floor,
/area/bigredv3/inside/colony/dorm)
"dY" = (
/obj/effect/decal/cleanable/dirt,
/obj/machinery/atmospherics/pipe/simple/green/hidden,
/obj/structure/cable,
/turf/open/floor/grimy,
/area/bigredv3/inside/colony/dorm)
"gp" = (
/obj/machinery/atmospherics/pipe/simple/green/hidden{
	dir = 4
	},
/obj/structure/cable,
/turf/open/floor,
/area/bigredv3/inside/colony/dorm)
"gy" = (
/obj/machinery/atmospherics/pipe/manifold/green/hidden,
/obj/structure/cable,
/turf/open/floor,
/area/bigredv3/inside/colony/dorm)
"hT" = (
/obj/effect/decal/cleanable/dirt,
/obj/effect/landmark/start/job/survivor,
/obj/effect/landmark/start/latejoinsurvivor,
/turf/open/floor/grimy,
/area/bigredv3/inside/colony/dorm)
"jB" = (
/obj/machinery/atmospherics/pipe/simple/green/hidden{
	dir = 5
	},
/obj/structure/cable,
/turf/open/floor,
/area/bigredv3/inside/colony/dorm)
"jW" = (
/obj/effect/decal/cleanable/dirt,
/obj/machinery/atmospherics/pipe/simple/green/hidden{
	dir = 4
	},
/turf/open/floor/grimy,
/area/bigredv3/inside/colony/dorm)
"kG" = (
/obj/machinery/atmospherics/pipe/manifold/green/hidden{
	dir = 1
	},
/obj/structure/cable,
/turf/open/floor,
/area/bigredv3/inside/colony/dorm)
"lS" = (
/obj/effect/ai_node,
/obj/structure/cable,
/turf/open/floor,
/area/bigredv3/inside/colony/dorm)
"lT" = (
/obj/structure/bed/chair{
	dir = 1
	},
/turf/open/floor,
/area/bigredv3/inside/colony/dorm)
"lX" = (
/obj/effect/decal/cleanable/dirt,
/obj/effect/decal/cleanable/dirt,
/obj/item/trash/plate,
/turf/open/floor,
/area/bigredv3/inside/colony/dorm)
"mF" = (
/turf/open/floor/grimy,
/area/bigredv3/inside/colony/dorm)
"pi" = (
/obj/structure/bed/chair{
	dir = 8
	},
/turf/open/floor,
/area/bigredv3/inside/colony/dorm)
"qM" = (
/obj/machinery/power/apc/weak/ntf,
/obj/structure/cable,
/turf/open/floor,
/area/bigredv3/inside/colony/dorm)
"rr" = (
/obj/structure/bed/chair{
	dir = 1
	},
/obj/machinery/atmospherics/pipe/simple/green/hidden,
/turf/open/floor,
/area/bigredv3/inside/colony/dorm)
"sn" = (
/obj/effect/decal/cleanable/dirt,
/turf/open/floor,
/area/bigredv3/inside/colony/dorm)
"sS" = (
/obj/machinery/light,
/obj/machinery/atmospherics/pipe/manifold/green/hidden,
/obj/structure/cable,
/turf/open/floor,
/area/bigredv3/inside/colony/dorm)
"tr" = (
/obj/structure/table,
/obj/effect/spawner/random/engineering/powercell,
/obj/machinery/atmospherics/components/unary/vent_pump,
/turf/open/floor,
/area/bigredv3/inside/colony/dorm)
"tJ" = (
/obj/effect/decal/cleanable/dirt,
/obj/effect/decal/cleanable/dirt,
/turf/open/floor/grimy,
/area/bigredv3/inside/colony/dorm)
"tZ" = (
/obj/machinery/light{
	dir = 1
	},
/turf/open/floor,
/area/bigredv3/inside/colony/dorm)
"ul" = (
/obj/structure/table,
/turf/open/floor,
/area/bigredv3/inside/colony/dorm)
"vy" = (
/obj/machinery/air_alarm,
/turf/open/floor,
/area/bigredv3/inside/colony/dorm)
"vT" = (
/obj/machinery/atmospherics/pipe/simple/green/hidden{
	dir = 4
	},
/obj/effect/decal/cleanable/dirt,
/obj/structure/cable,
/turf/open/floor,
/area/bigredv3/inside/colony/dorm)
"wd" = (
/obj/machinery/atmospherics/pipe/simple/green/hidden,
/obj/effect/ai_node,
/obj/structure/cable,
/turf/open/floor,
/area/bigredv3/inside/colony/dorm)
"wJ" = (
/obj/effect/ai_node,
/turf/open/floor,
/area/bigredv3/inside/colony/dorm)
"yd" = (
/obj/machinery/vending/cola,
/obj/machinery/atmospherics/pipe/simple/green/hidden{
	dir = 4
	},
/obj/structure/cable,
/turf/open/floor,
/area/bigredv3/inside/colony/dorm)
"yT" = (
/obj/structure/bed/chair,
/obj/effect/ai_node,
/turf/open/floor,
/area/bigredv3/inside/colony/dorm)
"zv" = (
/obj/machinery/atmospherics/pipe/simple/green/hidden,
/obj/structure/cable,
/turf/open/floor,
/area/bigredv3/inside/colony/dorm)
"AC" = (
/obj/machinery/light,
/obj/machinery/atmospherics/pipe/simple/green/hidden{
	dir = 4
	},
/obj/structure/cable,
/turf/open/floor,
/area/bigredv3/inside/colony/dorm)
"Bd" = (
/obj/machinery/atmospherics/pipe/simple/green/hidden{
	dir = 6
	},
/obj/structure/cable,
/turf/open/floor/grimy,
/area/bigredv3/inside/colony/dorm)
"Bq" = (
/obj/machinery/atmospherics/pipe/simple/green/hidden,
/turf/open/floor,
/area/bigredv3/inside/colony/dorm)
"BU" = (
/obj/machinery/atmospherics/pipe/manifold/green/hidden{
	dir = 1
	},
/obj/effect/decal/cleanable/dirt,
/obj/structure/cable,
/turf/open/floor,
/area/bigredv3/inside/colony/dorm)
"BZ" = (
/obj/machinery/atmospherics/pipe/simple/green/hidden{
	dir = 4
	},
/obj/machinery/door_control{
	dir = 1;
	id = "Dormitories";
	name = "Storm Shutters"
	},
/obj/structure/cable,
/turf/open/floor,
/area/bigredv3/inside/colony/dorm)
"Cg" = (
/obj/machinery/atmospherics/pipe/simple/green/hidden{
	dir = 4
	},
/obj/effect/ai_node,
/obj/structure/cable,
/turf/open/floor,
/area/bigredv3/inside/colony/dorm)
"Cz" = (
/obj/structure/table,
/obj/item/radio/survivor,
/turf/open/floor,
/area/bigredv3/inside/colony/dorm)
"Dq" = (
/obj/effect/decal/cleanable/dirt,
/obj/item/trash/pistachios,
/turf/open/floor,
/area/bigredv3/inside/colony/dorm)
"DI" = (
/obj/effect/ai_node,
/turf/open/floor/grimy,
/area/bigredv3/inside/colony/dorm)
"ES" = (
/obj/machinery/light{
	dir = 1
	},
/obj/effect/decal/cleanable/dirt,
/turf/open/floor,
/area/bigredv3/inside/colony/dorm)
"Gz" = (
/obj/structure/bed/chair{
	dir = 4
	},
/turf/open/floor,
/area/bigredv3/inside/colony/dorm)
"Jn" = (
/obj/machinery/atmospherics/components/unary/vent_pump,
/turf/open/floor,
/area/bigredv3/inside/colony/dorm)
"JI" = (
/obj/structure/table,
/obj/effect/spawner/random/engineering/toolbox,
/turf/open/floor,
/area/bigredv3/inside/colony/dorm)
"JU" = (
/obj/effect/decal/cleanable/dirt,
/obj/machinery/atmospherics/components/unary/vent_pump{
	dir = 4;
	on = 1
	},
/turf/open/floor/grimy,
/area/bigredv3/inside/colony/dorm)
"Lx" = (
/obj/structure/table,
/obj/effect/spawner/random/engineering/tool,
/turf/open/floor,
/area/bigredv3/inside/colony/dorm)
"Mp" = (
/obj/structure/table,
/obj/item/ashtray/bronze,
/turf/open/floor,
/area/bigredv3/inside/colony/dorm)
"Om" = (
/obj/structure/bed/chair,
/turf/open/floor,
/area/bigredv3/inside/colony/dorm)
"Rl" = (
/obj/structure/bed/chair{
	dir = 4
	},
/obj/effect/landmark/start/job/survivor,
/obj/effect/landmark/start/latejoinsurvivor,
/turf/open/floor,
/area/bigredv3/inside/colony/dorm)
"RW" = (
/obj/machinery/atmospherics/pipe/simple/green/hidden{
	dir = 4
	},
/obj/structure/prop/tgbrokenvendor/snackbrokebed,
/obj/structure/cable,
/turf/open/floor,
/area/bigredv3/inside/colony/dorm)
"Th" = (
/obj/effect/decal/cleanable/dirt,
/obj/machinery/atmospherics/pipe/manifold/green/hidden{
	dir = 4
	},
/obj/structure/cable,
/turf/open/floor/grimy,
/area/bigredv3/inside/colony/dorm)
"TX" = (
/obj/effect/decal/cleanable/dirt,
/turf/open/floor/grimy,
/area/bigredv3/inside/colony/dorm)
"Uw" = (
/obj/structure/noticeboard{
	dir = 1;
	pixel_y = -27
	},
/obj/machinery/atmospherics/pipe/simple/green/hidden{
	dir = 4
	},
/obj/structure/cable,
/turf/open/floor,
/area/bigredv3/inside/colony/dorm)
"US" = (
/obj/structure/table,
/obj/item/trash/plate,
/turf/open/floor,
/area/bigredv3/inside/colony/dorm)
"Wu" = (
/obj/machinery/atmospherics/pipe/simple/green/hidden,
/obj/structure/cable,
/turf/open/floor/grimy,
/area/bigredv3/inside/colony/dorm)
"WC" = (
/obj/structure/cable,
/turf/open/floor,
/area/bigredv3/inside/colony/dorm)
"Xh" = (
/obj/machinery/vending/cigarette/colony,
/obj/machinery/atmospherics/pipe/manifold/green/hidden,
/obj/structure/cable,
/turf/open/floor,
/area/bigredv3/inside/colony/dorm)

(1,1,1) = {"
zv
wd
zv
zv
zv
zv
jB
"}
(2,1,1) = {"
lX
sn
wJ
sn
Dq
sn
vT
"}
(3,1,1) = {"
ES
sn
am
wJ
am
am
BU
"}
(4,1,1) = {"
am
am
Gz
Rl
am
sn
gp
"}
(5,1,1) = {"
am
yT
ul
Lx
lT
am
RW
"}
(6,1,1) = {"
am
Om
Mp
tr
rr
Bq
Xh
"}
(7,1,1) = {"
am
Om
ul
US
lT
am
yd
"}
(8,1,1) = {"
am
Om
Cz
Lx
lT
Jn
sS
"}
(9,1,1) = {"
am
yT
JI
ul
lT
am
gp
"}
(10,1,1) = {"
am
am
pi
pi
am
am
Uw
"}
(11,1,1) = {"
qM
lS
WC
WC
WC
WC
BZ
"}
(12,1,1) = {"
vy
am
am
am
am
am
kG
"}
(13,1,1) = {"
am
am
sn
sn
sn
sn
gp
"}
(14,1,1) = {"
am
mF
TX
TX
TX
TX
gp
"}
(15,1,1) = {"
tZ
mF
mF
mF
mF
TX
gp
"}
(16,1,1) = {"
am
DI
mF
JU
mF
TX
Cg
"}
(17,1,1) = {"
wJ
mF
mF
jW
tJ
hT
AC
"}
(18,1,1) = {"
am
Bd
Wu
Th
dY
Wu
gy
"}
(19,1,1) = {"
am
gp
am
am
am
am
gp
"}
