//MAP CONVERTED BY dmm2tgm.py THIS HEADER COMMENT PREVENTS RECONVERSION, DO NOT REMOVE
"am" = (
/obj/docking_port/stationary/crashmode,
/turf/open/floor,
/area/bigredv2/outside/dorms)
"dY" = (
/obj/effect/decal/cleanable/dirt,
/obj/machinery/atmospherics/pipe/simple/green/hidden,
/obj/structure/cable,
/turf/open/floor/grimy,
/area/bigredv2/outside/dorms)
"gp" = (
/obj/machinery/atmospherics/pipe/simple/green/hidden{
	dir = 4
	},
/obj/structure/cable,
/turf/open/floor,
/area/bigredv2/outside/dorms)
"gy" = (
/obj/machinery/atmospherics/pipe/manifold/green/hidden,
/obj/structure/cable,
/turf/open/floor,
/area/bigredv2/outside/dorms)
"hT" = (
/obj/effect/decal/cleanable/dirt,
/obj/effect/landmark/start/job/survivor,
/obj/effect/landmark/start/latejoinsurvivor,
/turf/open/floor/grimy,
/area/bigredv2/outside/dorms)
"jB" = (
/obj/machinery/atmospherics/pipe/simple/green/hidden{
	dir = 5
	},
/obj/structure/cable,
/turf/open/floor,
/area/bigredv2/outside/dorms)
"jW" = (
/obj/effect/decal/cleanable/dirt,
/obj/machinery/atmospherics/pipe/simple/green/hidden{
	dir = 4
	},
/turf/open/floor/grimy,
/area/bigredv2/outside/dorms)
"kG" = (
/obj/machinery/atmospherics/pipe/manifold/green/hidden{
	dir = 1
	},
/obj/structure/cable,
/turf/open/floor,
/area/bigredv2/outside/dorms)
"lT" = (
/obj/structure/bed/chair{
	dir = 1
	},
/turf/open/floor,
/area/bigredv2/outside/dorms)
"lX" = (
/obj/effect/decal/cleanable/dirt,
/obj/effect/decal/cleanable/dirt,
/obj/item/trash/plate,
/turf/open/floor,
/area/bigredv2/outside/dorms)
"mF" = (
/turf/open/floor/grimy,
/area/bigredv2/outside/dorms)
"pi" = (
/obj/structure/bed/chair{
	dir = 8
	},
/turf/open/floor,
/area/bigredv2/outside/dorms)
"qM" = (
/obj/machinery/power/apc/high/ntf,
/turf/open/floor,
/area/bigredv2/outside/dorms)
"rr" = (
/obj/structure/bed/chair{
	dir = 1
	},
/obj/machinery/atmospherics/pipe/simple/green/hidden,
/turf/open/floor,
/area/bigredv2/outside/dorms)
"sn" = (
/obj/effect/decal/cleanable/dirt,
/turf/open/floor,
/area/bigredv2/outside/dorms)
"sS" = (
/obj/machinery/light,
/obj/machinery/atmospherics/pipe/manifold/green/hidden,
/obj/structure/cable,
/turf/open/floor,
/area/bigredv2/outside/dorms)
"tr" = (
/obj/structure/table,
/obj/effect/spawner/random/engineering/powercell,
/obj/machinery/atmospherics/components/unary/vent_pump,
/turf/open/floor,
/area/bigredv2/outside/dorms)
"tJ" = (
/obj/effect/decal/cleanable/dirt,
/obj/effect/decal/cleanable/dirt,
/turf/open/floor/grimy,
/area/bigredv2/outside/dorms)
"tZ" = (
/obj/machinery/light{
	dir = 1
	},
/turf/open/floor,
/area/bigredv2/outside/dorms)
"ul" = (
/obj/structure/table,
/turf/open/floor,
/area/bigredv2/outside/dorms)
"vy" = (
/obj/machinery/air_alarm,
/turf/open/floor,
/area/bigredv2/outside/dorms)
"vT" = (
/obj/machinery/atmospherics/pipe/simple/green/hidden{
	dir = 4
	},
/obj/effect/decal/cleanable/dirt,
/obj/structure/cable,
/turf/open/floor,
/area/bigredv2/outside/dorms)
"wd" = (
/obj/machinery/atmospherics/pipe/simple/green/hidden,
/obj/effect/ai_node,
/obj/structure/cable,
/turf/open/floor,
/area/bigredv2/outside/dorms)
"wJ" = (
/obj/effect/ai_node,
/turf/open/floor,
/area/bigredv2/outside/dorms)
"yd" = (
/obj/machinery/vending/cola,
/obj/machinery/atmospherics/pipe/simple/green/hidden{
	dir = 4
	},
/obj/structure/cable,
/turf/open/floor,
/area/bigredv2/outside/dorms)
"yT" = (
/obj/structure/bed/chair,
/obj/effect/ai_node,
/turf/open/floor,
/area/bigredv2/outside/dorms)
"zv" = (
/obj/machinery/atmospherics/pipe/simple/green/hidden,
/obj/structure/cable,
/turf/open/floor,
/area/bigredv2/outside/dorms)
"AC" = (
/obj/machinery/light,
/obj/machinery/atmospherics/pipe/simple/green/hidden{
	dir = 4
	},
/obj/structure/cable,
/turf/open/floor,
/area/bigredv2/outside/dorms)
"Bd" = (
/obj/machinery/atmospherics/pipe/simple/green/hidden{
	dir = 6
	},
/obj/structure/cable,
/turf/open/floor/grimy,
/area/bigredv2/outside/dorms)
"Bq" = (
/obj/machinery/atmospherics/pipe/simple/green/hidden,
/turf/open/floor,
/area/bigredv2/outside/dorms)
"BU" = (
/obj/machinery/atmospherics/pipe/manifold/green/hidden{
	dir = 1
	},
/obj/effect/decal/cleanable/dirt,
/obj/structure/cable,
/turf/open/floor,
/area/bigredv2/outside/dorms)
"BZ" = (
/obj/machinery/atmospherics/pipe/simple/green/hidden{
	dir = 4
	},
/obj/machinery/door_control{
	dir = 1;
	id = "Dormitories";
	name = "Storm Shutters"
	},
/obj/structure/cable,
/turf/open/floor,
/area/bigredv2/outside/dorms)
"Cg" = (
/obj/machinery/atmospherics/pipe/simple/green/hidden{
	dir = 4
	},
/obj/effect/ai_node,
/obj/structure/cable,
/turf/open/floor,
/area/bigredv2/outside/dorms)
"Cz" = (
/obj/structure/table,
/obj/item/radio/survivor,
/turf/open/floor,
/area/bigredv2/outside/dorms)
"Dq" = (
/obj/effect/decal/cleanable/dirt,
/obj/item/trash/pistachios,
/turf/open/floor,
/area/bigredv2/outside/dorms)
"DI" = (
/obj/effect/ai_node,
/turf/open/floor/grimy,
/area/bigredv2/outside/dorms)
"ES" = (
/obj/machinery/light{
	dir = 1
	},
/obj/effect/decal/cleanable/dirt,
/turf/open/floor,
/area/bigredv2/outside/dorms)
"Gz" = (
/obj/structure/bed/chair{
	dir = 4
	},
/turf/open/floor,
/area/bigredv2/outside/dorms)
"Ha" = (
/turf/open/floor,
/area/bigredv2/outside/dorms)
"Jn" = (
/obj/machinery/atmospherics/components/unary/vent_pump,
/turf/open/floor,
/area/bigredv2/outside/dorms)
"JI" = (
/obj/structure/table,
/obj/effect/spawner/random/engineering/toolbox,
/turf/open/floor,
/area/bigredv2/outside/dorms)
"JU" = (
/obj/effect/decal/cleanable/dirt,
/obj/machinery/atmospherics/components/unary/vent_pump{
	dir = 4;
	on = 1
	},
/turf/open/floor/grimy,
/area/bigredv2/outside/dorms)
"Lx" = (
/obj/structure/table,
/obj/effect/spawner/random/engineering/tool,
/turf/open/floor,
/area/bigredv2/outside/dorms)
"Mp" = (
/obj/structure/table,
/obj/item/ashtray/bronze,
/turf/open/floor,
/area/bigredv2/outside/dorms)
"Om" = (
/obj/structure/bed/chair,
/turf/open/floor,
/area/bigredv2/outside/dorms)
"Rl" = (
/obj/structure/bed/chair{
	dir = 4
	},
/obj/effect/landmark/start/job/survivor,
/obj/effect/landmark/start/latejoinsurvivor,
/turf/open/floor,
/area/bigredv2/outside/dorms)
"RW" = (
/obj/machinery/atmospherics/pipe/simple/green/hidden{
	dir = 4
	},
/obj/structure/prop/tgbrokenvendor/snackbrokebed,
/obj/structure/cable,
/turf/open/floor,
/area/bigredv2/outside/dorms)
"Th" = (
/obj/effect/decal/cleanable/dirt,
/obj/machinery/atmospherics/pipe/manifold/green/hidden{
	dir = 4
	},
/obj/structure/cable,
/turf/open/floor/grimy,
/area/bigredv2/outside/dorms)
"TX" = (
/obj/effect/decal/cleanable/dirt,
/turf/open/floor/grimy,
/area/bigredv2/outside/dorms)
"Uw" = (
/obj/structure/noticeboard{
	dir = 1;
	pixel_y = -27
	},
/obj/machinery/atmospherics/pipe/simple/green/hidden{
	dir = 4
	},
/obj/structure/cable,
/turf/open/floor,
/area/bigredv2/outside/dorms)
"US" = (
/obj/structure/table,
/obj/item/trash/plate,
/turf/open/floor,
/area/bigredv2/outside/dorms)
"Wu" = (
/obj/machinery/atmospherics/pipe/simple/green/hidden,
/obj/structure/cable,
/turf/open/floor/grimy,
/area/bigredv2/outside/dorms)
"Xh" = (
/obj/machinery/vending/cigarette/colony,
/obj/machinery/atmospherics/pipe/manifold/green/hidden,
/obj/structure/cable,
/turf/open/floor,
/area/bigredv2/outside/dorms)

(1,1,1) = {"
zv
wd
zv
zv
zv
zv
jB
"}
(2,1,1) = {"
lX
sn
wJ
sn
Dq
sn
vT
"}
(3,1,1) = {"
ES
sn
Ha
wJ
Ha
Ha
BU
"}
(4,1,1) = {"
Ha
Ha
Gz
Rl
Ha
sn
gp
"}
(5,1,1) = {"
Ha
yT
ul
Lx
lT
Ha
RW
"}
(6,1,1) = {"
Ha
Om
Mp
tr
rr
Bq
Xh
"}
(7,1,1) = {"
Ha
Om
ul
US
lT
Ha
yd
"}
(8,1,1) = {"
Ha
Om
Cz
Lx
lT
Jn
sS
"}
(9,1,1) = {"
Ha
yT
JI
ul
lT
Ha
gp
"}
(10,1,1) = {"
Ha
Ha
pi
pi
Ha
Ha
Uw
"}
(11,1,1) = {"
qM
wJ
Ha
Ha
Ha
Ha
BZ
"}
(12,1,1) = {"
vy
Ha
Ha
Ha
Ha
am
kG
"}
(13,1,1) = {"
Ha
Ha
sn
sn
sn
sn
gp
"}
(14,1,1) = {"
Ha
mF
TX
TX
TX
TX
gp
"}
(15,1,1) = {"
tZ
mF
mF
mF
mF
TX
gp
"}
(16,1,1) = {"
Ha
DI
mF
JU
mF
TX
Cg
"}
(17,1,1) = {"
wJ
mF
mF
jW
tJ
hT
AC
"}
(18,1,1) = {"
Ha
Bd
Wu
Th
dY
Wu
gy
"}
(19,1,1) = {"
Ha
gp
Ha
Ha
Ha
Ha
gp
"}
