//MAP CONVERTED BY dmm2tgm.py THIS HEADER COMMENT PREVENTS RECONVERSION, DO NOT REMOVE
"b" = (
/turf/open/floor/plating/ground/mars/random/cave,
/area/bigredv2/caves/east)
"h" = (
/obj/machinery/miner/damaged/platinum,
/turf/open/floor/plating/ground/mars/random/cave,
/area/bigredv2/caves/southeast)
"i" = (
/obj/effect/landmark/xeno_silo_spawn,
/turf/open/floor/plating/ground/mars/random/cave,
/area/bigredv2/caves/southeast)
"k" = (
/turf/closed/mineral/smooth/bigred/indestructible,
/area/space)
"l" = (
/turf/open/floor/plating/ground/mars/random/cave,
/area/bigredv2/caves/southeast)
"o" = (
/obj/machinery/miner/damaged/platinum,
/turf/open/floor/plating/ground/mars/random/cave,
/area/bigredv2/caves/southeast/garbledradio)
"p" = (
/obj/docking_port/stationary/crashmode,
/turf/closed/mineral/smooth/bigred,
/area/bigredv2/caves/rock)
"r" = (
/turf/closed/mineral/smooth/bigred,
/area/bigredv2/caves/rock)
"s" = (
/turf/open/space/basic,
/area/space)
"t" = (
/turf/open/floor/plating/ground/mars/random/cave/rock,
/area/bigredv2/caves/southeast/garbledradio)
"w" = (
/obj/effect/ai_node,
/turf/open/floor/plating/ground/mars/random/cave/rock,
/area/bigredv2/caves/southeast/garbledradio)
"z" = (
/turf/open/floor/plating/ground/mars/random/cave,
/area/bigredv2/caves/southeast/garbledradio)
"A" = (
/obj/effect/ai_node,
/turf/open/floor/plating/ground/mars/random/cave,
/area/bigredv2/caves/southeast)
"D" = (
/turf/open/floor/plating/ground/mars/random/cave/rock,
/area/bigredv2/caves/southeast)
"L" = (
/obj/effect/landmark/patrol_point/tgmc_11,
/turf/open/floor/plating/ground/mars/random/cave,
/area/bigredv2/caves/southeast)
"R" = (
/obj/effect/landmark/lv624/fog_blocker/xeno_spawn,
/turf/open/floor/plating/ground/mars/random/cave,
/area/bigredv2/caves/southeast)
"S" = (
/obj/effect/ai_node,
/turf/open/floor/plating/ground/mars/random/cave,
/area/bigredv2/caves/southeast/garbledradio)
"U" = (
/obj/effect/landmark/lv624/fog_blocker/xeno_spawn,
/turf/closed/mineral/smooth/bigred,
/area/bigredv2/caves/rock)
"X" = (
/turf/closed/mineral/smooth/bigred/indestructible,
/area/bigredv2/caves/rock)

(1,1,1) = {"
r
r
r
r
r
r
r
r
r
r
r
r
r
r
r
r
z
z
z
z
z
z
t
r
r
r
r
r
r
r
r
l
l
l
l
l
l
r
r
r
r
r
r
r
r
r
r
r
r
r
l
l
l
l
r
r
r
r
r
r
r
r
r
r
k
k
s
"}
(2,1,1) = {"
b
r
r
r
r
r
r
r
r
r
r
r
r
r
t
t
z
z
z
r
z
z
t
r
r
r
r
r
r
r
r
l
l
l
l
l
r
r
r
r
r
r
r
r
r
r
r
r
r
r
l
l
l
l
r
r
r
r
r
r
r
r
r
r
r
k
s
"}
(3,1,1) = {"
r
r
r
r
r
r
r
r
r
r
r
r
r
r
z
z
z
z
z
r
t
z
t
r
r
r
r
r
r
r
r
l
l
l
l
l
r
r
r
r
r
r
r
r
r
r
r
r
r
r
l
l
l
l
r
r
r
r
r
r
r
r
r
r
r
k
s
"}
(4,1,1) = {"
r
r
r
r
r
r
r
r
r
r
r
r
r
w
z
z
S
z
r
r
r
z
t
r
r
r
r
r
r
r
r
l
l
l
l
l
r
r
r
r
r
r
r
r
r
r
r
r
r
r
l
l
l
l
r
r
r
r
r
r
r
r
r
r
r
k
s
"}
(5,1,1) = {"
r
r
r
r
r
r
r
r
r
r
r
r
r
z
z
t
z
z
r
r
r
z
t
r
r
r
r
r
r
r
r
l
l
l
l
l
r
r
r
r
r
r
r
r
r
r
r
r
r
r
l
l
A
l
r
r
r
r
r
r
r
r
r
r
r
k
s
"}
(6,1,1) = {"
r
r
r
r
r
r
r
r
r
r
r
t
t
z
z
t
z
z
r
r
r
z
t
r
r
r
r
r
r
r
r
l
l
l
l
l
r
r
p
r
r
r
r
r
r
r
r
r
r
r
l
l
l
l
r
r
r
r
r
r
r
r
r
r
r
k
s
"}
(7,1,1) = {"
r
r
r
r
r
r
r
r
r
r
r
z
z
z
t
z
z
r
r
r
r
z
t
r
r
r
r
r
r
r
r
l
l
l
l
l
r
r
r
r
r
r
r
r
r
r
r
r
r
r
l
l
l
l
r
r
r
r
r
r
r
r
r
r
r
k
s
"}
(8,1,1) = {"
r
r
r
r
r
r
r
r
r
r
r
z
z
S
z
r
r
r
r
r
r
z
t
r
r
r
r
r
r
r
r
l
l
l
l
l
r
r
r
r
r
r
r
r
r
r
r
r
r
r
l
l
l
l
r
r
r
r
r
r
r
r
r
r
r
k
s
"}
(9,1,1) = {"
r
r
r
r
r
r
r
r
r
r
r
z
w
z
z
r
r
r
r
r
r
z
t
r
r
r
r
r
r
r
r
l
l
l
l
l
r
r
r
r
r
r
r
r
r
r
r
r
r
r
l
l
l
l
r
r
r
r
r
r
r
r
r
r
r
k
s
"}
(10,1,1) = {"
r
r
r
r
r
r
r
r
r
r
t
z
t
z
z
r
r
r
r
z
z
S
t
r
r
r
r
r
r
r
l
l
l
l
l
l
r
r
r
r
r
r
r
r
r
r
r
r
r
r
l
l
l
l
r
r
r
r
r
r
r
r
r
r
r
k
s
"}
(11,1,1) = {"
r
r
r
r
r
r
r
r
r
r
z
z
t
z
t
t
t
t
t
z
z
z
t
r
r
r
r
r
r
l
l
l
l
A
l
l
l
r
r
r
r
r
r
r
r
r
r
r
r
r
l
l
l
l
r
r
r
r
r
r
r
r
r
r
r
k
s
"}
(12,1,1) = {"
p
r
r
r
r
r
r
r
r
r
z
z
z
t
z
z
z
z
t
z
z
z
r
r
r
r
r
l
A
l
l
l
A
l
l
l
l
r
r
r
r
r
r
r
r
r
r
r
r
r
l
l
l
r
r
r
r
r
r
r
r
r
r
r
r
k
s
"}
(13,1,1) = {"
r
r
r
r
r
r
r
r
r
r
z
z
z
z
z
z
S
z
z
z
z
z
r
r
r
r
r
l
l
l
l
l
l
l
l
l
l
r
r
r
r
r
r
r
r
r
r
r
r
l
l
l
l
r
r
r
r
r
r
r
r
r
r
r
r
k
s
"}
(14,1,1) = {"
t
z
r
r
r
r
r
r
r
t
z
z
z
z
z
z
z
z
z
z
z
t
r
r
r
r
r
l
l
l
l
l
l
l
l
l
l
l
l
r
r
r
r
r
r
r
r
r
r
l
l
l
A
r
r
r
r
r
r
r
r
r
r
r
r
k
s
"}
(15,1,1) = {"
t
r
r
r
r
r
r
r
r
z
S
z
S
z
z
z
S
z
z
t
r
r
r
r
r
l
l
l
l
l
l
l
l
l
l
l
l
l
l
l
l
r
r
r
r
r
r
r
l
l
l
A
l
r
r
r
r
r
r
r
r
r
r
r
r
k
s
"}
(16,1,1) = {"
t
r
r
r
r
r
r
t
t
z
t
z
z
z
z
z
z
z
z
z
z
r
r
r
r
l
l
l
l
l
l
l
l
l
l
l
l
l
l
l
l
l
l
l
l
r
r
r
l
l
l
l
l
r
r
r
r
r
r
r
r
r
r
r
r
k
s
"}
(17,1,1) = {"
z
r
r
r
r
r
r
z
z
z
t
z
z
z
r
r
r
D
z
z
z
r
r
r
r
l
l
l
l
l
l
l
l
l
l
l
l
l
l
l
l
l
l
l
l
l
l
l
l
l
l
l
r
r
r
r
r
r
r
r
r
r
r
r
r
k
s
"}
(18,1,1) = {"
z
r
r
r
r
r
r
t
z
t
z
z
z
r
r
r
r
r
z
z
A
l
l
l
l
l
l
l
l
l
l
l
l
l
l
l
l
l
l
l
l
l
l
l
l
l
l
l
l
l
l
l
r
r
r
r
r
r
r
r
r
r
r
r
r
k
s
"}
(19,1,1) = {"
z
r
r
r
r
r
z
z
z
t
z
r
r
r
r
r
r
r
r
r
l
l
l
l
l
l
l
l
A
l
l
l
l
A
l
l
l
l
l
l
l
l
A
l
l
l
l
h
l
A
l
A
r
r
r
r
r
r
r
r
r
r
r
r
r
X
s
"}
(20,1,1) = {"
z
r
r
z
z
z
S
z
z
z
S
r
r
r
r
r
r
r
r
r
l
l
l
l
l
l
l
l
l
l
l
l
l
l
l
l
l
l
l
l
l
l
l
l
l
l
l
l
l
l
l
l
r
r
r
r
r
r
r
r
r
r
r
r
r
X
s
"}
(21,1,1) = {"
z
z
z
z
z
z
z
z
t
z
r
r
r
r
r
r
r
r
r
r
A
l
l
l
A
l
l
l
A
l
l
l
l
l
l
l
l
l
l
l
l
l
l
l
l
l
l
l
l
l
l
r
r
r
r
r
r
r
r
r
r
r
r
r
r
X
s
"}
(22,1,1) = {"
z
z
z
z
t
t
z
z
z
z
r
r
r
r
r
r
r
r
r
r
r
l
l
l
l
l
l
l
l
l
h
l
l
l
l
l
l
r
r
r
r
l
l
l
l
l
l
l
l
l
r
r
r
r
r
r
r
r
r
r
r
r
r
r
r
X
s
"}
(23,1,1) = {"
o
S
z
t
z
z
S
z
z
r
r
r
r
r
r
r
r
r
r
r
r
r
l
l
l
l
l
l
l
l
l
l
l
l
l
l
r
r
r
r
r
r
r
r
r
r
r
r
r
r
r
r
r
r
r
r
r
r
r
r
r
r
r
r
r
X
s
"}
(24,1,1) = {"
z
t
t
z
z
z
z
t
r
r
r
r
r
r
r
r
r
r
r
r
r
r
r
l
l
l
l
l
l
l
l
l
l
l
l
l
r
r
r
r
r
r
r
r
r
r
r
r
r
r
r
r
r
r
r
r
r
r
r
r
r
r
r
r
r
X
s
"}
(25,1,1) = {"
t
z
z
t
r
r
r
r
r
r
r
r
r
r
r
r
r
r
r
r
r
r
r
r
A
l
l
l
l
A
l
l
l
l
l
l
r
r
r
r
r
r
r
r
r
r
r
r
r
r
r
r
r
r
r
r
r
r
r
r
r
r
r
r
r
X
s
"}
(26,1,1) = {"
z
z
z
t
r
r
r
r
r
r
r
r
r
r
r
r
r
r
r
r
r
r
r
r
r
l
l
l
A
l
l
l
l
A
l
r
r
r
r
r
r
r
r
r
r
r
r
r
r
r
r
r
r
r
r
r
r
r
r
r
r
r
r
r
r
X
s
"}
(27,1,1) = {"
r
r
r
r
r
r
r
r
r
r
r
r
r
r
r
r
r
r
r
r
r
r
r
r
r
l
l
l
l
l
l
l
l
l
l
r
r
r
r
r
r
r
r
r
r
r
r
r
r
r
r
r
r
r
r
r
r
r
r
r
r
r
r
r
r
X
s
"}
(28,1,1) = {"
r
r
r
r
r
r
r
r
r
r
r
r
r
r
r
r
r
r
r
r
r
r
r
r
r
l
l
l
l
l
l
l
l
l
r
r
r
r
r
r
r
r
r
r
r
r
r
r
r
r
r
r
r
r
r
r
r
r
r
r
r
r
r
r
r
X
s
"}
(29,1,1) = {"
r
r
r
r
r
r
r
r
r
r
r
r
r
r
r
r
r
r
r
r
r
r
r
r
r
l
l
l
l
l
l
l
l
r
r
r
r
r
r
r
r
r
r
r
r
r
r
r
r
r
r
r
r
r
r
r
r
r
r
r
r
r
r
r
r
X
s
"}
(30,1,1) = {"
r
r
r
r
r
r
r
r
r
r
r
r
r
r
r
r
r
r
r
r
r
r
r
r
r
l
l
l
A
l
l
l
r
r
r
r
r
r
r
r
r
r
r
r
r
r
r
r
r
r
r
r
r
r
r
r
r
r
r
r
r
r
r
r
r
X
s
"}
(31,1,1) = {"
r
r
r
r
r
r
r
r
r
r
r
r
r
r
r
r
r
r
r
r
r
r
r
r
r
l
l
A
l
l
l
r
r
r
r
r
r
r
r
r
r
r
r
r
r
r
r
r
r
r
r
r
r
r
r
r
r
r
r
r
r
r
r
r
r
X
s
"}
(32,1,1) = {"
l
l
r
r
r
r
r
r
r
r
r
r
r
r
r
r
r
r
r
r
r
r
r
r
r
l
l
l
l
l
r
r
r
r
r
r
r
r
r
r
r
r
r
r
r
r
r
r
r
r
r
r
r
r
r
r
r
r
r
r
r
r
r
r
r
X
s
"}
(33,1,1) = {"
l
l
l
l
A
r
r
r
r
r
r
r
r
r
r
r
r
r
r
r
r
r
r
r
r
l
l
l
l
l
r
r
r
r
r
r
r
r
r
r
r
r
r
r
r
r
r
r
r
r
r
r
r
r
r
r
r
r
r
r
r
r
r
r
r
X
s
"}
(34,1,1) = {"
l
l
l
l
l
l
l
r
r
r
r
r
r
r
r
r
r
r
r
r
r
r
r
r
r
l
l
l
l
l
r
r
r
r
r
r
r
r
r
r
r
r
r
r
r
r
r
r
r
r
r
r
r
r
r
r
r
r
r
r
r
r
r
r
r
X
s
"}
(35,1,1) = {"
l
l
l
l
l
l
l
r
r
r
r
r
r
r
r
r
r
r
r
r
r
r
r
r
r
l
l
l
l
l
r
r
r
r
r
r
r
r
r
r
r
r
r
r
r
r
r
r
r
r
r
r
r
r
r
r
r
r
r
r
r
r
r
r
r
X
s
"}
(36,1,1) = {"
l
l
l
l
l
l
l
l
r
l
r
r
r
r
r
r
r
r
r
r
r
r
r
r
l
l
l
l
l
l
r
r
r
r
r
r
r
r
r
r
r
r
r
r
r
r
r
r
r
r
r
r
r
r
r
r
r
r
r
r
r
r
r
r
r
X
s
"}
(37,1,1) = {"
l
l
l
l
A
l
l
A
l
l
l
l
r
r
r
r
r
r
r
r
r
r
U
U
R
R
R
R
R
R
r
r
r
r
r
r
r
r
r
r
r
r
r
r
r
r
r
r
r
r
r
r
r
r
r
r
r
r
r
r
r
r
r
r
r
X
s
"}
(38,1,1) = {"
r
r
l
l
l
l
l
l
l
l
l
l
l
l
r
r
r
r
r
r
r
r
U
r
l
l
l
l
l
U
r
r
r
r
r
r
r
r
r
r
r
r
r
r
r
r
r
r
r
r
r
r
r
r
r
r
r
r
r
r
r
r
r
k
k
k
s
"}
(39,1,1) = {"
r
r
l
l
l
l
l
A
l
l
l
l
l
l
A
l
l
l
r
r
r
r
U
r
l
l
l
l
l
U
r
r
r
r
r
r
r
r
r
r
r
r
r
r
r
r
r
r
r
r
r
r
r
r
r
r
r
r
r
r
r
r
r
k
k
k
s
"}
(40,1,1) = {"
r
r
l
l
l
l
l
l
l
l
l
l
l
l
l
l
l
l
l
r
r
r
U
l
l
l
l
l
l
U
r
r
r
r
r
r
r
r
r
r
r
r
r
r
r
r
r
r
r
r
r
r
r
r
r
r
r
r
r
r
r
r
r
k
k
k
s
"}
(41,1,1) = {"
l
l
l
l
l
l
l
l
l
l
l
l
l
l
l
l
l
l
l
l
r
r
U
l
l
l
l
l
l
U
r
r
r
r
r
r
r
r
r
r
r
r
r
r
r
r
r
r
r
r
r
r
r
r
r
r
r
r
r
r
r
r
r
k
k
k
s
"}
(42,1,1) = {"
l
l
l
l
l
l
l
l
l
l
l
l
l
l
l
l
l
l
l
l
l
l
U
l
l
l
L
l
l
U
r
r
r
r
r
r
r
r
r
r
r
r
r
r
r
r
r
r
r
r
r
r
r
r
r
r
r
r
r
r
r
r
r
k
k
k
s
"}
(43,1,1) = {"
l
l
l
l
l
l
l
l
l
l
l
l
l
l
l
h
l
l
l
l
l
l
R
l
l
l
l
l
l
U
r
r
r
r
r
r
r
r
r
r
r
r
r
r
r
r
r
r
r
r
r
r
r
r
r
r
r
r
r
r
r
r
r
k
k
k
s
"}
(44,1,1) = {"
l
l
l
l
l
l
l
l
l
l
l
l
l
l
l
l
l
l
l
l
l
l
R
l
l
l
l
l
l
U
r
r
r
r
r
r
r
r
r
r
r
r
r
r
r
r
r
r
r
r
r
r
r
r
r
r
r
r
r
r
r
r
r
k
k
k
s
"}
(45,1,1) = {"
l
A
l
l
l
l
l
A
l
l
l
l
l
l
A
l
l
l
l
l
l
l
R
l
l
A
l
A
l
U
r
r
r
r
r
r
r
r
r
r
r
r
r
r
r
r
r
r
r
r
r
r
r
r
r
r
r
r
r
r
r
r
r
k
k
k
s
"}
(46,1,1) = {"
l
l
l
l
l
l
l
l
l
r
l
l
l
l
l
l
l
l
l
l
l
l
R
l
l
i
l
l
l
U
r
r
r
r
r
r
r
r
r
r
r
r
r
r
r
r
r
r
r
r
r
r
r
r
r
r
r
r
r
r
r
r
r
k
k
k
s
"}
(47,1,1) = {"
l
l
l
l
l
l
l
l
l
r
r
r
l
l
l
l
l
l
l
l
l
l
R
l
l
l
l
l
r
U
r
r
r
r
r
r
r
r
r
r
r
r
r
r
r
r
r
r
r
r
r
r
r
r
r
r
r
r
r
r
r
r
r
k
k
k
s
"}
(48,1,1) = {"
l
l
l
l
l
l
l
r
r
r
r
r
r
r
r
l
l
l
l
l
l
l
R
l
l
l
l
r
r
U
r
r
r
r
r
r
r
r
r
r
r
r
r
r
r
r
r
r
r
r
r
r
r
r
r
r
r
r
r
r
r
r
r
k
k
k
s
"}
(49,1,1) = {"
l
A
l
l
l
l
r
r
r
r
r
r
r
r
r
r
r
l
l
l
l
l
R
l
l
r
r
r
r
U
r
r
r
r
r
r
r
r
r
r
r
r
r
r
r
r
r
r
r
r
r
r
r
r
r
r
r
r
r
r
r
r
r
k
k
k
s
"}
(50,1,1) = {"
l
l
l
r
r
r
r
r
r
r
r
r
r
r
r
r
r
r
r
l
l
l
R
r
r
r
r
r
r
U
r
r
r
r
r
r
r
r
r
r
r
r
r
r
r
r
r
r
r
r
r
r
r
r
r
r
r
r
r
r
r
r
r
k
k
k
s
"}
(51,1,1) = {"
l
l
l
r
r
r
r
r
r
r
r
r
r
r
r
r
r
r
r
r
r
r
U
U
U
U
U
U
U
U
r
r
r
r
r
r
r
r
r
r
r
r
r
r
r
r
r
r
r
r
r
r
r
r
r
r
r
r
r
r
r
r
r
k
k
k
s
"}
(52,1,1) = {"
r
r
r
r
r
r
r
r
r
r
r
r
r
r
r
r
r
r
r
r
r
r
r
r
r
r
r
r
r
r
r
r
r
r
r
r
r
r
r
r
r
r
r
r
r
r
r
r
r
r
r
r
r
r
r
r
r
r
r
r
r
r
r
k
k
k
s
"}
(53,1,1) = {"
r
r
r
r
r
r
r
r
r
r
r
r
r
r
r
r
r
r
r
r
r
r
r
r
r
r
r
r
r
r
r
r
r
r
r
r
r
r
r
r
r
r
r
r
r
r
r
r
r
r
r
r
r
r
r
r
r
r
r
r
r
r
r
k
k
k
s
"}
(54,1,1) = {"
r
r
r
r
r
r
r
r
r
r
r
r
r
r
r
r
r
r
r
r
r
r
r
r
r
r
r
r
r
r
r
r
r
r
r
r
r
r
r
r
r
r
r
r
r
r
r
r
r
r
r
r
r
r
r
r
r
r
r
r
r
r
r
k
k
k
s
"}
(55,1,1) = {"
r
r
r
r
r
r
r
r
r
r
r
r
r
r
r
r
r
r
r
r
r
r
r
r
r
r
r
r
r
r
r
r
r
r
r
r
r
r
r
r
r
r
r
r
r
r
r
r
r
r
r
r
r
r
r
r
r
r
r
r
r
r
r
k
k
k
s
"}
(56,1,1) = {"
r
r
r
r
r
r
r
r
r
r
r
r
r
r
r
r
r
r
r
r
r
r
r
r
r
r
r
r
r
r
r
r
r
r
r
r
r
r
r
r
r
r
r
r
r
r
r
r
r
r
r
r
r
r
r
r
r
r
r
r
r
r
r
k
k
k
s
"}
(57,1,1) = {"
r
r
r
r
r
r
r
r
r
r
r
r
r
r
r
r
r
r
r
r
r
r
r
r
r
r
r
r
r
r
r
r
r
r
r
r
r
r
r
r
r
r
r
r
r
r
r
r
r
r
r
r
r
r
r
r
r
r
r
r
r
r
r
k
k
k
s
"}
(58,1,1) = {"
r
r
r
r
r
r
r
r
r
r
r
r
r
r
r
r
r
r
r
r
r
r
r
r
r
r
r
r
r
r
r
r
r
r
r
r
r
r
r
r
r
r
r
r
r
r
r
r
r
r
r
r
r
r
r
r
r
r
r
r
r
r
r
k
k
k
s
"}
(59,1,1) = {"
r
r
r
r
r
r
r
r
r
r
r
r
r
r
r
r
r
r
r
r
r
r
r
r
r
r
r
r
r
r
r
r
r
r
r
r
r
r
r
r
r
r
r
r
r
r
r
r
r
r
r
r
r
r
r
r
r
r
r
r
r
r
r
k
k
k
s
"}
(60,1,1) = {"
r
r
r
r
r
r
r
r
r
r
r
r
r
r
r
r
r
r
r
r
r
r
r
r
r
r
r
r
r
r
r
r
r
r
r
r
r
r
r
r
r
r
r
r
r
r
r
r
r
r
r
r
r
r
r
r
r
r
r
r
r
r
r
k
k
k
s
"}
(61,1,1) = {"
r
r
r
r
r
r
r
r
r
r
r
r
r
r
r
r
r
r
r
r
r
r
r
r
r
r
r
r
r
r
r
r
r
r
r
r
r
r
r
r
r
r
r
r
r
r
r
r
r
r
r
r
r
r
r
r
r
r
r
r
r
r
r
k
k
k
s
"}
(62,1,1) = {"
r
r
r
r
r
r
r
r
r
r
r
r
r
r
r
r
r
r
r
r
r
r
r
r
r
r
r
r
r
r
r
r
r
r
r
r
r
r
r
r
r
r
r
r
r
r
r
r
r
r
r
r
r
r
r
r
r
r
r
r
r
r
r
k
k
k
s
"}
(63,1,1) = {"
k
k
k
k
k
k
k
k
k
k
k
k
k
k
k
k
k
k
k
k
k
k
k
k
k
k
k
k
k
k
k
k
k
k
k
k
k
k
k
k
k
k
k
k
r
r
r
r
r
r
r
r
r
r
r
r
r
r
r
r
r
r
r
k
k
k
s
"}
(64,1,1) = {"
k
k
k
k
k
k
k
k
k
k
k
k
k
k
k
k
k
k
k
k
k
k
k
k
k
k
k
k
k
k
k
k
k
k
k
k
k
k
k
k
k
k
k
k
r
r
r
r
r
r
r
r
r
r
r
r
r
r
r
r
r
r
r
k
k
k
s
"}
(65,1,1) = {"
k
k
k
k
k
k
k
k
k
k
k
k
k
k
k
k
k
k
k
k
k
k
k
k
k
k
k
k
k
k
k
k
k
k
k
k
k
k
k
k
k
k
k
k
r
r
r
r
r
r
r
r
r
r
r
r
r
r
r
r
r
r
r
k
k
k
s
"}
(66,1,1) = {"
k
k
k
k
k
k
k
k
k
k
k
k
k
k
k
k
k
k
k
k
k
k
k
k
k
k
k
k
k
k
k
k
k
k
k
k
k
k
k
k
k
k
k
k
r
r
r
r
r
r
r
r
r
r
r
r
r
r
r
r
r
r
r
k
k
k
s
"}
(67,1,1) = {"
k
k
k
k
k
k
k
k
k
k
k
k
k
k
k
k
k
k
k
k
k
k
k
k
k
k
k
k
k
k
k
k
k
k
k
k
k
k
k
k
k
k
k
k
r
r
r
r
r
r
r
r
r
r
r
r
r
r
r
r
r
r
r
k
k
k
s
"}
(68,1,1) = {"
k
k
k
k
k
k
k
k
k
k
k
k
k
k
k
k
k
k
k
k
k
k
k
k
k
k
k
k
k
k
k
k
k
k
k
k
k
k
k
k
k
k
k
k
r
r
r
r
r
r
r
r
r
r
r
r
r
r
r
r
r
r
r
k
k
k
s
"}
(69,1,1) = {"
k
k
k
k
k
k
k
k
k
k
k
k
k
k
k
k
k
k
k
k
k
k
k
k
k
k
k
k
k
k
k
k
k
k
k
k
k
k
k
k
k
k
k
k
r
r
r
r
r
r
r
r
r
r
r
r
r
r
r
r
r
r
r
k
k
k
s
"}
(70,1,1) = {"
k
k
k
k
k
k
k
k
k
k
k
k
k
k
k
k
k
k
k
k
k
k
k
k
k
k
k
k
k
k
k
k
k
k
k
k
k
k
k
k
k
k
k
k
k
k
k
k
k
r
r
r
r
r
r
r
r
r
r
r
r
r
r
k
k
k
s
"}
(71,1,1) = {"
k
k
k
k
k
k
k
k
k
k
k
k
k
k
k
k
k
k
k
k
k
k
k
k
k
k
k
k
k
k
k
k
k
k
k
k
k
k
k
k
k
k
k
k
k
k
k
k
k
k
k
k
k
k
k
k
k
k
k
k
k
k
k
k
k
k
s
"}
