//MAP CONVERTED BY dmm2tgm.py THIS HEADER COMMENT PREVENTS RECONVERSION, DO NOT REMOVE
"aj" = (
/obj/structure/table,
/obj/effect/spawner/random/engineering/toolbox,
/obj/item/stack/cable_coil,
/turf/open/floor,
/area/bigredv3/inside/colony/dorm)
"aG" = (
/obj/machinery/floodlight/outpost/bigred,
/turf/open/floor/plating/ground/mars/random/sand,
/area/bigredv3/outside/directions/ne)
"aM" = (
/obj/item/clothing/under/darkred,
/turf/open/floor/freezer,
/area/bigredv3/inside/colony/dorm/laundry)
"bh" = (
/obj/structure/bed/chair{
	dir = 1
	},
/turf/open/floor,
/area/bigredv3/inside/colony/dorm/recreation)
"bi" = (
/obj/effect/landmark/lv624/fog_blocker,
/turf/closed/mineral/smooth/bigred,
/area/bigredv3/caves/rock)
"bG" = (
/obj/machinery/atmospherics/pipe/simple/green/hidden{
	dir = 4
	},
/turf/open/floor,
/area/bigredv3/inside/colony/dorm/recreation)
"bT" = (
/obj/effect/ai_node,
/turf/open/floor/tile/dark,
/area/bigredv3/inside/colony/bar)
"cm" = (
/obj/machinery/atmospherics/pipe/simple/green/hidden,
/obj/structure/cable,
/turf/open/floor/tile/green/whitegreenfull,
/area/bigredv3/inside/colony/hydroponics)
"cR" = (
/obj/effect/decal/cleanable/dirt,
/obj/effect/decal/cleanable/dirt,
/obj/machinery/atmospherics/pipe/simple/green/hidden,
/obj/structure/cable,
/turf/open/floor/tile/dark,
/area/bigredv3/inside/colony/bar)
"do" = (
/obj/machinery/atmospherics/components/unary/vent_pump{
	dir = 8;
	on = 1
	},
/obj/effect/ai_node,
/turf/open/floor/tile/dark,
/area/bigredv3/inside/colony/bar)
"dG" = (
/obj/structure/bed,
/turf/open/floor/wood,
/area/bigredv3/inside/colony/dorm)
"dR" = (
/obj/structure/cable,
/obj/machinery/atmospherics/pipe/simple/green/hidden{
	dir = 4
	},
/obj/effect/decal/cleanable/dirt,
/turf/open/floor/asteroidfloor,
/area/bigredv3/outside/directions/ne)
"es" = (
/turf/closed/wall/r_wall,
/area/bigredv3/inside/wall)
"eB" = (
/turf/open/floor/plating/ground/mars/random/dirt,
/area/bigredv3/outside/directions/ne)
"eD" = (
/obj/machinery/hydroponics,
/turf/open/floor/tile/green/whitegreenfull,
/area/bigredv3/inside/colony/hydroponics)
"eR" = (
/obj/machinery/light{
	dir = 8
	},
/obj/effect/ai_node,
/turf/open/floor/wood,
/area/bigredv3/inside/colony/dorm)
"fA" = (
/obj/machinery/atmospherics/components/unary/vent_pump{
	dir = 4;
	on = 1
	},
/obj/structure/cable,
/turf/open/floor/tile/dark,
/area/bigredv3/inside/colony/bar)
"fH" = (
/obj/machinery/light,
/turf/open/floor,
/area/bigredv3/inside/colony/dorm)
"fP" = (
/obj/effect/decal/cleanable/dirt,
/obj/machinery/air_alarm{
	dir = 4
	},
/turf/open/floor/tile/dark,
/area/bigredv3/inside/colony/bar)
"fY" = (
/obj/machinery/vending/tool,
/turf/open/floor,
/area/bigredv3/inside/colony/dorm)
"gg" = (
/obj/structure/rack,
/turf/open/floor/tile/dark,
/area/bigredv3/inside/colony/bar)
"gI" = (
/obj/effect/decal/cleanable/dirt,
/obj/machinery/atmospherics/pipe/simple/green/hidden,
/obj/structure/cable,
/turf/open/floor/tile/dark,
/area/bigredv3/inside/colony/bar)
"gQ" = (
/obj/effect/decal/cleanable/dirt,
/obj/machinery/atmospherics/pipe/simple/green/hidden{
	dir = 6
	},
/obj/effect/ai_node,
/turf/open/floor,
/area/bigredv3/inside/colony/dorm)
"gS" = (
/obj/machinery/door/airlock/mainship/maint/free_access{
	name = "\improper Dormitories EVA Maintenance"
	},
/turf/open/floor/plating,
/area/bigredv3/inside/secondary/maintence)
"hd" = (
/obj/machinery/atmospherics/pipe/manifold/green/hidden{
	dir = 1
	},
/obj/structure/cable,
/obj/effect/ai_node,
/turf/open/floor,
/area/bigredv3/inside/colony/dorm)
"hl" = (
/obj/structure/rack,
/obj/item/stack/sheet/mineral/gold,
/turf/open/floor/tile/dark,
/area/bigredv3/inside/colony/bar)
"hq" = (
/obj/structure/sign/safety/EVA{
	dir = 1
	},
/turf/open/floor,
/area/bigredv3/inside/colony/dorm)
"hG" = (
/obj/effect/spawner/random/engineering/structure/tank_dispenser/oxygenweighted,
/turf/open/floor/tile/dark,
/area/bigredv3/inside/colony/bar)
"hM" = (
/turf/open/floor/plating/ground/mars/random/dirt,
/area/bigredv3/caves/northeast/garbledradio)
"hZ" = (
/obj/machinery/atmospherics/pipe/simple/green/hidden{
	dir = 9
	},
/obj/structure/cable,
/obj/effect/ai_node,
/turf/open/floor,
/area/bigredv3/inside/colony/dorm)
"ii" = (
/obj/effect/ai_node,
/turf/open/floor/marking/asteroidwarning{
	dir = 6
	},
/area/bigredv3/outside/directions/ne)
"iB" = (
/obj/machinery/door/airlock/mainship/maint/free_access{
	dir = 1;
	name = "\improper Dormitories Tool Storage Maintenance"
	},
/turf/open/floor/plating,
/area/bigredv3/inside/secondary/maintence)
"iP" = (
/obj/machinery/washing_machine,
/turf/open/floor/freezer,
/area/bigredv3/inside/colony/dorm/laundry)
"jc" = (
/turf/open/floor/marking/asteroidwarning{
	dir = 4
	},
/area/bigredv3/outside/directions/ne)
"jn" = (
/obj/structure/window/framed/colony,
/obj/machinery/door/poddoor/shutters/mainship{
	dir = 2;
	id = "Greenhouse";
	name = "\improper Greenhouse Shutters"
	},
/turf/open/floor/plating,
/area/bigredv3/inside/wall)
"jo" = (
/obj/machinery/atmospherics/pipe/simple/green/hidden{
	dir = 4
	},
/obj/effect/ai_node,
/turf/open/floor,
/area/bigredv3/inside/colony/dorm)
"jw" = (
/obj/structure/table,
/turf/open/floor/tile/dark,
/area/bigredv3/inside/colony/bar)
"jK" = (
/obj/machinery/atmospherics/pipe/manifold/green/hidden,
/obj/effect/ai_node,
/turf/open/floor,
/area/bigredv3/inside/colony/dorm)
"kh" = (
/obj/machinery/light,
/turf/open/floor/tile/dark,
/area/bigredv3/inside/colony/bar)
"kC" = (
/obj/structure/window/framed/colony/reinforced,
/turf/open/floor/plating,
/area/bigredv3/inside/wall)
"kF" = (
/turf/open/floor/marking/asteroidwarning,
/area/bigredv3/outside/directions/ne)
"mf" = (
/obj/machinery/light,
/obj/effect/decal/cleanable/dirt,
/turf/open/floor,
/area/bigredv3/inside/colony/dorm)
"mi" = (
/obj/effect/ai_node,
/turf/open/floor/plating/ground/mars/random/sand,
/area/bigredv3/caves/northeast/garbledradio)
"mq" = (
/obj/machinery/atmospherics/pipe/simple/green/hidden,
/turf/open/floor,
/area/bigredv3/inside/colony/dorm/recreation)
"mu" = (
/turf/open/floor/plating/ground/mars/random/sand,
/area/bigredv3/outside/directions/ne)
"mS" = (
/obj/item/clothing/under/brown,
/turf/open/floor/freezer,
/area/bigredv3/inside/colony/dorm/laundry)
"mU" = (
/obj/effect/decal/cleanable/dirt,
/turf/open/floor/asteroidfloor,
/area/bigredv3/outside/directions/ne)
"nv" = (
/obj/machinery/washing_machine,
/obj/machinery/light,
/turf/open/floor/freezer,
/area/bigredv3/inside/colony/dorm/laundry)
"nD" = (
/obj/structure/cable,
/obj/effect/ai_node,
/turf/open/floor/plating,
/area/bigredv3/inside/secondary/maintence)
"nL" = (
/obj/machinery/power/apc/weak/ntf{
	dir = 4
	},
/obj/structure/cable,
/turf/open/floor/plating,
/area/bigredv3/inside/secondary/maintence)
"oa" = (
/obj/effect/decal/cleanable/dirt,
/obj/machinery/atmospherics/components/unary/vent_pump{
	dir = 4;
	on = 1
	},
/turf/open/floor/tile/dark,
/area/bigredv3/inside/colony/bar)
"ot" = (
/turf/open/floor/tile/dark,
/area/bigredv3/inside/colony/bar)
"oH" = (
/obj/machinery/atmospherics/pipe/simple/green/hidden{
	dir = 4
	},
/obj/structure/cable,
/turf/open/floor,
/area/bigredv3/inside/colony/dorm)
"oL" = (
/obj/machinery/light{
	dir = 8
	},
/obj/structure/cable,
/obj/machinery/atmospherics/pipe/simple/green/hidden,
/turf/open/floor/asteroidfloor,
/area/bigredv3/outside/directions/ne)
"oQ" = (
/turf/open/floor/plating/ground/mars/random/sand,
/area/bigredv3/outside/directions/n)
"oY" = (
/obj/machinery/atmospherics/pipe/manifold/green/hidden{
	dir = 4
	},
/obj/structure/cable,
/obj/effect/ai_node,
/turf/open/floor/asteroidfloor,
/area/bigredv3/outside/directions/ne)
"pO" = (
/obj/structure/bed/chair{
	dir = 8
	},
/turf/open/floor,
/area/bigredv3/inside/colony/dorm/recreation)
"qd" = (
/obj/structure/window/framed/colony,
/obj/machinery/door/poddoor/shutters/mainship{
	id = "Greenhouse";
	name = "\improper Greenhouse Shutters"
	},
/turf/open/floor/plating,
/area/bigredv3/inside/wall)
"rw" = (
/obj/machinery/light{
	dir = 1
	},
/turf/open/floor,
/area/bigredv3/inside/colony/dorm)
"rW" = (
/obj/structure/rack,
/obj/effect/spawner/random/engineering/tool,
/obj/effect/spawner/random/engineering/tool,
/turf/open/floor,
/area/bigredv3/inside/colony/dorm)
"rY" = (
/obj/machinery/door/airlock/mainship/engineering/free_access{
	dir = 1;
	name = "\improper Dormitories EVA"
	},
/obj/machinery/atmospherics/pipe/simple/green/hidden,
/obj/structure/cable,
/turf/open/floor/tile/dark,
/area/bigredv3/inside/colony/bar)
"sw" = (
/obj/machinery/washing_machine,
/obj/item/clothing/under/lightbrown,
/turf/open/floor/freezer,
/area/bigredv3/inside/colony/dorm/laundry)
"sF" = (
/obj/structure/table,
/obj/structure/bedsheetbin,
/turf/open/floor/freezer,
/area/bigredv3/inside/colony/dorm/laundry)
"sH" = (
/obj/structure/cable,
/obj/machinery/atmospherics/pipe/simple/green/hidden{
	dir = 4
	},
/obj/machinery/door/airlock/mainship/maint/free_access{
	name = "\improper Bar Maintenance"
	},
/turf/open/floor/plating,
/area/bigredv3/inside/secondary/maintence)
"tc" = (
/obj/machinery/washing_machine,
/obj/item/clothing/under/darkred,
/turf/open/floor/freezer,
/area/bigredv3/inside/colony/dorm/laundry)
"tm" = (
/obj/machinery/atmospherics/pipe/simple/green/hidden{
	dir = 4
	},
/turf/open/floor,
/area/bigredv3/inside/colony/dorm)
"tw" = (
/obj/machinery/light{
	dir = 1
	},
/turf/open/floor,
/area/bigredv3/inside/colony/hydroponics)
"uk" = (
/obj/effect/ai_node,
/turf/open/floor,
/area/bigredv3/inside/colony/dorm)
"ut" = (
/obj/machinery/vending/hydronutrients,
/turf/open/floor,
/area/bigredv3/inside/colony/hydroponics)
"uD" = (
/obj/structure/rack,
/obj/item/stack/sheet/mineral/phoron{
	amount = 25
	},
/turf/open/floor/tile/dark,
/area/bigredv3/inside/colony/bar)
"uO" = (
/obj/machinery/atmospherics/pipe/simple/green/hidden{
	dir = 6
	},
/turf/open/floor,
/area/bigredv3/inside/colony/dorm/recreation)
"va" = (
/obj/machinery/atmospherics/pipe/manifold/green/hidden{
	dir = 1
	},
/obj/structure/cable,
/obj/effect/ai_node,
/turf/open/floor/tile/dark,
/area/bigredv3/inside/colony/bar)
"vd" = (
/obj/machinery/suit_storage_unit/carbon_unit,
/obj/effect/decal/cleanable/cobweb2,
/turf/open/floor/tile/dark,
/area/bigredv3/inside/colony/bar)
"vI" = (
/obj/structure/rack,
/obj/item/stack/sheet/mineral/diamond,
/obj/item/clothing/under/redcoat,
/turf/open/floor/tile/dark,
/area/bigredv3/inside/colony/bar)
"wt" = (
/obj/machinery/atmospherics/components/unary/vent_pump{
	dir = 8;
	on = 1
	},
/obj/effect/ai_node,
/turf/open/floor/freezer,
/area/bigredv3/inside/colony/dorm/laundry)
"wu" = (
/turf/open/floor/plating/ground/mars/dirttosand/autosmooth,
/area/bigredv3/outside/directions/ne)
"wz" = (
/obj/machinery/door/airlock/multi_tile/mainship/generic{
	name = "\improper Dormitories Tool Storage"
	},
/turf/open/floor,
/area/bigredv3/inside/colony/dorm)
"wC" = (
/obj/structure/cable,
/obj/machinery/atmospherics/pipe/simple/green/hidden,
/obj/machinery/door/airlock/multi_tile/mainship/generic{
	name = "\improper Dormitories"
	},
/turf/open/floor,
/area/bigredv3/inside/colony/dorm)
"wE" = (
/obj/effect/landmark/lv624/fog_blocker,
/turf/open/floor/plating/ground/mars/random/sand,
/area/bigredv3/caves/northeast/garbledradio)
"xa" = (
/turf/closed/wall,
/area/bigredv3/inside/wall)
"xy" = (
/obj/structure/window/framed/colony,
/obj/machinery/door/poddoor/shutters/mainship{
	dir = 2;
	id = "Dormitories";
	name = "\improper Dormitories Shutters"
	},
/turf/open/floor/plating,
/area/bigredv3/inside/wall)
"xJ" = (
/obj/machinery/vending/snack,
/turf/open/floor,
/area/bigredv3/inside/colony/dorm)
"xL" = (
/obj/machinery/light{
	dir = 4
	},
/obj/structure/rack,
/obj/item/stack/sheet/mineral/silver,
/obj/item/stack/sheet/mineral/silver{
	amount = 20
	},
/obj/item/stack/sheet/mineral/phoron{
	amount = 25
	},
/turf/open/floor/tile/dark,
/area/bigredv3/inside/colony/bar)
"xR" = (
/turf/open/floor/plating/ground/mars/dirttosand/autosmooth{
	dir = 8
	},
/area/bigredv3/caves/northeast/garbledradio)
"xV" = (
/obj/machinery/atmospherics/pipe/manifold/green/hidden{
	dir = 4
	},
/turf/open/floor,
/area/bigredv3/inside/colony/dorm/recreation)
"yd" = (
/turf/open/floor,
/area/bigredv3/inside/colony/dorm/recreation)
"yo" = (
/turf/open/floor/plating,
/area/bigredv3/inside/secondary/maintence)
"yI" = (
/obj/structure/sign/safety/EVA{
	dir = 1
	},
/turf/open/floor/tile/dark,
/area/bigredv3/inside/colony/bar)
"yO" = (
/obj/effect/ai_node,
/turf/open/floor/wood,
/area/bigredv3/inside/colony/dorm)
"yP" = (
/obj/structure/table,
/obj/effect/spawner/random/misc/paperbin,
/obj/machinery/atmospherics/pipe/simple/green/hidden{
	dir = 4
	},
/turf/open/floor/tile/dark,
/area/bigredv3/inside/colony/bar)
"zS" = (
/turf/open/floor/freezer,
/area/bigredv3/inside/colony/dorm/laundry)
"Aa" = (
/obj/structure/table,
/turf/open/floor,
/area/bigredv3/inside/colony/hydroponics)
"AC" = (
/obj/machinery/door/airlock/mainship/engineering/free_access{
	name = "\improper Dormitories EVA"
	},
/obj/machinery/atmospherics/pipe/simple/green/hidden{
	dir = 4
	},
/turf/open/floor/tile/dark,
/area/bigredv3/inside/colony/bar)
"AG" = (
/obj/machinery/atmospherics/pipe/simple/green/hidden,
/obj/structure/cable,
/obj/machinery/door/airlock/mainship/medical/glass/free_access{
	dir = 1;
	name = "\improper Greenhouse"
	},
/turf/open/floor,
/area/bigredv3/inside/colony/hydroponics)
"AT" = (
/turf/open/floor/plating/ground/mars/dirttosand/autosmooth{
	dir = 10
	},
/area/bigredv3/outside/directions/ne)
"Bj" = (
/obj/machinery/washing_machine,
/obj/item/clothing/under/lightred,
/turf/open/floor/freezer,
/area/bigredv3/inside/colony/dorm/laundry)
"BF" = (
/obj/machinery/light{
	dir = 8
	},
/turf/open/floor/wood,
/area/bigredv3/inside/colony/dorm)
"BR" = (
/obj/structure/rack,
/obj/item/stack/sheet/mineral/diamond,
/turf/open/floor/tile/dark,
/area/bigredv3/inside/colony/bar)
"Ca" = (
/obj/machinery/atmospherics/pipe/manifold/green/hidden{
	dir = 4
	},
/obj/structure/cable,
/obj/effect/ai_node,
/turf/open/floor/tile/dark,
/area/bigredv3/inside/colony/bar)
"Ce" = (
/obj/machinery/atmospherics/pipe/simple/green/hidden{
	dir = 4
	},
/turf/open/floor/tile/dark,
/area/bigredv3/inside/colony/bar)
"Cx" = (
/obj/effect/decal/cleanable/dirt,
/obj/machinery/atmospherics/pipe/simple/green/hidden,
/turf/open/floor,
/area/bigredv3/inside/colony/dorm)
"De" = (
/obj/structure/table,
/turf/open/floor,
/area/bigredv3/inside/colony/dorm/recreation)
"Dg" = (
/obj/machinery/light{
	dir = 1
	},
/turf/open/floor/plating,
/area/bigredv3/inside/secondary/maintence)
"Dy" = (
/obj/structure/cable,
/turf/open/floor/tile/dark,
/area/bigredv3/inside/colony/bar)
"Ev" = (
/obj/effect/ai_node,
/turf/open/floor/plating/ground/mars/random/sand,
/area/bigredv3/outside/directions/ne)
"Ex" = (
/obj/structure/rack,
/obj/item/stack/sheet/mineral/diamond,
/obj/item/stack/sheet/plasteel{
	amount = 30;
	pixel_x = 4;
	pixel_y = 4
	},
/turf/open/floor/tile/dark,
/area/bigredv3/inside/colony/bar)
"EY" = (
/obj/structure/rack,
/obj/item/stack/sheet/mineral/plastic,
/obj/item/stack/sheet/mineral/plastic,
/obj/item/stack/sheet/mineral/plastic,
/obj/effect/decal/cleanable/cobweb,
/turf/open/floor/tile/dark,
/area/bigredv3/inside/colony/bar)
"Fo" = (
/turf/open/floor/plating/ground/mars/random/sand,
/area/bigredv3/caves/northeast/garbledradio)
"FP" = (
/turf/open/floor,
/area/bigredv3/inside/colony/dorm)
"FY" = (
/obj/machinery/vending/engivend,
/turf/open/floor,
/area/bigredv3/inside/colony/dorm)
"Gb" = (
/obj/structure/closet/l3closet,
/obj/effect/decal/cleanable/dirt,
/turf/open/floor/tile/vault{
	dir = 8
	},
/area/bigredv3/inside/colony/bar)
"Gh" = (
/obj/machinery/atmospherics/pipe/simple/green/hidden{
	dir = 4
	},
/turf/open/floor/freezer,
/area/bigredv3/inside/colony/dorm/laundry)
"GB" = (
/obj/machinery/atmospherics/pipe/simple/green/hidden,
/turf/open/floor,
/area/bigredv3/inside/colony/dorm)
"GF" = (
/obj/machinery/door/airlock/mainship/medical/glass/free_access{
	name = "\improper Dormitories Lavatory"
	},
/obj/machinery/atmospherics/pipe/simple/green/hidden{
	dir = 4
	},
/turf/open/floor/freezer,
/area/bigredv3/inside/colony/dorm/laundry)
"GN" = (
/obj/structure/table,
/obj/item/tool/shovel/spade,
/turf/open/floor,
/area/bigredv3/inside/colony/hydroponics)
"Hb" = (
/obj/machinery/door/airlock/mainship/maint/free_access{
	name = "\improper Dormitories EVA Maintenance"
	},
/obj/structure/cable,
/turf/open/floor/plating,
/area/bigredv3/inside/colony/bar)
"HB" = (
/obj/machinery/vending/cigarette/colony,
/turf/open/floor,
/area/bigredv3/inside/colony/dorm)
"HC" = (
/obj/machinery/hydroponics,
/obj/machinery/light{
	dir = 1
	},
/turf/open/floor/tile/green/whitegreenfull,
/area/bigredv3/inside/colony/hydroponics)
"Ig" = (
/obj/machinery/suit_storage_unit/carbon_unit,
/turf/open/floor/tile/dark,
/area/bigredv3/inside/colony/bar)
"In" = (
/turf/closed/mineral/smooth/bigred,
/area/bigredv3/caves/rock)
"Iw" = (
/obj/machinery/door/airlock/mainship/generic{
	dir = 1;
	name = "\improper Dormitories Bedroom"
	},
/turf/open/floor/wood,
/area/bigredv3/inside/colony/dorm)
"Iy" = (
/obj/structure/table,
/obj/machinery/atmospherics/components/unary/vent_pump{
	dir = 8;
	on = 1
	},
/turf/open/floor/tile/dark,
/area/bigredv3/inside/colony/bar)
"IG" = (
/obj/structure/window/framed/colony,
/turf/open/floor/plating,
/area/bigredv3/inside/wall)
"Jb" = (
/obj/machinery/atmospherics/pipe/simple/green/hidden,
/obj/structure/cable,
/turf/open/floor,
/area/bigredv3/inside/colony/dorm)
"Jr" = (
/turf/open/floor/wood,
/area/bigredv3/inside/colony/dorm)
"Ky" = (
/obj/structure/rack,
/obj/item/stack/sheet/mineral/uranium{
	amount = 50
	},
/turf/open/floor/tile/dark,
/area/bigredv3/inside/colony/bar)
"KG" = (
/obj/structure/cable,
/obj/machinery/atmospherics/pipe/simple/green/hidden,
/turf/open/floor/asteroidfloor,
/area/bigredv3/outside/directions/ne)
"Lj" = (
/obj/item/clothing/under/lightbrown,
/turf/open/floor/freezer,
/area/bigredv3/inside/colony/dorm/laundry)
"NB" = (
/obj/effect/decal/cleanable/dirt,
/turf/open/floor/tile/dark,
/area/bigredv3/inside/colony/bar)
"Oh" = (
/obj/machinery/atmospherics/pipe/manifold/green/hidden,
/turf/open/floor,
/area/bigredv3/inside/colony/dorm/recreation)
"OJ" = (
/obj/structure/cable,
/obj/machinery/atmospherics/pipe/simple/green/hidden{
	dir = 4
	},
/obj/effect/ai_node,
/turf/open/floor/asteroidfloor,
/area/bigredv3/outside/directions/ne)
"Pa" = (
/obj/effect/ai_node,
/turf/open/floor/plating/ground/mars/random/dirt,
/area/bigredv3/caves/northeast/garbledradio)
"PP" = (
/obj/effect/decal/cleanable/dirt,
/obj/machinery/atmospherics/pipe/simple/green/hidden{
	dir = 9
	},
/turf/open/floor,
/area/bigredv3/inside/colony/dorm)
"PY" = (
/obj/effect/decal/cleanable/dirt,
/obj/structure/rack,
/obj/item/stack/sheet/mineral/uranium{
	amount = 50
	},
/turf/open/floor/tile/dark,
/area/bigredv3/inside/colony/bar)
"Qp" = (
/obj/structure/closet/l3closet,
/turf/open/floor/tile/vault{
	dir = 8
	},
/area/bigredv3/inside/colony/bar)
"QT" = (
/obj/structure/table,
/obj/item/paper/hydroponics,
/turf/open/floor,
/area/bigredv3/inside/colony/hydroponics)
"Ro" = (
/obj/effect/decal/cleanable/dirt,
/turf/open/floor,
/area/bigredv3/inside/colony/dorm)
"RF" = (
/obj/machinery/light{
	dir = 1
	},
/turf/open/floor,
/area/bigredv3/inside/colony/dorm/recreation)
"SR" = (
/obj/machinery/light{
	dir = 8
	},
/turf/open/floor/plating,
/area/bigredv3/inside/secondary/maintence)
"Tf" = (
/obj/structure/cable,
/obj/machinery/atmospherics/pipe/simple/green/hidden{
	dir = 4
	},
/turf/open/floor/asteroidfloor,
/area/bigredv3/outside/directions/ne)
"Th" = (
/obj/machinery/light{
	dir = 1
	},
/obj/machinery/vending/cola,
/turf/open/floor,
/area/bigredv3/inside/colony/dorm)
"Ts" = (
/obj/machinery/light{
	dir = 1
	},
/obj/machinery/suit_storage_unit/carbon_unit,
/turf/open/floor/tile/dark,
/area/bigredv3/inside/colony/bar)
"Tz" = (
/obj/machinery/atmospherics/pipe/simple/green/hidden,
/obj/structure/cable,
/turf/open/floor/tile/dark,
/area/bigredv3/inside/colony/bar)
"TU" = (
/obj/structure/table,
/turf/open/floor/wood,
/area/bigredv3/inside/colony/dorm)
"WI" = (
/obj/structure/table,
/obj/effect/spawner/random/engineering/toolbox,
/obj/machinery/atmospherics/components/unary/vent_pump,
/turf/open/floor,
/area/bigredv3/inside/colony/dorm)
"WZ" = (
/obj/structure/closet/toolcloset,
/turf/open/floor,
/area/bigredv3/inside/colony/dorm)
"Xv" = (
/obj/machinery/light{
	dir = 1
	},
/obj/effect/decal/cleanable/dirt,
/turf/open/floor,
/area/bigredv3/inside/colony/dorm)
"Xy" = (
/obj/structure/rack,
/obj/effect/spawner/random/engineering/tool,
/obj/effect/spawner/random/engineering/tool,
/obj/effect/spawner/random/engineering/tool,
/turf/open/floor,
/area/bigredv3/inside/colony/dorm)
"XH" = (
/obj/structure/cable,
/obj/machinery/atmospherics/pipe/manifold/green/hidden{
	dir = 8
	},
/turf/open/floor/tile/dark,
/area/bigredv3/inside/colony/bar)
"Yp" = (
/obj/machinery/atmospherics/pipe/simple/green/hidden{
	dir = 4
	},
/obj/structure/cable,
/turf/open/floor/plating,
/area/bigredv3/inside/secondary/maintence)
"YO" = (
/obj/machinery/vending/hydroseeds,
/obj/machinery/light{
	dir = 1
	},
/turf/open/floor,
/area/bigredv3/inside/colony/hydroponics)
"YS" = (
/turf/open/floor/asteroidfloor,
/area/bigredv3/outside/directions/ne)
"Zl" = (
/obj/machinery/washing_machine,
/obj/item/clothing/under/brown,
/turf/open/floor/freezer,
/area/bigredv3/inside/colony/dorm/laundry)

(1,1,1) = {"
oQ
oQ
xy
yd
yd
uO
mq
xV
mq
mq
mq
mq
mq
mq
Oh
yd
yd
bh
xa
Dg
Yp
yo
yo
xa
"}
(2,1,1) = {"
oQ
oQ
xa
xa
xa
GF
xa
xa
xa
xa
xa
xa
xa
RF
bG
yd
pO
De
xa
yo
Yp
yo
yo
xa
"}
(3,1,1) = {"
oQ
oQ
xa
tc
zS
Gh
zS
sw
xa
Xy
rW
rW
xa
FP
jo
FP
xa
xa
xa
xa
sH
xa
xa
xa
"}
(4,1,1) = {"
oQ
oQ
xa
iP
zS
Gh
zS
iP
xa
rw
Ro
FP
xa
Ro
tm
uk
Iw
Jr
eR
xa
dR
kF
eB
xa
"}
(5,1,1) = {"
oQ
oQ
xa
iP
zS
Gh
zS
Zl
xa
FP
Ro
FP
xa
Ro
tm
FP
xa
TU
dG
xa
dR
kF
eB
xa
"}
(6,1,1) = {"
oQ
oQ
xa
iP
aM
wt
zS
nv
xa
FY
Ro
FP
xa
Ro
tm
fH
xa
xa
xa
xa
dR
kF
eB
xa
"}
(7,1,1) = {"
In
In
xa
iP
zS
sF
mS
iP
xa
fY
FP
FP
wz
FP
tm
uk
Iw
Jr
eR
xa
dR
kF
eB
xa
"}
(8,1,1) = {"
bi
In
xa
Zl
Lj
sF
zS
iP
xa
aj
gQ
Cx
GB
GB
jK
FP
xa
TU
dG
xa
Tf
kF
wu
mu
"}
(9,1,1) = {"
In
bi
xa
iP
zS
zS
zS
Bj
xa
WI
PP
Ro
xa
FP
tm
FP
xa
xa
xa
xa
OJ
kF
eB
AT
"}
(10,1,1) = {"
In
bi
xa
xa
xa
xa
xa
xa
xa
WZ
Ro
mf
xa
Ro
jo
FP
Iw
yO
BF
xa
dR
kF
eB
wu
"}
(11,1,1) = {"
Fo
wE
xa
yo
nL
SR
yo
yo
xa
WZ
Ro
Ro
xa
Ro
tm
FP
xa
TU
dG
xa
dR
kF
xa
qd
"}
(12,1,1) = {"
mi
wE
gS
yo
nD
yo
yo
yo
iB
FP
uk
FP
xa
Ro
tm
fH
xa
xa
xa
xa
Tf
kF
jn
eD
"}
(13,1,1) = {"
Fo
wE
xa
xa
Hb
xa
xa
xa
xa
xa
xa
xa
xa
Xv
hd
Jb
wC
KG
oL
KG
oY
KG
AG
cm
"}
(14,1,1) = {"
Fo
wE
xa
Ig
Dy
fP
hG
jw
xa
Gb
Gb
Qp
xa
FP
oH
uk
FP
YS
YS
mU
jc
ii
xa
eD
"}
(15,1,1) = {"
Fo
wE
xa
Ig
Dy
NB
ot
jw
xa
NB
NB
ot
xa
hq
oH
FP
xa
xa
xa
xa
mu
mu
jn
eD
"}
(16,1,1) = {"
Fo
wE
xa
Ts
fA
NB
NB
jw
IG
NB
oa
ot
IG
FP
oH
FP
Iw
Jr
BF
xa
mu
mu
jn
eD
"}
(17,1,1) = {"
xR
bi
xa
Ig
va
cR
gI
XH
rY
Tz
Ca
Tz
rY
Jb
hZ
FP
xa
TU
dG
xa
mu
aG
xa
HC
"}
(18,1,1) = {"
hM
bi
xa
Ig
Ce
NB
ot
yP
IG
ot
ot
ot
IG
Ro
FP
FP
xa
xa
xa
xa
mu
mu
jn
eD
"}
(19,1,1) = {"
hM
bi
xa
Ig
Ce
ot
ot
Iy
xa
yI
ot
kh
xa
Ro
FP
FP
Iw
Jr
BF
xa
mu
mu
jn
eD
"}
(20,1,1) = {"
Pa
bi
xa
vd
Ce
ot
hG
jw
xa
Qp
Qp
Qp
xa
FP
FP
fH
xa
TU
dG
xa
mu
mu
xa
IG
"}
(21,1,1) = {"
hM
bi
es
kC
AC
kC
kC
es
es
es
es
es
es
Ro
FP
FP
xa
xa
xa
xa
mu
Ev
xa
ut
"}
(22,1,1) = {"
In
bi
es
EY
Ce
uD
NB
PY
NB
Ex
ot
hl
es
Ro
FP
FP
xa
In
mu
mu
mu
mu
xa
YO
"}
(23,1,1) = {"
In
bi
es
ot
Ce
ot
NB
NB
NB
ot
NB
ot
es
Ro
FP
FP
xa
In
mu
mu
aG
mu
xa
Aa
"}
(24,1,1) = {"
In
bi
es
ot
do
ot
ot
ot
ot
ot
bT
ot
es
Ro
FP
FP
xa
In
In
mu
mu
mu
xa
GN
"}
(25,1,1) = {"
In
bi
es
gg
ot
Ky
ot
xL
ot
vI
ot
BR
es
FP
FP
FP
xa
In
In
mu
mu
mu
xa
QT
"}
(26,1,1) = {"
In
bi
es
es
es
es
es
es
es
es
es
es
es
Th
HB
xJ
xa
In
In
mu
mu
mu
xa
tw
"}
