//MAP CONVERTED BY dmm2tgm.py THIS HEADER COMMENT PREVENTS RECONVERSION, DO NOT REMOVE
"aA" = (
/obj/machinery/atmospherics/pipe/simple/green/hidden{
	dir = 10
	},
/obj/structure/cable,
/turf/open/floor,
/area/bigredv3/inside/engi/west)
"aU" = (
/turf/open/floor/plating,
/area/bigredv3/inside/engi/power_plant)
"bh" = (
/obj/effect/decal/cleanable/dirt,
/obj/structure/cable,
/turf/open/floor/plating,
/area/bigredv3/inside/engi/power_plant)
"bB" = (
/obj/effect/decal/cleanable/dirt,
/obj/machinery/air_alarm{
	dir = 1
	},
/turf/open/floor,
/area/bigredv3/inside/engi/west)
"bI" = (
/obj/effect/ai_node,
/obj/structure/cable,
/turf/open/floor,
/area/bigredv3/inside/engi/fabrication)
"ci" = (
/turf/open/floor/plating/ground/mars/random/dirt,
/area/bigredv3/outside/directions/s)
"cu" = (
/obj/effect/decal/cleanable/dirt,
/obj/structure/cable,
/turf/open/floor,
/area/bigredv3/inside/engi/fabrication)
"cQ" = (
/obj/effect/decal/cleanable/blood/oil,
/turf/open/floor/plating,
/area/bigredv3/inside/engi/power_plant)
"dk" = (
/obj/machinery/door/airlock/mainship/secure/free_access{
	dir = 1;
	name = "\improper Engine Reactor"
	},
/obj/structure/cable,
/turf/open/floor,
/area/bigredv3/inside/engi)
"dp" = (
/turf/open/floor/plating/ground/mars/random/cave/rock,
/area/bigredv3/caves/southwest)
"dI" = (
/obj/structure/bed/chair/office/light{
	dir = 8
	},
/turf/open/floor,
/area/bigredv3/inside/engi/power_plant)
"ea" = (
/obj/machinery/light{
	dir = 4
	},
/turf/open/liquid/water/river,
/area/bigredv3/inside/engi/power_plant)
"ee" = (
/obj/effect/decal/cleanable/dirt,
/obj/machinery/atmospherics/components/unary/vent_pump{
	dir = 1;
	on = 1
	},
/turf/open/floor,
/area/bigredv3/inside/engi/west)
"eM" = (
/obj/machinery/atmospherics/pipe/simple/green/hidden,
/obj/structure/cable,
/turf/open/floor,
/area/bigredv3/inside/engi/ceo)
"eQ" = (
/obj/structure/table,
/obj/item/tool/lighter/random,
/obj/item/lightreplacer,
/turf/open/floor,
/area/bigredv3/inside/engi/west)
"eR" = (
/obj/machinery/atmospherics/pipe/simple/green/hidden,
/obj/machinery/power/apc/weak/ntf{
	dir = 8
	},
/obj/structure/cable,
/turf/open/floor,
/area/bigredv3/inside/engi/west)
"fK" = (
/obj/effect/decal/cleanable/dirt,
/obj/effect/decal/cleanable/blood/oil,
/turf/open/floor,
/area/bigredv3/inside/engi/west)
"fQ" = (
/obj/structure/table,
/obj/effect/spawner/random/engineering/tool,
/obj/effect/spawner/random/engineering/technology_scanner,
/turf/open/floor,
/area/bigredv3/inside/engi/fabrication)
"gp" = (
/obj/machinery/atmospherics/pipe/simple/green/hidden,
/turf/open/floor,
/area/bigredv3/inside/engi/power_plant)
"gx" = (
/obj/effect/ai_node,
/obj/structure/cable,
/turf/open/floor/plating,
/area/bigredv3/inside/engi/power_plant)
"gy" = (
/turf/open/floor/plating/ground/mars/dirttosand/autosmooth{
	dir = 1
	},
/area/bigredv3/outside/directions/s)
"gE" = (
/obj/machinery/atmospherics/pipe/simple/green/hidden,
/obj/effect/decal/cleanable/dirt,
/obj/structure/cable,
/turf/open/floor,
/area/bigredv3/inside/engi/west)
"gH" = (
/turf/open/floor/plating/ground/mars/cavetodirt{
	dir = 9
	},
/area/bigredv3/outside/directions/s)
"hl" = (
/obj/effect/decal/cleanable/dirt,
/turf/open/floor,
/area/bigredv3/inside/engi/power_plant)
"hz" = (
/obj/machinery/floodlight/outpost/bigred,
/turf/open/floor/plating/ground/mars/random/cave/rock,
/area/bigredv3/outside/directions/s)
"hJ" = (
/obj/machinery/light{
	dir = 8
	},
/obj/effect/spawner/random/misc/structure/supplycrate,
/turf/open/floor,
/area/bigredv3/inside/engi/fabrication)
"hQ" = (
/obj/machinery/atmospherics/pipe/simple/green/hidden,
/turf/open/floor,
/area/bigredv3/inside/engi/west)
"hU" = (
/obj/structure/table,
/obj/effect/decal/cleanable/dirt,
/obj/item/clothing/glasses/welding,
/turf/open/floor,
/area/bigredv3/inside/engi/west)
"iT" = (
/obj/effect/decal/cleanable/dirt,
/obj/item/lightreplacer,
/turf/open/floor,
/area/bigredv3/inside/engi/west)
"jq" = (
/turf/open/floor/plating/ground/mars/random/cave,
/area/bigredv3/outside/directions/s)
"jr" = (
/obj/effect/ai_node,
/turf/open/floor/plating/ground/mars/random/cave,
/area/bigredv3/caves/southwest)
"jG" = (
/obj/machinery/atmospherics/pipe/simple/green/hidden,
/obj/effect/ai_node,
/turf/open/floor,
/area/bigredv3/inside/engi/power_plant)
"jR" = (
/obj/machinery/light{
	dir = 1
	},
/obj/machinery/atmospherics/pipe/simple/green/hidden{
	dir = 4
	},
/obj/structure/cable,
/turf/open/floor,
/area/bigredv3/inside/engi/west)
"kp" = (
/obj/effect/ai_node,
/turf/open/floor/plating/ground/mars/random/dirt,
/area/bigredv3/outside/directions/s)
"kq" = (
/turf/closed/wall/r_wall,
/area/bigredv3/inside/wall)
"kJ" = (
/turf/open/floor/plating/ground/mars/random/cave,
/area/bigredv3/caves/southwest)
"kT" = (
/obj/machinery/light{
	dir = 4
	},
/obj/effect/decal/cleanable/dirt,
/turf/open/floor,
/area/bigredv3/inside/engi/west)
"lX" = (
/obj/effect/decal/cleanable/dirt,
/obj/structure/sign/safety/hazard,
/turf/open/floor,
/area/bigredv3/inside/engi/west)
"lZ" = (
/obj/structure/table,
/obj/effect/spawner/random/engineering/tool,
/turf/open/floor,
/area/bigredv3/inside/engi/fabrication)
"ma" = (
/obj/effect/decal/cleanable/dirt,
/obj/machinery/atmospherics/pipe/simple/green/hidden{
	dir = 5
	},
/obj/structure/cable,
/turf/open/floor,
/area/bigredv3/inside/engi/west)
"mf" = (
/turf/open/floor,
/area/bigredv3/inside/engi/fabrication)
"nx" = (
/obj/effect/decal/cleanable/dirt,
/obj/machinery/atmospherics/pipe/simple/green/hidden{
	dir = 4
	},
/obj/structure/cable,
/turf/open/floor,
/area/bigredv3/inside/engi/west)
"nz" = (
/obj/structure/bed/chair{
	dir = 4
	},
/turf/open/floor,
/area/bigredv3/inside/engi/west)
"of" = (
/obj/machinery/floodlight/outpost/bigred,
/turf/open/floor/plating/ground/mars/random/cave,
/area/bigredv3/caves/southwest)
"ok" = (
/obj/machinery/atmospherics/components/unary/vent_pump{
	dir = 8;
	on = 1
	},
/turf/open/floor,
/area/bigredv3/inside/engi/west)
"op" = (
/turf/closed/mineral/smooth/bigred,
/area/bigredv3/caves/rock)
"oE" = (
/turf/open/floor/plating/ground/mars/dirttosand/autosmooth{
	dir = 8
	},
/area/bigredv3/outside/directions/sw)
"oI" = (
/obj/machinery/light{
	dir = 4
	},
/turf/open/floor/plating,
/area/bigredv3/inside/engi/power_plant)
"oP" = (
/obj/structure/bed/chair/office/light{
	dir = 4
	},
/turf/open/floor,
/area/bigredv3/inside/engi/west)
"oX" = (
/obj/structure/window/framed/colony,
/turf/open/floor/plating,
/area/bigredv3/inside/wall)
"pe" = (
/obj/effect/decal/cleanable/dirt,
/obj/structure/sign/safety/high_radiation,
/turf/open/floor,
/area/bigredv3/inside/engi/west)
"pE" = (
/obj/structure/sign/safety/hazard,
/turf/open/floor,
/area/bigredv3/inside/engi/west)
"pR" = (
/obj/structure/table,
/obj/effect/spawner/random/engineering/tool,
/obj/machinery/light{
	dir = 4
	},
/turf/open/floor,
/area/bigredv3/inside/engi/fabrication)
"qf" = (
/obj/structure/table,
/obj/item/tool/lighter/random,
/turf/open/floor,
/area/bigredv3/inside/engi/fabrication)
"qg" = (
/obj/structure/window/framed/colony/reinforced,
/obj/machinery/door/poddoor/shutters/mainship{
	dir = 2;
	id = "Engineering";
	name = "\improper Engineering Shutters"
	},
/turf/open/floor/plating,
/area/bigredv3/inside/wall)
"qi" = (
/obj/machinery/vending/cigarette/colony,
/turf/open/floor,
/area/bigredv3/inside/engi/west)
"qs" = (
/obj/effect/decal/cleanable/dirt,
/obj/machinery/door/airlock/mainship/secure/free_access{
	name = "\improper Engineering Secure Storage"
	},
/obj/structure/cable,
/turf/open/floor,
/area/bigredv3/inside/engi/fabrication)
"qE" = (
/obj/effect/decal/cleanable/dirt,
/obj/machinery/atmospherics/pipe/simple/green/hidden,
/turf/open/floor,
/area/bigredv3/inside/engi/west)
"qP" = (
/obj/machinery/atmospherics/pipe/simple/green/hidden{
	dir = 4
	},
/obj/machinery/door/airlock/multi_tile/mainship/generic{
	dir = 1;
	name = "\improper Engineering Complex"
	},
/obj/structure/cable,
/turf/open/floor,
/area/bigredv3/inside/engi/west)
"rt" = (
/obj/structure/table,
/obj/effect/spawner/random/engineering/tool,
/obj/item/stack/sheet/metal{
	amount = 30
	},
/turf/open/floor,
/area/bigredv3/inside/engi/west)
"rK" = (
/obj/machinery/computer/atmos_alert,
/obj/structure/table,
/turf/open/floor,
/area/bigredv3/inside/engi/power_plant)
"sf" = (
/obj/machinery/atmospherics/pipe/simple/green/hidden{
	dir = 9
	},
/obj/effect/ai_node,
/obj/structure/cable,
/turf/open/floor,
/area/bigredv3/inside/engi/west)
"sD" = (
/obj/effect/decal/cleanable/dirt,
/turf/open/floor,
/area/bigredv3/inside/engi/west)
"sF" = (
/obj/structure/table,
/obj/effect/spawner/random/engineering/toolbox,
/obj/effect/decal/cleanable/dirt,
/turf/open/floor,
/area/bigredv3/inside/engi/west)
"sK" = (
/obj/structure/table,
/obj/effect/spawner/random/engineering/tool,
/turf/open/floor,
/area/bigredv3/inside/engi/power_plant)
"tc" = (
/obj/machinery/door/airlock/mainship/engineering/free_access{
	dir = 1;
	name = "\improper Engineering SMES"
	},
/turf/open/floor/plating,
/area/bigredv3/inside/engi/fabrication)
"tJ" = (
/obj/structure/bed/chair{
	dir = 8
	},
/turf/open/floor,
/area/bigredv3/inside/engi/west)
"tW" = (
/obj/machinery/atmospherics/pipe/simple/green/hidden{
	dir = 4
	},
/obj/machinery/door/airlock/mainship/engineering/free_access{
	name = "\improper Engineering Workshop"
	},
/obj/structure/cable,
/turf/open/floor,
/area/bigredv3/inside/engi/west)
"us" = (
/obj/machinery/light{
	dir = 4
	},
/obj/structure/cable,
/turf/open/floor,
/area/bigredv3/inside/engi)
"uv" = (
/obj/structure/cable,
/turf/open/floor,
/area/bigredv3/inside/engi/west)
"uP" = (
/obj/machinery/light{
	dir = 8
	},
/turf/open/liquid/water/river,
/area/bigredv3/inside/engi/power_plant)
"uU" = (
/obj/machinery/atmospherics/components/unary/vent_pump,
/turf/open/floor,
/area/bigredv3/inside/engi/locker_room)
"vv" = (
/obj/structure/table,
/obj/machinery/light,
/obj/effect/spawner/random/engineering/tool,
/turf/open/floor,
/area/bigredv3/inside/engi/west)
"vw" = (
/obj/effect/landmark/start/job/survivor,
/obj/effect/landmark/start/latejoinsurvivor,
/turf/open/floor,
/area/bigredv3/inside/engi/west)
"vR" = (
/obj/effect/decal/cleanable/dirt,
/obj/machinery/door/airlock/multi_tile/mainship/generic{
	name = "\improper Engineering Complex"
	},
/turf/open/floor,
/area/bigredv3/inside/engi/west)
"we" = (
/obj/effect/decal/cleanable/dirt,
/obj/effect/ai_node,
/obj/structure/cable,
/turf/open/floor,
/area/bigredv3/inside/engi/west)
"wL" = (
/obj/structure/window/framed/colony/reinforced,
/obj/machinery/door/poddoor/mainship{
	dir = 2;
	id = "rad_door";
	name = "\improper Radiation Shielding"
	},
/turf/open/floor/plating,
/area/bigredv3/inside/wall)
"wN" = (
/obj/machinery/atmospherics/pipe/manifold/green/hidden{
	dir = 8
	},
/obj/structure/cable,
/turf/open/floor,
/area/bigredv3/inside/engi/west)
"wY" = (
/obj/effect/decal/cleanable/dirt,
/obj/effect/ai_node,
/obj/structure/cable,
/turf/open/floor/plating,
/area/bigredv3/inside/engi/power_plant)
"xc" = (
/obj/machinery/atmospherics/pipe/simple/green/hidden,
/obj/machinery/door/airlock/mainship/engineering/free_access{
	dir = 1;
	name = "\improper Chief Engineer's Office"
	},
/obj/structure/cable,
/turf/open/floor,
/area/bigredv3/inside/engi/ceo)
"xu" = (
/turf/open/floor/plating/ground/mars/random/sand,
/area/bigredv3/outside/directions/s)
"xT" = (
/obj/machinery/door/airlock/mainship/engineering/free_access{
	name = "\improper Engine Reactor Control"
	},
/turf/open/floor,
/area/bigredv3/inside/engi/power_plant)
"yi" = (
/turf/open/floor/plating/ground/mars/random/cave/rock,
/area/bigredv3/outside/directions/s)
"yo" = (
/obj/effect/decal/cleanable/dirt,
/obj/machinery/atmospherics/components/unary/vent_pump{
	dir = 1;
	on = 1
	},
/turf/open/floor,
/area/bigredv3/inside/engi/power_plant)
"yQ" = (
/obj/item/tool/multitool,
/obj/effect/ai_node,
/turf/open/floor/plating,
/area/bigredv3/inside/engi/power_plant)
"yR" = (
/obj/machinery/computer/area_atmos,
/turf/open/floor,
/area/bigredv3/inside/engi/west)
"yS" = (
/turf/open/floor/plating/ground/mars/cavetodirt{
	dir = 9
	},
/area/bigredv3/outside/directions/sw)
"zt" = (
/obj/machinery/computer/arcade,
/turf/open/floor,
/area/bigredv3/inside/engi/west)
"zA" = (
/obj/machinery/atmospherics/pipe/simple/green/hidden,
/obj/machinery/door/airlock/mainship/engineering/free_access{
	dir = 1;
	name = "\improper Engineering Tool Storage"
	},
/obj/structure/cable,
/turf/open/floor,
/area/bigredv3/inside/engi/fabrication)
"zN" = (
/obj/machinery/vending/snack,
/turf/open/floor,
/area/bigredv3/inside/engi/west)
"AS" = (
/turf/open/floor,
/area/bigredv3/inside/engi/west)
"AT" = (
/obj/structure/sign/safety/high_radiation,
/turf/open/floor,
/area/bigredv3/inside/engi/west)
"Bc" = (
/obj/structure/cable,
/turf/open/floor/plating,
/area/bigredv3/inside/engi/power_plant)
"Bg" = (
/obj/machinery/atmospherics/pipe/simple/green/hidden,
/obj/effect/ai_node,
/obj/structure/cable,
/turf/open/floor,
/area/bigredv3/inside/engi/fabrication)
"Cr" = (
/obj/structure/table,
/obj/effect/spawner/random/misc/earmuffs,
/turf/open/floor,
/area/bigredv3/inside/engi/west)
"Cx" = (
/obj/structure/table,
/obj/effect/spawner/random/engineering/tool,
/obj/effect/spawner/random/engineering/technology_scanner,
/turf/open/floor,
/area/bigredv3/inside/engi/west)
"CL" = (
/obj/machinery/light{
	dir = 8
	},
/obj/structure/cable,
/turf/open/floor,
/area/bigredv3/inside/engi/power_plant)
"CS" = (
/obj/structure/table,
/obj/item/tool/lighter/random,
/turf/open/floor,
/area/bigredv3/inside/engi/west)
"Di" = (
/obj/effect/spawner/random/machinery/machine_frame,
/turf/open/floor,
/area/bigredv3/inside/engi/west)
"EX" = (
/obj/effect/decal/cleanable/dirt,
/obj/structure/sign/safety/electronics{
	dir = 1
	},
/obj/structure/cable,
/turf/open/floor,
/area/bigredv3/inside/engi/fabrication)
"Fg" = (
/obj/structure/table,
/obj/effect/decal/cleanable/dirt,
/obj/item/tool/pen,
/turf/open/floor,
/area/bigredv3/inside/engi/west)
"Fu" = (
/obj/machinery/floodlight/outpost/bigred,
/turf/open/floor/plating/ground/mars/random/sand,
/area/bigredv3/outside/directions/s)
"FY" = (
/obj/machinery/atmospherics/pipe/manifold/green/hidden,
/obj/effect/ai_node,
/obj/structure/cable,
/turf/open/floor,
/area/bigredv3/inside/engi/west)
"Gl" = (
/turf/open/floor/plating/ground/mars/random/sand,
/area/bigredv3/outside/directions/sw)
"Gr" = (
/obj/machinery/atmospherics/pipe/manifold/green/hidden{
	dir = 4
	},
/obj/effect/ai_node,
/obj/structure/cable,
/turf/open/floor,
/area/bigredv3/inside/engi/west)
"GE" = (
/obj/machinery/atmospherics/pipe/simple/green/hidden{
	dir = 4
	},
/obj/structure/cable,
/turf/open/floor,
/area/bigredv3/inside/engi/west)
"GK" = (
/obj/machinery/atmospherics/pipe/simple/green/hidden,
/obj/structure/cable,
/turf/open/floor,
/area/bigredv3/inside/engi/fabrication)
"Hh" = (
/obj/machinery/atmospherics/pipe/manifold/green/hidden{
	dir = 8
	},
/obj/effect/ai_node,
/obj/structure/cable,
/turf/open/floor,
/area/bigredv3/inside/engi/west)
"Hk" = (
/turf/open/liquid/water/river,
/area/bigredv3/inside/engi/power_plant)
"Hu" = (
/obj/machinery/floodlight/outpost/bigred,
/turf/open/floor/plating/ground/mars/random/dirt,
/area/bigredv3/outside/directions/sw)
"Hz" = (
/turf/open/floor/plating/ground/mars/dirttosand/autosmooth{
	dir = 9
	},
/area/bigredv3/outside/directions/s)
"HF" = (
/obj/structure/bed/chair{
	dir = 4
	},
/obj/effect/decal/cleanable/dirt,
/turf/open/floor,
/area/bigredv3/inside/engi/west)
"HK" = (
/obj/machinery/light{
	dir = 8
	},
/turf/open/floor,
/area/bigredv3/inside/engi/fabrication)
"HP" = (
/obj/machinery/atmospherics/pipe/simple/green/hidden{
	dir = 5
	},
/obj/effect/ai_node,
/obj/structure/cable,
/turf/open/floor,
/area/bigredv3/inside/engi/west)
"HW" = (
/obj/structure/closet/radiation,
/turf/open/floor,
/area/bigredv3/inside/engi/west)
"Ib" = (
/turf/closed/wall/r_wall)
"Ic" = (
/obj/structure/bed/chair/office/light,
/turf/open/floor,
/area/bigredv3/inside/engi/power_plant)
"Ke" = (
/obj/structure/closet/radiation,
/turf/open/floor,
/area/bigredv3/inside/engi)
"Kv" = (
/obj/machinery/light{
	dir = 8
	},
/turf/open/floor/plating,
/area/bigredv3/inside/engi/power_plant)
"Lm" = (
/obj/machinery/door/airlock/mainship/engineering/free_access{
	dir = 1;
	name = "\improper Engine Reactor Control"
	},
/obj/machinery/atmospherics/pipe/simple/green/hidden,
/turf/open/floor,
/area/bigredv3/inside/engi/power_plant)
"Mk" = (
/turf/closed/wall/mineral/gold,
/area/bigredv3/inside/engi/power_plant)
"MJ" = (
/obj/structure/table,
/obj/item/tool/analyzer,
/turf/open/floor,
/area/bigredv3/inside/engi/power_plant)
"MK" = (
/turf/open/floor,
/area/bigredv3/inside/engi/ceo)
"Nh" = (
/obj/effect/decal/cleanable/dirt,
/obj/item/clothing/head/welding,
/turf/open/floor,
/area/bigredv3/inside/engi/west)
"Nn" = (
/obj/structure/cable,
/turf/open/floor,
/area/bigredv3/inside/engi/fabrication)
"Nr" = (
/turf/open/floor/plating/ground/mars/random/dirt,
/area/bigredv3/outside/directions/sw)
"NZ" = (
/turf/open/floor,
/area/bigredv3/inside/engi/power_plant)
"Od" = (
/obj/effect/decal/cleanable/dirt,
/turf/open/floor/plating,
/area/bigredv3/inside/engi/power_plant)
"Of" = (
/obj/structure/table,
/obj/effect/spawner/random/engineering/toolbox,
/turf/open/floor,
/area/bigredv3/inside/engi/fabrication)
"Or" = (
/obj/machinery/atmospherics/pipe/simple/green/hidden,
/obj/structure/cable,
/turf/open/floor,
/area/bigredv3/inside/engi/west)
"OF" = (
/obj/effect/decal/cleanable/dirt,
/obj/machinery/atmospherics/pipe/simple/green/hidden{
	dir = 4
	},
/obj/effect/ai_node,
/obj/structure/cable,
/turf/open/floor,
/area/bigredv3/inside/engi/west)
"OQ" = (
/obj/effect/decal/cleanable/dirt,
/obj/item/clothing/mask/breath,
/turf/open/floor,
/area/bigredv3/inside/engi/west)
"OR" = (
/obj/machinery/door/airlock/mainship/secure/free_access{
	dir = 1;
	name = "\improper Engine Reactor"
	},
/obj/structure/cable,
/turf/open/floor,
/area/bigredv3/inside/engi/power_plant)
"Pg" = (
/obj/machinery/light{
	dir = 8
	},
/turf/open/floor,
/area/bigredv3/inside/engi/west)
"Pk" = (
/obj/effect/decal/cleanable/dirt,
/obj/effect/spawner/random/machinery/machine_frame,
/turf/open/floor,
/area/bigredv3/inside/engi/west)
"Pz" = (
/obj/machinery/door_control{
	dir = 1;
	id = "Engineering";
	name = "Storm Shutters"
	},
/turf/open/floor,
/area/bigredv3/inside/engi/west)
"PB" = (
/turf/open/floor/marking/asteroidwarning{
	dir = 4
	},
/area/bigredv3/outside/directions/central)
"PN" = (
/obj/machinery/atmospherics/pipe/manifold/green/hidden{
	dir = 1
	},
/obj/effect/ai_node,
/obj/structure/cable,
/turf/open/floor,
/area/bigredv3/inside/engi/west)
"PZ" = (
/obj/effect/decal/cleanable/dirt,
/obj/effect/ai_node,
/turf/open/floor/plating,
/area/bigredv3/inside/engi/power_plant)
"QH" = (
/obj/effect/spawner/random/engineering/structure/tank/fuelweighted,
/turf/open/floor,
/area/bigredv3/inside/engi/fabrication)
"QO" = (
/obj/machinery/vending/cola,
/turf/open/floor,
/area/bigredv3/inside/engi/west)
"QT" = (
/obj/machinery/atmospherics/pipe/simple/green/hidden,
/obj/machinery/door/airlock/mainship/engineering/free_access{
	dir = 1;
	name = "\improper Engineering Lockers"
	},
/obj/structure/cable,
/turf/open/floor,
/area/bigredv3/inside/engi/locker_room)
"Ri" = (
/obj/machinery/atmospherics/pipe/simple/green/hidden{
	dir = 4
	},
/obj/effect/decal/cleanable/dirt,
/obj/structure/cable,
/turf/open/floor,
/area/bigredv3/inside/engi/west)
"Rk" = (
/obj/structure/rack,
/obj/item/camera_film,
/turf/open/floor,
/area/bigredv3/inside/engi/west)
"Rl" = (
/obj/machinery/computer/station_alert,
/obj/structure/table,
/turf/open/floor,
/area/bigredv3/inside/engi/power_plant)
"RD" = (
/obj/machinery/power/geothermal/bigred,
/obj/structure/cable,
/turf/open/floor/plating,
/area/bigredv3/inside/engi/power_plant)
"RW" = (
/obj/structure/table,
/turf/open/floor,
/area/bigredv3/inside/engi/ceo)
"Si" = (
/turf/open/floor/plating/ground/mars/random/sand,
/area/bigredv3/outside/directions/central)
"Sy" = (
/obj/machinery/bot/mulebot,
/turf/open/floor,
/area/bigredv3/inside/engi/west)
"ST" = (
/obj/structure/table,
/obj/machinery/light{
	dir = 8
	},
/obj/effect/spawner/random/engineering/technology_scanner,
/turf/open/floor,
/area/bigredv3/inside/engi/power_plant)
"Tl" = (
/obj/structure/closet/radiation,
/turf/open/floor,
/area/bigredv3/inside/engi/power_plant)
"Tt" = (
/obj/machinery/power/apc/weak/ntf{
	dir = 4
	},
/obj/structure/cable,
/turf/open/floor,
/area/bigredv3/inside/engi/fabrication)
"TB" = (
/obj/machinery/atmospherics/pipe/simple/green/hidden,
/obj/effect/ai_node,
/obj/structure/cable,
/turf/open/floor,
/area/bigredv3/inside/engi/west)
"TY" = (
/obj/effect/ai_node,
/turf/open/floor/plating/ground/mars/cavetodirt{
	dir = 1
	},
/area/bigredv3/caves/southwest)
"Uz" = (
/obj/structure/rack,
/obj/item/tool/analyzer,
/turf/open/floor,
/area/bigredv3/inside/engi/west)
"UM" = (
/turf/closed/wall,
/area/bigredv3/inside/wall)
"UO" = (
/obj/effect/decal/cleanable/dirt,
/turf/open/floor,
/area/bigredv3/inside/engi/fabrication)
"Vk" = (
/turf/open/floor,
/area/bigredv3/inside/engi/locker_room)
"Vy" = (
/obj/effect/decal/cleanable/dirt,
/obj/item/tool/weldpack,
/turf/open/floor,
/area/bigredv3/inside/engi/west)
"VK" = (
/obj/effect/spawner/random/engineering/structure/tank/waterweighted,
/obj/effect/decal/cleanable/dirt,
/obj/machinery/light{
	dir = 4
	},
/turf/open/floor,
/area/bigredv3/inside/engi/fabrication)
"Wq" = (
/obj/structure/table,
/obj/effect/spawner/random/engineering/toolbox,
/turf/open/floor,
/area/bigredv3/inside/engi/west)
"WA" = (
/obj/machinery/light{
	dir = 8
	},
/obj/effect/decal/cleanable/dirt,
/turf/open/floor/plating,
/area/bigredv3/inside/engi/power_plant)
"Xe" = (
/obj/machinery/light,
/turf/open/floor/plating,
/area/bigredv3/inside/engi/power_plant)
"XF" = (
/obj/machinery/power/monitor{
	name = "Main Power Grid Monitoring"
	},
/turf/open/floor,
/area/bigredv3/inside/engi/power_plant)
"Yk" = (
/obj/machinery/door_control{
	desc = "A remote control-switch for opening the engines blast doors.";
	dir = 8;
	id = "rad_door";
	name = "Reactor Radiation Shielding control"
	},
/turf/open/floor,
/area/bigredv3/inside/engi/power_plant)
"YJ" = (
/obj/machinery/atmospherics/pipe/manifold/green/hidden{
	dir = 4
	},
/obj/structure/cable,
/turf/open/floor,
/area/bigredv3/inside/engi/locker_room)
"Zo" = (
/obj/effect/ai_node,
/turf/open/floor/plating/ground/mars/random/dirt,
/area/bigredv3/outside/directions/sw)
"ZE" = (
/obj/structure/table,
/obj/effect/spawner/random/engineering/powercell,
/turf/open/floor,
/area/bigredv3/inside/engi/west)
"ZX" = (
/obj/effect/decal/cleanable/dirt,
/obj/structure/sign/safety/electronics{
	dir = 1
	},
/turf/open/floor,
/area/bigredv3/inside/engi/fabrication)

(1,1,1) = {"
Vk
uU
YJ
QT
Or
Hh
qE
hQ
qE
ee
Di
qg
Gl
Gl
Gl
op
op
kJ
kJ
kJ
kJ
kJ
kJ
dp
kJ
kJ
kJ
"}
(2,1,1) = {"
kq
kq
kq
kq
UM
GE
sD
AS
sD
AS
Pk
qg
oE
oE
oE
Nr
op
kJ
kJ
kJ
kJ
kJ
kJ
kJ
dp
of
kJ
"}
(3,1,1) = {"
UM
ZX
hJ
Tt
UM
GE
AS
oP
AS
AS
vv
kq
Zo
Hu
Nr
Nr
Nr
TY
kJ
of
kJ
kJ
kJ
kJ
jr
dp
kJ
"}
(4,1,1) = {"
tc
bI
Nn
cu
UM
GE
sF
ZE
Fg
sD
rt
kq
Nr
Nr
Nr
Nr
yS
dp
kJ
kJ
kJ
kJ
kJ
kJ
kJ
kJ
kJ
"}
(5,1,1) = {"
UM
EX
mf
mf
UM
tW
oX
oX
oX
kq
kq
kq
kq
kq
kq
kq
kq
kq
kq
kq
kq
kq
kq
kq
kq
op
op
"}
(6,1,1) = {"
UM
Nn
VK
QH
UM
GE
AS
sD
pE
Ib
Ke
kq
aU
Od
WA
aU
aU
aU
aU
Od
WA
Od
Od
aU
kq
op
op
"}
(7,1,1) = {"
UM
qs
UM
UM
UM
OF
uv
uv
we
dk
us
dk
Bc
bh
bh
bh
wY
aU
Od
Od
PZ
Od
Od
Od
kq
kq
op
"}
(8,1,1) = {"
HK
cu
UM
Uz
Rk
GE
AS
AS
AT
kq
kq
kq
Od
Od
Od
aU
Bc
Od
Od
Od
Od
Od
Od
aU
aU
kq
op
"}
(9,1,1) = {"
mf
cu
oX
AS
AS
nx
Sy
AS
AS
HW
HW
kq
Hk
Hk
Hk
Hk
Bc
Hk
Hk
Hk
aU
Hk
Hk
Hk
aU
kq
kq
"}
(10,1,1) = {"
mf
cu
oX
AS
OQ
nx
Vy
AS
AS
AS
AS
wL
Hk
Hk
Mk
Hk
Bc
Hk
Mk
Hk
aU
Hk
Mk
Hk
aU
Xe
kq
"}
(11,1,1) = {"
GK
Bg
zA
Hh
Or
sf
AS
AS
AS
AS
AS
wL
Hk
Hk
Hk
Hk
Bc
Hk
Hk
Hk
aU
Hk
Hk
Hk
aU
aU
kq
"}
(12,1,1) = {"
UO
UO
oX
Ri
sD
sD
sD
kT
sD
AS
AS
wL
Hk
Hk
Mk
Hk
Bc
Hk
Mk
Hk
aU
Hk
Mk
Hk
aU
aU
kq
"}
(13,1,1) = {"
UO
qf
oX
Ri
sD
UM
UM
UM
xT
UM
UM
kq
kq
Hk
Hk
Hk
Bc
Hk
ea
Hk
aU
Hk
Hk
Hk
aU
aU
kq
"}
(14,1,1) = {"
mf
lZ
UM
GE
AS
UM
ST
sK
NZ
NZ
NZ
Rl
wL
Hk
Mk
Hk
Bc
aU
kq
aU
aU
Hk
Mk
Hk
aU
aU
kq
"}
(15,1,1) = {"
mf
Of
oX
Ri
iT
UM
NZ
dI
NZ
hl
Ic
sK
wL
Hk
Hk
Hk
Bc
aU
Kv
aU
aU
Hk
Hk
Hk
aU
aU
kq
"}
(16,1,1) = {"
pR
fQ
oX
PN
qE
Lm
gp
gp
jG
yo
NZ
XF
wL
Hk
Mk
Hk
gx
Bc
RD
aU
yQ
Hk
Mk
Hk
aU
aU
kq
"}
(17,1,1) = {"
UM
UM
UM
jR
bB
UM
hl
hl
NZ
hl
Ic
MJ
wL
Hk
Hk
Hk
Bc
aU
oI
aU
aU
Hk
Hk
Hk
aU
aU
kq
"}
(18,1,1) = {"
RW
oX
Pg
GE
sD
UM
NZ
Yk
NZ
NZ
NZ
rK
wL
Hk
Mk
Hk
Bc
aU
kq
aU
aU
Hk
Mk
Hk
aU
aU
kq
"}
(19,1,1) = {"
MK
oX
AS
GE
Pz
UM
UM
UM
xT
UM
UM
kq
kq
Hk
Hk
Hk
Bc
Hk
uP
Hk
aU
Hk
Hk
Hk
aU
aU
kq
"}
(20,1,1) = {"
MK
oX
AS
GE
sD
AS
AS
Pg
AS
sD
AS
wL
Hk
Hk
Mk
Hk
Bc
Hk
Mk
Hk
aU
Hk
Mk
Hk
aU
aU
kq
"}
(21,1,1) = {"
eM
xc
Or
FY
HF
nz
nz
sD
AS
sD
AS
wL
Hk
Hk
Hk
Hk
Bc
Hk
Hk
Hk
aU
Hk
Hk
Hk
aU
aU
kq
"}
(22,1,1) = {"
MK
oX
AS
GE
hU
Cx
eQ
sD
AS
AS
AS
wL
Hk
Hk
Mk
Hk
Bc
Hk
Mk
Hk
aU
Hk
Mk
Hk
aU
Xe
kq
"}
(23,1,1) = {"
UM
UM
vw
GE
Wq
Cr
CS
AS
AS
AS
yR
kq
Hk
Hk
Hk
Hk
Bc
Hk
Hk
Hk
aU
Hk
Hk
Hk
aU
kq
kq
"}
(24,1,1) = {"
sD
vR
AS
GE
tJ
tJ
tJ
sD
pe
kq
kq
kq
aU
aU
aU
aU
Bc
cQ
aU
Od
Od
aU
aU
aU
aU
kq
jq
"}
(25,1,1) = {"
gE
gE
Or
Gr
eR
Or
wN
ma
we
OR
CL
OR
Bc
Bc
Bc
Bc
gx
Od
Od
aU
PZ
aU
aU
aU
kq
kq
yi
"}
(26,1,1) = {"
kq
kq
kq
kq
kq
zt
ok
nx
lX
kq
Tl
kq
aU
Od
oI
aU
aU
aU
aU
aU
oI
aU
aU
aU
kq
hz
jq
"}
(27,1,1) = {"
PB
PB
PB
PB
kq
kq
qi
nx
Nh
kq
kq
kq
kq
kq
kq
kq
kq
kq
kq
kq
kq
kq
kq
kq
kq
jq
jq
"}
(28,1,1) = {"
Si
Si
Si
Si
Si
kq
zN
aA
TB
Or
Or
Or
Or
HP
kq
xu
xu
xu
xu
gy
ci
ci
ci
ci
gH
jq
jq
"}
(29,1,1) = {"
Si
Si
Si
Si
Si
kq
QO
AS
fK
kT
sD
AS
AS
GE
kq
xu
Fu
xu
Hz
ci
kp
ci
ci
gH
jq
jq
jq
"}
(30,1,1) = {"
Si
Si
Si
Si
Si
kq
kq
kq
kq
kq
kq
kq
AS
qP
kq
xu
xu
Hz
ci
ci
ci
kq
kq
kq
kq
kq
kq
"}
