//MAP CONVERTED BY dmm2tgm.py THIS HEADER COMMENT PREVENTS RECONVERSION, DO NOT REMOVE
"e" = (
/obj/effect/ai_node,
/turf/open/floor/plating/ground/mars/random/cave,
/area/bigredv3/caves/east/garbledradio)
"g" = (
/obj/effect/landmark/lv624/fog_blocker,
/turf/open/floor/plating/ground/mars/random/cave,
/area/bigredv3/caves/east/garbledradio)
"l" = (
/turf/open/floor/plating/ground/mars/random/cave/rock,
/area/bigredv3/caves/east/garbledradio)
"m" = (
/obj/effect/landmark/lv624/fog_blocker,
/obj/effect/ai_node,
/turf/open/floor/plating/ground/mars/random/cave,
/area/bigredv3/caves/east/garbledradio)
"w" = (
/turf/closed/mineral/smooth/bigred,
/area/bigredv3/caves/rock)
"x" = (
/obj/effect/ai_node,
/turf/open/floor/plating/ground/mars/random/cave,
/area/bigredv3/caves/northeast/garbledradio)
"y" = (
/turf/open/floor/plating/ground/mars/random/cave,
/area/bigredv3/caves/east/garbledradio)
"E" = (
/obj/effect/ai_node,
/turf/open/floor/plating/ground/mars/random/cave/rock,
/area/bigredv3/caves/east/garbledradio)
"J" = (
/obj/effect/landmark/lv624/fog_blocker,
/turf/closed/mineral/smooth/bigred,
/area/bigredv3/caves/rock)
"N" = (
/obj/effect/ai_node,
/turf/open/floor/plating/ground/mars/random/cave/rock,
/area/bigredv3/caves/northeast/garbledradio)
"X" = (
/turf/open/floor/plating/ground/mars/random/cave,
/area/bigredv3/caves/northeast/garbledradio)

(1,1,1) = {"
w
w
w
w
w
w
w
w
w
w
w
"}
(2,1,1) = {"
w
w
w
w
w
w
w
w
w
w
w
"}
(3,1,1) = {"
w
w
w
w
w
w
w
w
w
w
w
"}
(4,1,1) = {"
w
w
w
w
w
w
w
w
w
w
w
"}
(5,1,1) = {"
N
w
w
w
w
w
w
w
w
w
w
"}
(6,1,1) = {"
X
w
w
w
w
w
w
w
w
w
w
"}
(7,1,1) = {"
X
y
w
w
w
w
w
w
w
l
l
"}
(8,1,1) = {"
X
y
y
w
w
w
w
w
y
y
g
"}
(9,1,1) = {"
X
y
y
w
w
w
y
y
y
g
e
"}
(10,1,1) = {"
x
y
y
y
e
y
y
E
y
m
y
"}
(11,1,1) = {"
X
y
y
y
y
y
y
g
g
y
y
"}
(12,1,1) = {"
X
y
y
y
y
y
g
l
y
y
e
"}
(13,1,1) = {"
x
y
y
y
y
g
y
y
y
w
w
"}
(14,1,1) = {"
w
y
y
y
y
g
y
y
y
w
w
"}
(15,1,1) = {"
w
w
w
y
e
g
y
e
w
w
w
"}
(16,1,1) = {"
w
w
w
w
y
g
y
w
w
w
w
"}
(17,1,1) = {"
w
w
w
w
w
J
w
w
w
w
w
"}
(18,1,1) = {"
w
w
w
w
w
J
w
w
w
w
w
"}
(19,1,1) = {"
w
w
w
w
w
J
w
w
w
w
w
"}
(20,1,1) = {"
w
w
w
w
w
J
w
w
w
w
w
"}
(21,1,1) = {"
w
w
w
w
w
J
w
w
w
w
w
"}
(22,1,1) = {"
J
J
J
J
J
w
w
w
w
w
w
"}
