//MAP CONVERTED BY dmm2tgm.py THIS HEADER COMMENT PREVENTS RECONVERSION, DO NOT REMOVE
"aa" = (
/turf/open/floor/plating/ground/mars/random/cave/rock,
/area/bigredv3/caves/east/garbledradio)
"ab" = (
/obj/effect/ai_node,
/turf/open/floor/plating/ground/mars/random/cave,
/area/bigredv3/caves/east/garbledradio)
"ah" = (
/turf/open/floor/plating/ground/mars/random/cave,
/area/bigredv3/caves/east/garbledradio)
"ak" = (
/turf/closed/mineral/smooth/bigred,
/area/bigredv3/caves/rock)
"al" = (
/obj/effect/landmark/lv624/fog_blocker/xeno_spawn,
/obj/effect/landmark/lv624/fog_blocker/xeno_spawn,
/turf/closed/mineral/smooth/bigred,
/area/bigredv3/caves/rock)
"am" = (
/turf/closed/mineral/smooth/bigred/indestructible,
/area/space)
"ar" = (
/obj/effect/landmark/xeno_silo_spawn,
/turf/open/floor/plating/ground/mars/random/cave,
/area/bigredv3/caves/east/garbledradio)
"au" = (
/turf/open/floor/plating/ground/mars/random/cave/rock,
/area/bigredv3/caves/east)
"az" = (
/obj/effect/landmark/lv624/fog_blocker/xeno_spawn,
/obj/effect/landmark/lv624/fog_blocker/xeno_spawn,
/turf/open/floor/plating/ground/mars/random/cave,
/area/bigredv3/caves/east/garbledradio)
"aF" = (
/obj/effect/landmark/xeno_silo_spawn,
/turf/open/floor/plating/ground/mars/random/cave,
/area/bigredv3/caves/east)
"aK" = (
/obj/effect/ai_node,
/turf/open/floor/plating/ground/mars/random/cave,
/area/bigredv3/caves/east)
"aM" = (
/obj/effect/landmark/lv624/fog_blocker/xeno_spawn,
/turf/closed/mineral/smooth/bigred,
/area/bigredv3/caves/rock)
"aN" = (
/obj/effect/landmark/lv624/fog_blocker/xeno_spawn,
/turf/open/floor/plating/ground/mars/random/cave,
/area/bigredv3/caves/east)
"aP" = (
/obj/effect/landmark/lv624/fog_blocker/xeno_spawn,
/turf/open/floor/plating/ground/mars/random/cave,
/area/bigredv3/caves/east/garbledradio)
"aQ" = (
/obj/effect/ai_node,
/turf/open/floor/plating/ground/mars/random/cave/rock,
/area/bigredv3/caves/east/garbledradio)
"aS" = (
/obj/effect/landmark/lv624/fog_blocker/xeno_spawn,
/turf/open/floor/plating/ground/mars/random/cave/rock,
/area/bigredv3/caves/east/garbledradio)
"aW" = (
/obj/effect/landmark/lv624/fog_blocker,
/turf/closed/wall/r_wall,
/area/bigredv3/caves/east/garbledradio)
"aX" = (
/turf/open/floor/plating/ground/mars/random/cave,
/area/bigredv3/caves/east)
"kb" = (
/obj/effect/landmark/lv624/fog_blocker,
/turf/closed/mineral/smooth/bigred,
/area/bigredv3/caves/rock)
"rp" = (
/obj/effect/landmark/xeno_tunnel_spawn,
/turf/open/floor/plating/ground/mars/random/cave,
/area/bigredv3/caves/east)
"zN" = (
/obj/effect/ai_node,
/turf/open/floor/plating/ground/mars/random/sand,
/area/bigredv3/outside/directions/se)
"DH" = (
/obj/effect/landmark/xeno_tunnel_spawn,
/turf/open/floor/plating/ground/mars/random/cave,
/area/bigredv3/caves/east/garbledradio)
"SF" = (
/turf/open/floor/plating/ground/mars/random/sand,
/area/bigredv3/outside/directions/se)
"Ud" = (
/obj/structure/fence/standard/xenoproof,
/turf/open/floor/plating/ground/mars/random/cave,
/area/bigredv3/caves/east/garbledradio)

(1,1,1) = {"
SF
SF
SF
SF
SF
SF
SF
SF
SF
SF
SF
ak
ak
ak
aW
Ud
Ud
ah
ah
ah
ah
ah
ah
ah
ah
ah
ah
ah
ak
ak
ak
ak
ak
ak
ak
ak
ak
ah
ah
ah
ah
ah
"}
(2,1,1) = {"
SF
SF
SF
SF
SF
SF
SF
SF
SF
SF
SF
ak
ak
ak
kb
ah
ah
ah
ah
ah
ah
ah
ah
ah
ah
ah
ah
ah
ak
ak
ak
ak
ak
ak
ak
ak
ak
ak
ah
ah
ab
ah
"}
(3,1,1) = {"
SF
SF
SF
SF
SF
SF
SF
SF
SF
SF
SF
ak
ak
ak
kb
ah
ah
ah
ah
ah
ah
ak
ak
ak
ak
ak
ah
ah
ah
ak
ak
ak
ak
ak
ak
ak
ak
ak
ah
ah
ah
ah
"}
(4,1,1) = {"
SF
ak
ak
ak
ak
SF
SF
SF
SF
SF
SF
SF
ak
ak
kb
ah
ah
ah
ah
ah
ah
ak
ak
ak
ak
ak
aa
ah
ah
ah
ah
ah
ah
ah
ah
ak
aa
aa
ah
ah
ah
ah
"}
(5,1,1) = {"
SF
ak
ak
ak
ak
ak
ak
SF
SF
SF
SF
SF
SF
ak
kb
ak
ah
az
aP
aP
aM
aM
aM
aM
aM
aM
aP
aS
az
ah
ah
ah
ah
ah
ah
aa
ah
ah
ah
ah
ah
ah
"}
(6,1,1) = {"
SF
SF
ak
ak
ak
ak
ak
ak
SF
SF
SF
SF
SF
ak
kb
ak
ak
aP
ah
ak
ak
ak
ak
ak
ak
ah
ah
ah
aS
aa
ab
ah
ah
ah
ah
ah
ah
ah
ah
ah
ab
aa
"}
(7,1,1) = {"
SF
SF
SF
SF
SF
SF
SF
SF
SF
SF
SF
SF
SF
ak
kb
ak
ak
aP
ah
ah
ah
ak
ah
ak
ak
ah
ab
ah
aP
ab
ah
ah
ah
ah
ah
ah
ah
ah
ah
ah
ah
aa
"}
(8,1,1) = {"
SF
SF
SF
SF
SF
SF
SF
SF
SF
SF
SF
SF
SF
ak
kb
ak
ak
aM
DH
ah
ah
ab
ah
ah
ab
ab
ah
ah
aP
ah
ah
ah
ah
ah
ah
ah
aa
ah
ah
ah
aa
ak
"}
(9,1,1) = {"
SF
SF
SF
SF
SF
zN
SF
SF
SF
zN
SF
SF
SF
ak
kb
ak
ak
aM
ah
ah
ah
ah
ah
ah
ah
ah
ah
ak
aM
ak
ak
ak
ah
ah
ah
ah
ah
aa
ah
ah
ah
aa
"}
(10,1,1) = {"
SF
SF
SF
SF
SF
SF
SF
SF
SF
SF
SF
SF
ak
ak
kb
ak
ak
aM
ak
ak
ah
ah
ah
ah
ah
ak
ak
ak
aM
ak
ak
ak
ak
ak
ak
ak
ah
ah
ah
ah
ah
aa
"}
(11,1,1) = {"
SF
SF
ak
SF
SF
SF
SF
SF
SF
SF
SF
ak
ak
ak
kb
ak
ak
aM
ak
ah
ah
ah
ah
ah
ah
ah
ak
ak
aM
ak
ak
ak
ak
ak
ak
ak
ah
ah
ah
ah
ah
aa
"}
(12,1,1) = {"
SF
ak
ak
SF
SF
SF
SF
SF
SF
ak
ak
ak
ak
ak
kb
ak
ak
aM
ah
aa
ah
ah
aa
ah
ah
ah
ak
ak
aM
ak
ak
ak
ak
ak
ak
ak
ah
ah
ah
ah
ah
aa
"}
(13,1,1) = {"
ak
ak
ak
SF
SF
SF
SF
SF
SF
ak
ak
ak
ak
ak
kb
ak
ak
aM
ah
ah
ah
ah
ah
ah
ah
ah
ak
ak
aM
ak
ak
ak
ak
ak
ak
ak
aa
ah
ah
ah
aa
ak
"}
(14,1,1) = {"
ak
ak
SF
SF
SF
SF
SF
SF
SF
ak
ak
ak
ak
ak
kb
ak
ak
aM
ah
ah
ah
ab
ar
ah
ah
ah
ah
ak
aM
ak
ak
ak
ak
ak
ak
ak
ah
ah
ah
ah
ab
aa
"}
(15,1,1) = {"
ak
SF
SF
SF
SF
SF
ak
ak
ak
ak
ak
ak
ak
ak
kb
ak
ak
aM
ah
ah
ah
ah
ah
ah
ah
ah
ak
ak
aM
ak
ak
ak
ak
ak
ak
ak
ak
aa
ah
ah
ah
aa
"}
(16,1,1) = {"
SF
SF
SF
SF
SF
zN
ak
ak
ak
ak
ak
ak
ak
ak
kb
ak
ak
aM
ak
ah
ah
ah
ah
ah
ah
ak
ak
ak
aM
ak
ak
ak
ak
ak
ak
ak
ak
ak
ah
ah
ah
ah
"}
(17,1,1) = {"
SF
SF
SF
SF
SF
SF
ak
ak
ak
ak
ak
ak
ak
ak
kb
ak
ak
aM
ak
ah
ah
ah
ah
ah
ak
ak
ak
ak
aM
ak
ak
ak
ak
ak
ak
ak
ak
ak
ah
ah
ah
ah
"}
(18,1,1) = {"
ak
ak
ak
ak
ak
ak
ak
ak
ak
ak
ak
ak
ak
ak
kb
ak
ak
al
aM
aP
aP
aP
aP
aP
aM
aM
aM
aM
al
ak
ak
ak
ak
ak
ak
ak
ah
ah
ah
ah
ah
ah
"}
(19,1,1) = {"
kb
kb
kb
kb
kb
kb
kb
kb
kb
kb
kb
kb
kb
kb
kb
ak
ak
ak
ak
ah
ah
ah
ah
ah
ak
ak
ak
ak
ak
ak
ak
ak
ak
ak
ak
ah
ah
ah
ah
ah
ah
ah
"}
(20,1,1) = {"
ak
ak
ak
ak
ak
ak
ak
ak
ak
ak
ak
ak
ak
ak
ak
ak
ak
ak
ak
ak
ah
ah
ah
ah
ak
ak
ak
ak
ak
ak
ak
ak
ak
ak
ah
ah
ah
ah
ah
ah
ah
ah
"}
(21,1,1) = {"
ak
ak
ak
ak
ak
ak
ak
ak
ak
ak
ak
ak
ak
ak
ak
ak
ak
ak
ak
ak
ah
ab
ah
ah
ah
ak
ak
ak
ak
ak
ak
ak
ak
ak
ah
ah
ah
ah
ah
aa
ah
ah
"}
(22,1,1) = {"
ak
aa
aa
aQ
aa
aa
ak
ak
ak
ak
ak
ak
ak
ak
ak
ak
ak
ak
ak
ak
ah
ah
ah
ah
ah
ak
ak
ak
ak
ak
ak
ak
ak
ak
ab
ah
ah
ah
ah
ah
ab
ah
"}
(23,1,1) = {"
ak
ah
ah
ah
ah
ah
aa
ak
ak
ak
ak
ak
ak
ak
ak
ak
ak
ak
ak
ak
ah
ah
ah
ah
ah
ak
ak
ak
ak
ak
ak
ak
ak
ak
ah
ah
aa
ak
ak
ah
ah
ah
"}
(24,1,1) = {"
ak
aa
ah
ah
ah
ah
aa
ak
ak
ak
ak
ak
ak
ak
ak
ak
ak
ak
ak
ak
ah
ah
ah
ah
ah
ak
ak
ak
ak
ak
ak
ak
ak
aa
ah
ah
aa
ak
ak
ah
ah
ah
"}
(25,1,1) = {"
ak
ak
ak
aQ
ah
ah
aa
ah
ab
ah
ah
ak
ak
ak
ak
ak
ak
ak
ak
ak
ah
ah
ah
ah
ah
ak
ak
ak
ak
ak
ak
ak
ak
ah
ah
aa
ak
ak
ak
ah
ah
ah
"}
(26,1,1) = {"
ak
ak
ak
ak
ak
ah
aa
ah
ah
ah
ah
ak
ak
ak
ak
aa
aa
ah
ah
ah
ah
ah
ah
ah
ah
ak
ak
ak
ak
ak
ak
ak
ak
ah
aa
ak
ak
ak
ak
ah
ab
ah
"}
(27,1,1) = {"
aa
aa
aa
aa
aa
ah
aa
ah
ah
ah
ah
ah
ah
ah
ah
ah
ah
ah
ah
ah
ah
ah
ah
ah
ah
ah
ak
ak
ak
ak
ak
ak
ak
ah
ab
aa
ak
aa
aa
ah
ah
ah
"}
(28,1,1) = {"
ab
ah
ah
ah
ah
ab
ah
aa
aQ
aa
aa
aa
aa
aa
ah
ah
aQ
ah
ah
ah
ah
ab
ah
ab
ah
ah
ak
ak
ak
ak
ak
ak
ak
ab
ah
ah
aa
ah
ah
ah
ah
ah
"}
(29,1,1) = {"
ah
ah
ah
ah
ah
ah
ah
ah
ah
ah
ah
ah
ah
ah
ah
ah
aa
ah
ah
aa
ah
ah
ah
ah
ah
ah
ak
ak
ak
ak
ak
ak
ak
ah
ah
ah
ah
ah
ah
ah
ah
ah
"}
(30,1,1) = {"
ah
ah
ah
ah
ah
ah
ah
ah
ah
ah
ah
ah
ah
ah
ah
ah
aa
ah
ah
ah
ah
ah
ah
ah
ah
ak
ak
ak
ak
ak
ak
ak
ak
ak
ah
ah
ah
ah
ah
ah
aQ
ak
"}
(31,1,1) = {"
ah
ah
ah
ah
ah
ah
ah
ah
ah
ah
ah
aa
ak
ak
ah
ah
aa
ah
ah
ah
ah
ah
ah
ah
ak
ak
ak
ak
ak
ak
ak
ak
ak
ak
ak
ak
ah
ah
ah
ah
aa
ak
"}
(32,1,1) = {"
aa
ah
ah
ah
ah
ah
ah
ak
ak
ak
ak
ak
ak
ak
ak
ah
aa
ah
ah
ah
ah
ah
ah
ak
ak
ak
ak
ak
ak
ak
ak
ak
ak
ak
ak
ak
ah
ah
ah
aa
ah
ak
"}
(33,1,1) = {"
ah
ah
ah
ah
ah
ah
ah
ak
ak
ak
ak
ak
ak
ak
ak
ah
aa
ah
ah
ah
ah
ah
ak
ak
ak
ak
ak
ak
ak
ak
ak
ak
ak
ak
ak
ak
ah
ah
aa
ah
ah
ah
"}
(34,1,1) = {"
aa
ah
ah
aa
ah
ah
ah
ak
ak
ak
ak
ak
ak
ak
aa
ah
ah
ah
ah
ah
ak
ak
ak
ak
ak
ak
ak
ak
ak
ak
ak
ak
ak
ak
ak
ak
ak
ak
aa
ah
ab
ah
"}
(35,1,1) = {"
ak
aa
ah
aX
aX
aX
ah
ah
ak
ak
ak
ak
ak
aa
ah
aX
aX
ah
ah
ak
ak
ak
ak
ak
ak
ak
aM
aM
aM
aM
aM
aM
aM
aM
aM
aM
aM
ak
ak
ah
ah
ah
"}
(36,1,1) = {"
ak
ak
ak
aX
aX
au
aX
aX
aX
ak
ak
ak
au
aX
aX
aX
aX
aX
aX
ak
ak
ak
ak
ak
ak
ak
aM
ak
ak
ak
ak
ak
ak
ak
ak
ak
aM
ak
ak
ak
ab
aX
"}
(37,1,1) = {"
ak
ak
ak
aX
aX
au
aX
aX
aX
au
aX
aX
aX
aX
aX
aX
aX
aX
ak
ak
ak
ak
ak
ak
ak
ak
aM
ak
rp
aX
aX
aX
ak
ak
ak
ak
aM
ak
ak
ak
aX
aX
"}
(38,1,1) = {"
ak
ak
ak
aX
aX
aK
aX
aX
aX
aX
aX
aX
aX
aX
aX
aX
aK
ak
ak
ak
ak
ak
ak
ak
ak
ak
aM
ak
aX
aX
aF
aX
aX
aX
ak
ak
aM
ak
ak
ak
ak
aX
"}
(39,1,1) = {"
ak
ak
ak
ak
aX
aX
aX
aX
aX
aX
aX
aX
aX
aX
aX
ak
ak
ak
ak
ak
ak
ak
ak
ak
ak
ak
aM
ak
aX
aX
aX
aX
aX
aX
aX
ak
aM
ak
ak
ak
ak
ak
"}
(40,1,1) = {"
ak
ak
ak
ak
aX
aX
aX
aX
aX
aX
aX
aX
aX
aX
ak
ak
ak
ak
ak
ak
ak
ak
ak
ak
ak
ak
aM
ak
aX
aX
aX
aX
aX
aX
aX
ak
aM
ak
ak
ak
ak
ak
"}
(41,1,1) = {"
ak
ak
ak
aX
aX
aX
aX
aX
aX
aX
aX
aX
ak
ak
ak
ak
ak
ak
ak
ak
ak
ak
ak
ak
ak
ak
aM
ak
aX
aX
aX
aX
aX
aX
aX
ak
aM
ak
ak
ak
ak
ak
"}
(42,1,1) = {"
ak
ak
ak
aX
aX
aX
aX
aX
aX
aX
aX
aX
ak
ak
ak
ak
ak
ak
ak
ak
aX
ak
ak
ak
aX
aX
aN
aX
aX
aX
aX
aK
aX
aX
aX
ak
aM
ak
ak
ak
ak
ak
"}
(43,1,1) = {"
ak
ak
aX
aX
aX
aX
aX
aX
aX
aX
aX
aX
aX
ak
ak
ak
ak
ak
ak
aX
aX
aX
ak
ak
aX
aX
aN
aN
aN
aN
aN
aN
aN
aN
aN
aM
aM
ak
ak
ak
ak
ak
"}
(44,1,1) = {"
ak
ak
aX
aX
aX
aX
aX
aX
aX
aX
aX
aX
aX
aX
aX
ak
ak
ak
aX
aX
aX
aX
aX
aX
aX
aX
aX
aX
aX
aX
aX
aX
aX
aX
aX
aX
ak
ak
ak
ak
ak
ak
"}
(45,1,1) = {"
ak
ak
aX
aX
aX
aX
aX
aX
aX
aX
aX
aX
aX
aX
aX
aX
aX
aX
aX
aX
aX
aX
aX
aX
aX
aX
aX
aX
aX
aX
aX
aX
aX
aX
aX
aX
aX
ak
ak
ak
ak
ak
"}
(46,1,1) = {"
aX
aX
aX
aX
aX
aX
aX
aX
aX
aX
aX
aX
aX
aX
aX
aX
aX
aX
aX
aX
aX
aX
aX
aX
aX
aX
aX
aX
aX
aX
aX
aX
aX
aX
aX
aX
aX
aX
aX
aX
aX
aX
"}
(47,1,1) = {"
aX
aX
aX
aX
aX
aX
aX
aX
aX
aX
aX
aX
aX
aX
aX
aX
aX
aX
aX
aX
aX
aX
aX
aX
aX
aX
aX
aX
aX
aX
aX
aX
aX
aX
aX
aX
aX
aX
aX
aX
aX
aX
"}
(48,1,1) = {"
aK
aX
aX
aX
aX
aK
aX
aX
aX
aX
aX
aX
aX
aX
aK
aX
aX
aX
aX
aX
aX
aX
aX
aK
aX
aX
aX
aX
aX
aX
aX
aK
aX
aX
aX
aX
aX
aX
aX
aK
aX
aX
"}
(49,1,1) = {"
aX
aX
aX
aX
aX
aX
aX
aX
aX
aX
aX
aX
aX
aX
aX
aX
aX
aX
aX
aX
aX
aX
aX
aX
aX
aX
aX
aX
aX
aX
aX
aX
aX
aX
aX
aX
aX
aX
aX
aX
aX
aX
"}
(50,1,1) = {"
aX
aX
aX
aX
aX
aX
aX
aX
aX
ak
ak
ak
ak
aX
aX
aX
aX
aX
aX
aX
aX
aX
aX
aX
aX
aX
aX
aX
aX
aX
aX
aX
aX
aX
aX
aX
aX
aX
aX
aX
aX
aX
"}
(51,1,1) = {"
aX
aX
aX
aX
aX
aX
aX
aX
aX
ak
ak
ak
ak
ak
aX
aX
aX
aX
aX
aX
aX
aX
aX
aX
aX
aX
aX
aX
aX
aX
ak
ak
ak
aX
aX
aX
aX
aX
aX
aX
aX
aX
"}
(52,1,1) = {"
aX
au
aX
aX
aX
aX
aX
ak
ak
ak
ak
ak
ak
ak
ak
ak
ak
ak
ak
ak
ak
ak
aX
aX
aX
aX
aX
aX
aX
ak
ak
ak
ak
ak
aX
aX
aX
aX
aX
aK
aX
aX
"}
(53,1,1) = {"
aK
aX
aX
aX
ak
ak
ak
ak
ak
ak
ak
ak
ak
ak
ak
ak
ak
ak
ak
ak
ak
ak
ak
au
aX
aX
aX
aX
ak
ak
ak
ak
ak
ak
au
aX
aX
aX
aX
aX
aX
aX
"}
(54,1,1) = {"
aX
aX
aX
aX
ak
ak
ak
ak
ak
ak
ak
ak
ak
ak
ak
ak
ak
ak
ak
ak
ak
ak
ak
ak
aX
aX
aX
aX
aX
ak
ak
ak
ak
ak
ak
ak
aX
aX
aX
aX
aX
aX
"}
(55,1,1) = {"
aX
aX
aX
ak
ak
ak
ak
ak
ak
ak
ak
ak
ak
ak
ak
ak
ak
ak
ak
ak
ak
ak
ak
ak
aX
aX
aX
aX
aX
aX
ak
ak
ak
ak
ak
ak
ak
ak
ak
aX
aX
aX
"}
(56,1,1) = {"
aX
aX
aX
ak
ak
ak
ak
ak
ak
ak
ak
ak
ak
ak
ak
ak
ak
ak
ak
ak
ak
ak
ak
ak
aX
aX
aX
aX
aX
aX
ak
ak
ak
ak
ak
ak
ak
ak
ak
ak
ak
ak
"}
(57,1,1) = {"
aX
aX
aX
ak
ak
ak
ak
ak
ak
ak
ak
ak
ak
ak
ak
ak
ak
ak
ak
ak
ak
ak
ak
ak
aX
aX
aX
aX
aX
aX
ak
ak
ak
ak
ak
ak
ak
ak
ak
ak
ak
ak
"}
(58,1,1) = {"
aX
aX
aX
ak
ak
ak
ak
ak
ak
ak
ak
ak
ak
ak
ak
ak
ak
ak
ak
ak
ak
ak
ak
ak
aX
aX
aX
aX
aX
ak
ak
ak
ak
ak
ak
ak
ak
ak
ak
ak
ak
ak
"}
(59,1,1) = {"
aK
aX
ak
ak
ak
ak
ak
ak
ak
ak
ak
ak
ak
ak
ak
ak
ak
ak
ak
ak
ak
ak
ak
ak
ak
aX
aX
aX
ak
ak
ak
ak
ak
ak
ak
ak
ak
ak
ak
ak
ak
ak
"}
(60,1,1) = {"
ak
ak
ak
ak
ak
ak
ak
ak
ak
ak
ak
ak
ak
ak
ak
ak
ak
ak
ak
ak
ak
ak
ak
ak
ak
ak
ak
ak
ak
ak
ak
ak
ak
ak
ak
ak
ak
ak
ak
ak
ak
ak
"}
(61,1,1) = {"
ak
ak
ak
ak
ak
ak
ak
ak
ak
ak
ak
ak
ak
ak
ak
ak
ak
ak
ak
ak
ak
ak
ak
ak
ak
ak
ak
ak
ak
ak
ak
ak
ak
ak
ak
ak
ak
ak
ak
ak
ak
ak
"}
(62,1,1) = {"
aM
aM
ak
ak
ak
ak
ak
ak
ak
ak
ak
ak
ak
ak
ak
ak
ak
ak
ak
ak
ak
ak
ak
ak
ak
ak
ak
ak
ak
ak
ak
ak
ak
ak
ak
ak
ak
ak
ak
ak
ak
ak
"}
(63,1,1) = {"
ak
aM
aM
ak
ak
ak
ak
ak
ak
ak
ak
ak
ak
ak
ak
ak
ak
ak
ak
ak
ak
ak
ak
ak
ak
ak
ak
ak
ak
ak
ak
ak
ak
ak
ak
ak
ak
ak
ak
ak
ak
ak
"}
(64,1,1) = {"
ak
ak
aM
ak
ak
ak
ak
ak
ak
ak
ak
ak
ak
ak
ak
ak
ak
ak
ak
ak
ak
ak
ak
ak
ak
ak
ak
ak
ak
ak
ak
ak
ak
ak
ak
ak
ak
ak
ak
ak
ak
ak
"}
(65,1,1) = {"
ak
ak
aM
ak
ak
ak
ak
ak
ak
ak
ak
ak
ak
ak
ak
ak
ak
ak
ak
ak
ak
ak
ak
ak
ak
ak
ak
ak
ak
ak
ak
ak
ak
ak
ak
ak
ak
ak
ak
ak
ak
ak
"}
(66,1,1) = {"
aX
ak
am
am
am
am
am
am
am
am
am
am
am
am
am
am
am
am
am
am
am
am
am
am
am
am
am
am
am
am
am
am
am
am
am
am
am
am
am
am
am
am
"}
