//MAP CONVERTED BY dmm2tgm.py THIS HEADER COMMENT PREVENTS RECONVERSION, DO NOT REMOVE
"aq" = (
/obj/machinery/atmospherics/pipe/simple/green/hidden{
	dir = 9
	},
/turf/open/floor/tile/yellow/full,
/area/bigredv3/inside/cargo/store)
"aU" = (
/obj/structure/table,
/obj/item/reagent_containers/food/drinks/cans/thirteenloko,
/obj/item/reagent_containers/food/drinks/cans/cola,
/obj/machinery/light{
	dir = 4
	},
/turf/open/floor/tile/blue/whitebluefull,
/area/bigredv3/inside/cargo/store)
"ci" = (
/obj/effect/decal/cleanable/dirt,
/obj/machinery/atmospherics/pipe/simple/green/hidden{
	dir = 4
	},
/turf/open/floor/tile/blue/whitebluefull,
/area/bigredv3/inside/cargo/store)
"cE" = (
/obj/structure/table,
/obj/item/reagent_containers/spray/cleaner,
/obj/machinery/atmospherics/components/unary/vent_pump{
	dir = 4;
	on = 1
	},
/turf/open/floor/tile/yellow/full,
/area/bigredv3/inside/cargo/store)
"cI" = (
/obj/machinery/door_control{
	dir = 8;
	id = "General Store";
	name = "Storm Shutters"
	},
/turf/open/floor/tile/yellow/full,
/area/bigredv3/inside/cargo/store)
"cY" = (
/obj/structure/bed/chair/office/dark{
	dir = 8
	},
/obj/effect/decal/cleanable/dirt,
/turf/open/floor,
/area/bigredv3/inside/cargo/store)
"dh" = (
/turf/closed/wall,
/area/bigredv3/inside/wall)
"dq" = (
/obj/structure/table,
/obj/item/reagent_containers/food/snacks/chips,
/obj/item/reagent_containers/food/snacks/cookie,
/obj/item/reagent_containers/food/snacks/donkpocket,
/turf/open/floor/tile/blue/whitebluefull,
/area/bigredv3/inside/cargo/store)
"dB" = (
/obj/structure/cable,
/turf/open/floor/plating,
/area/bigredv3/inside/secondary/maintence/cargo)
"dD" = (
/obj/effect/decal/cleanable/dirt,
/obj/structure/cable,
/obj/effect/ai_node,
/turf/open/floor,
/area/bigredv3/inside/cargo/store)
"ex" = (
/obj/effect/decal/cleanable/dirt,
/turf/open/floor/tile/yellow/full,
/area/bigredv3/inside/cargo/store)
"fH" = (
/obj/structure/table,
/obj/item/toy/prize/mauler,
/obj/item/toy/prize/odysseus,
/turf/open/floor/tile/blue/whitebluefull,
/area/bigredv3/inside/cargo/store)
"gJ" = (
/obj/structure/table,
/obj/effect/decal/cleanable/blood,
/turf/open/floor/tile/yellow/full,
/area/bigredv3/inside/cargo/store)
"gL" = (
/obj/effect/decal/cleanable/dirt,
/obj/machinery/atmospherics/pipe/simple/green/hidden{
	dir = 9
	},
/obj/effect/ai_node,
/turf/open/floor/tile/blue/whitebluefull,
/area/bigredv3/inside/cargo/store)
"hf" = (
/obj/structure/table,
/obj/item/toy/gun,
/obj/item/toy/katana,
/turf/open/floor/tile/blue/whitebluefull,
/area/bigredv3/inside/cargo/store)
"hA" = (
/obj/structure/window/framed/colony,
/turf/open/floor/plating,
/area/bigredv3/inside/wall)
"it" = (
/obj/effect/decal/cleanable/dirt,
/obj/machinery/atmospherics/components/unary/vent_pump{
	dir = 1;
	on = 1
	},
/turf/open/floor,
/area/bigredv3/inside/cargo/store)
"iA" = (
/obj/structure/cable,
/obj/effect/ai_node,
/turf/open/floor/plating,
/area/bigredv3/inside/secondary/maintence/cargo)
"jp" = (
/obj/machinery/light/small{
	dir = 4
	},
/turf/open/floor/plating,
/area/bigredv3/inside/secondary/maintence/cargo)
"jB" = (
/obj/machinery/door/airlock/mainship/maint/free_access{
	name = "\improper General Store Storage"
	},
/turf/open/floor/plating,
/area/bigredv3/inside/secondary/maintence/cargo)
"jS" = (
/obj/machinery/atmospherics/pipe/simple/green/hidden,
/obj/machinery/door/airlock/mainship/medical/glass/free_access{
	name = "\improper General Store"
	},
/turf/open/floor/tile/yellow/full,
/area/bigredv3/inside/cargo/store)
"ke" = (
/obj/machinery/door/poddoor/shutters/mainship{
	id = "General Store";
	name = "\improper General Store Shutters"
	},
/obj/structure/window/framed/colony/reinforced,
/turf/open/floor/plating,
/area/bigredv3/inside/wall)
"kl" = (
/obj/effect/decal/cleanable/dirt,
/obj/machinery/vending/snack,
/turf/open/floor/tile/yellow/full,
/area/bigredv3/inside/cargo/store)
"km" = (
/obj/structure/table,
/obj/item/reagent_containers/food/drinks/coffee,
/turf/open/floor/tile/blue/whitebluefull,
/area/bigredv3/inside/cargo/store)
"kn" = (
/obj/structure/table,
/obj/item/healthanalyzer,
/turf/open/floor/tile/yellow/full,
/area/bigredv3/inside/cargo/store)
"kt" = (
/obj/effect/ai_node,
/turf/open/floor/tile/yellow/full,
/area/bigredv3/inside/cargo/store)
"kM" = (
/obj/structure/table,
/obj/item/tool/surgery/surgicaldrill,
/turf/open/floor/tile/yellow/full,
/area/bigredv3/inside/cargo/store)
"lm" = (
/obj/effect/decal/cleanable/dirt,
/obj/machinery/computer/arcade,
/turf/open/floor/tile/yellow/full,
/area/bigredv3/inside/cargo/store)
"lL" = (
/obj/structure/table,
/obj/effect/spawner/random/food_or_drink/kitchenknife,
/turf/open/floor/tile/yellow/full,
/area/bigredv3/inside/cargo/store)
"mk" = (
/obj/effect/decal/cleanable/dirt,
/turf/open/floor,
/area/bigredv3/inside/cargo/store)
"mB" = (
/obj/structure/table,
/obj/item/reagent_containers/food/drinks/flask/vacuumflask,
/turf/open/floor/tile/blue/whitebluefull,
/area/bigredv3/inside/cargo/store)
"mN" = (
/obj/structure/window/framed/colony,
/obj/machinery/door/poddoor/shutters/mainship{
	dir = 2;
	id = "General Store";
	name = "\improper General Store Shutters"
	},
/turf/open/floor/plating,
/area/bigredv3/inside/wall)
"nU" = (
/obj/structure/table,
/obj/item/toy/dice,
/turf/open/floor/tile/yellow/full,
/area/bigredv3/inside/cargo/store)
"nX" = (
/obj/structure/table,
/obj/item/tool/lighter/random,
/obj/item/tool/lighter/random,
/obj/item/storage/toolbox/mechanical,
/turf/open/floor/tile/yellow/full,
/area/bigredv3/inside/cargo/store)
"oM" = (
/obj/structure/table,
/obj/effect/spawner/random/food_or_drink/packagedbar/candyweighted,
/obj/effect/spawner/random/food_or_drink/burger/bunweighted,
/turf/open/floor/tile/blue/whitebluefull,
/area/bigredv3/inside/cargo/store)
"oY" = (
/obj/item/weapon/gun/pistol/holdout,
/obj/effect/ai_node,
/turf/open/floor/tile/blue/whitebluefull,
/area/bigredv3/inside/cargo/store)
"pH" = (
/obj/structure/table,
/obj/effect/spawner/random/food_or_drink/cheesewedge,
/obj/item/reagent_containers/food/snacks/chips,
/obj/item/reagent_containers/food/snacks/cookie,
/turf/open/floor/tile/blue/whitebluefull,
/area/bigredv3/inside/cargo/store)
"qO" = (
/obj/structure/table,
/obj/effect/spawner/random/food_or_drink/packagedbar/candyweighted,
/obj/effect/spawner/random/food_or_drink/packagedbar/candyweighted,
/obj/effect/spawner/random/food_or_drink/packagedbar/candyweighted,
/obj/item/reagent_containers/food/snacks/chips,
/turf/open/floor/tile/blue/whitebluefull,
/area/bigredv3/inside/cargo/store)
"qV" = (
/obj/structure/table,
/obj/machinery/light,
/obj/item/toy/prize/ripley,
/obj/item/toy/prize/odysseus,
/turf/open/floor/tile/blue/whitebluefull,
/area/bigredv3/inside/cargo/store)
"qW" = (
/obj/structure/table,
/obj/machinery/light{
	dir = 8
	},
/turf/open/floor/tile/blue/whitebluefull,
/area/bigredv3/inside/cargo/store)
"rl" = (
/obj/effect/decal/cleanable/blood/gibs,
/obj/effect/decal/cleanable/blood,
/turf/open/floor/tile/blue/whitebluefull,
/area/bigredv3/inside/cargo/store)
"rm" = (
/obj/structure/table,
/obj/machinery/computer/pod/old{
	name = "Register"
	},
/turf/open/floor/tile/yellow/full,
/area/bigredv3/inside/cargo/store)
"sa" = (
/obj/effect/decal/cleanable/dirt,
/obj/machinery/atmospherics/components/unary/vent_pump{
	dir = 4;
	on = 1
	},
/turf/open/floor,
/area/bigredv3/inside/cargo/store)
"se" = (
/obj/structure/closet/toolcloset,
/turf/open/floor/tile/blue/whitebluefull,
/area/bigredv3/inside/cargo/store)
"sk" = (
/obj/structure/table,
/obj/item/reagent_containers/food/drinks/flask,
/obj/item/reagent_containers/food/drinks/cans/waterbottle,
/obj/effect/spawner/random/food_or_drink/beer,
/turf/open/floor/tile/blue/whitebluefull,
/area/bigredv3/inside/cargo/store)
"sv" = (
/obj/effect/decal/cleanable/dirt,
/obj/effect/decal/cleanable/dirt,
/turf/open/floor/tile/yellow/full,
/area/bigredv3/inside/cargo/store)
"sA" = (
/obj/machinery/atmospherics/pipe/simple/green/hidden{
	dir = 4
	},
/turf/open/floor,
/area/bigredv3/inside/cargo/store)
"tl" = (
/obj/structure/table,
/obj/item/reagent_containers/food/drinks/cans/thirteenloko,
/obj/item/reagent_containers/food/drinks/cans/cola,
/turf/open/floor/tile/blue/whitebluefull,
/area/bigredv3/inside/cargo/store)
"tq" = (
/obj/structure/bed,
/obj/item/toy/plush/farwa,
/turf/open/floor/tile/blue/whitebluefull,
/area/bigredv3/inside/cargo/store)
"tz" = (
/obj/structure/cable,
/obj/machinery/light/small,
/turf/open/floor/plating,
/area/bigredv3/inside/secondary/maintence/cargo)
"uk" = (
/obj/structure/table,
/turf/open/floor/tile/yellow/full,
/area/bigredv3/inside/cargo/store)
"uo" = (
/obj/structure/table,
/obj/item/reagent_containers/food/drinks/cans/waterbottle,
/obj/item/reagent_containers/food/drinks/cans/cola,
/obj/effect/spawner/random/food_or_drink/beer,
/turf/open/floor/tile/blue/whitebluefull,
/area/bigredv3/inside/cargo/store)
"uY" = (
/obj/effect/decal/cleanable/dirt,
/obj/structure/reagent_dispensers/water_cooler,
/turf/open/floor,
/area/bigredv3/inside/cargo/store)
"vs" = (
/obj/structure/table,
/obj/effect/spawner/random/food_or_drink/packagedbar/candyweighted,
/obj/effect/spawner/random/food_or_drink/burger/bunweighted,
/obj/item/reagent_containers/food/snacks/donkpocket,
/obj/machinery/light{
	dir = 8
	},
/turf/open/floor/tile/blue/whitebluefull,
/area/bigredv3/inside/cargo/store)
"wr" = (
/obj/effect/decal/cleanable/dirt,
/turf/open/floor/tile/blue/whitebluefull,
/area/bigredv3/inside/cargo/store)
"wx" = (
/obj/effect/decal/cleanable/dirt,
/obj/effect/ai_node,
/turf/open/floor,
/area/bigredv3/inside/cargo/store)
"wZ" = (
/obj/structure/table,
/obj/effect/spawner/random/food_or_drink/packagedbar/candyweighted,
/obj/effect/spawner/random/food_or_drink/packagedbar/candyweighted,
/obj/effect/spawner/random/food_or_drink/packagedbar/candyweighted,
/obj/effect/spawner/random/food_or_drink/packagedbar/candyweighted,
/obj/effect/spawner/random/food_or_drink/packagedbar/candyweighted,
/obj/item/reagent_containers/food/snacks/donkpocket,
/turf/open/floor/tile/blue/whitebluefull,
/area/bigredv3/inside/cargo/store)
"xd" = (
/obj/structure/table,
/obj/item/reagent_containers/food/drinks/cans/tonic,
/obj/item/reagent_containers/food/drinks/cans/waterbottle,
/obj/item/reagent_containers/food/drinks/cans/aspen,
/turf/open/floor/tile/blue/whitebluefull,
/area/bigredv3/inside/cargo/store)
"ym" = (
/obj/structure/table,
/obj/effect/spawner/random/food_or_drink/burger/bunweighted,
/obj/effect/spawner/random/food_or_drink/burger/bunweighted,
/obj/effect/spawner/random/food_or_drink/cheesewedge,
/turf/open/floor/tile/blue/whitebluefull,
/area/bigredv3/inside/cargo/store)
"yx" = (
/obj/structure/table,
/obj/effect/spawner/random/food_or_drink/packagedbar/candyweighted,
/turf/open/floor/tile/blue/whitebluefull,
/area/bigredv3/inside/cargo/store)
"yU" = (
/obj/machinery/power/apc/weak/ntf,
/obj/structure/cable,
/turf/open/floor/plating,
/area/bigredv3/inside/cargo/store)
"zj" = (
/obj/effect/decal/cleanable/dirt,
/obj/machinery/atmospherics/pipe/simple/green/hidden{
	dir = 4
	},
/turf/open/floor,
/area/bigredv3/inside/cargo/store)
"zl" = (
/obj/structure/rack,
/obj/machinery/light/small,
/turf/open/floor/plating,
/area/bigredv3/inside/secondary/maintence/cargo)
"zq" = (
/obj/machinery/atmospherics/pipe/simple/green/hidden{
	dir = 4
	},
/obj/effect/ai_node,
/turf/open/floor,
/area/bigredv3/inside/cargo/store)
"zL" = (
/obj/effect/decal/cleanable/dirt,
/obj/structure/bed/chair,
/obj/effect/decal/cleanable/blood,
/turf/open/floor,
/area/bigredv3/inside/cargo/store)
"zT" = (
/obj/structure/table,
/obj/item/reagent_containers/food/snacks/chips,
/obj/item/reagent_containers/food/snacks/cookie,
/obj/effect/spawner/random/food_or_drink/donut,
/turf/open/floor/tile/blue/whitebluefull,
/area/bigredv3/inside/cargo/store)
"zX" = (
/obj/machinery/door_control{
	id = "General Store";
	name = "Storm Shutters"
	},
/turf/open/floor/tile/blue/whitebluefull,
/area/bigredv3/inside/cargo/store)
"Ad" = (
/obj/effect/decal/cleanable/blood/gibs,
/obj/item/paper/crumpled/bloody,
/turf/open/floor,
/area/bigredv3/inside/cargo/store)
"BL" = (
/obj/structure/table,
/obj/item/toy/prize/mauler,
/turf/open/floor/tile/blue/whitebluefull,
/area/bigredv3/inside/cargo/store)
"Ef" = (
/obj/structure/cable,
/obj/machinery/atmospherics/pipe/simple/green/hidden,
/turf/open/floor,
/area/bigredv3/inside/cargo/store)
"Ev" = (
/obj/structure/table,
/obj/effect/spawner/random/food_or_drink/burger/bunweighted,
/obj/machinery/light{
	dir = 4
	},
/turf/open/floor/tile/blue/whitebluefull,
/area/bigredv3/inside/cargo/store)
"EG" = (
/obj/machinery/door/airlock/mainship/medical/glass/free_access{
	name = "\improper General Store"
	},
/turf/open/floor,
/area/bigredv3/inside/cargo/store)
"ER" = (
/obj/machinery/light{
	dir = 4
	},
/turf/open/floor/tile/yellow/full,
/area/bigredv3/inside/cargo/store)
"EW" = (
/obj/structure/table,
/turf/open/floor/tile/blue/whitebluefull,
/area/bigredv3/inside/cargo/store)
"Fg" = (
/obj/effect/decal/cleanable/dirt,
/obj/structure/bed/roller,
/turf/open/floor,
/area/bigredv3/inside/cargo/store)
"Fk" = (
/obj/machinery/atmospherics/pipe/simple/green/hidden,
/obj/effect/decal/cleanable/dirt,
/turf/open/floor,
/area/bigredv3/inside/cargo/store)
"Fz" = (
/obj/structure/table,
/obj/item/reagent_containers/food/snacks/chips,
/obj/effect/spawner/random/food_or_drink/donut,
/turf/open/floor/tile/blue/whitebluefull,
/area/bigredv3/inside/cargo/store)
"FW" = (
/obj/structure/table,
/obj/item/toy/plush/carp,
/turf/open/floor/tile/blue/whitebluefull,
/area/bigredv3/inside/cargo/store)
"GR" = (
/obj/structure/rack,
/turf/open/floor/plating,
/area/bigredv3/inside/secondary/maintence/cargo)
"GU" = (
/obj/structure/table,
/obj/item/toy/prize/ripley,
/obj/item/toy/prize/odysseus,
/turf/open/floor/tile/blue/whitebluefull,
/area/bigredv3/inside/cargo/store)
"HC" = (
/obj/machinery/atmospherics/pipe/simple/green/hidden{
	dir = 10
	},
/obj/effect/ai_node,
/turf/open/floor,
/area/bigredv3/inside/cargo/store)
"Ie" = (
/obj/structure/table,
/obj/item/storage/briefcase,
/turf/open/floor/tile/blue/whitebluefull,
/area/bigredv3/inside/cargo/store)
"IG" = (
/obj/machinery/door/airlock/mainship/medical/glass/free_access{
	dir = 1;
	name = "\improper General Store"
	},
/turf/open/floor,
/area/bigredv3/inside/cargo/store)
"IO" = (
/obj/effect/decal/cleanable/dirt,
/obj/machinery/atmospherics/pipe/simple/green/hidden,
/turf/open/floor,
/area/bigredv3/inside/cargo/store)
"IV" = (
/obj/effect/landmark/start/job/survivor,
/obj/effect/landmark/start/latejoinsurvivor,
/turf/open/floor,
/area/bigredv3/inside/cargo/store)
"Jm" = (
/turf/open/floor,
/area/bigredv3/inside/cargo/store)
"JV" = (
/obj/structure/table,
/obj/item/tool/multitool,
/turf/open/floor/tile/yellow/full,
/area/bigredv3/inside/cargo/store)
"JZ" = (
/turf/open/floor/plating,
/area/bigredv3/inside/secondary/maintence/cargo)
"Kg" = (
/obj/machinery/light/small{
	dir = 1
	},
/turf/open/floor/plating,
/area/bigredv3/inside/secondary/maintence/cargo)
"KK" = (
/obj/machinery/atmospherics/pipe/simple/green/hidden{
	dir = 6
	},
/obj/structure/cable,
/obj/effect/ai_node,
/turf/open/floor/tile/blue/whitebluefull,
/area/bigredv3/inside/cargo/store)
"KO" = (
/obj/structure/table,
/obj/item/storage/box/snappops,
/turf/open/floor/tile/blue/whitebluefull,
/area/bigredv3/inside/cargo/store)
"Lc" = (
/obj/structure/cable,
/obj/machinery/door/airlock/mainship/medical/glass/free_access{
	name = "\improper General Store"
	},
/turf/open/floor/tile/bar,
/area/bigredv3/inside/cargo/store)
"Lt" = (
/obj/structure/table,
/obj/item/storage/briefcase,
/obj/machinery/light{
	dir = 4
	},
/turf/open/floor/tile/blue/whitebluefull,
/area/bigredv3/inside/cargo/store)
"LI" = (
/obj/structure/table,
/obj/item/reagent_containers/food/drinks/flask/vacuumflask,
/obj/item/reagent_containers/food/drinks/cans/aspen,
/turf/open/floor/tile/blue/whitebluefull,
/area/bigredv3/inside/cargo/store)
"Mz" = (
/obj/structure/bed,
/turf/open/floor/tile/blue/whitebluefull,
/area/bigredv3/inside/cargo/store)
"MK" = (
/obj/effect/spawner/random/engineering/structure/tank/waterweighted,
/turf/open/floor,
/area/bigredv3/inside/cargo/store)
"Ng" = (
/obj/effect/decal/cleanable/dirt,
/obj/machinery/atmospherics/pipe/manifold/green/hidden{
	dir = 1
	},
/obj/effect/ai_node,
/turf/open/floor,
/area/bigredv3/inside/cargo/store)
"Ns" = (
/obj/structure/table,
/obj/effect/spawner/random/food_or_drink/burger/bunweighted,
/obj/effect/spawner/random/food_or_drink/burger/bunweighted,
/obj/effect/spawner/random/food_or_drink/cheesewedge,
/obj/effect/spawner/random/food_or_drink/donut,
/turf/open/floor/tile/blue/whitebluefull,
/area/bigredv3/inside/cargo/store)
"NI" = (
/obj/structure/table,
/obj/item/reagent_containers/food/drinks/flask/vacuumflask,
/obj/item/reagent_containers/food/drinks/flask,
/obj/machinery/light{
	dir = 8
	},
/turf/open/floor/tile/blue/whitebluefull,
/area/bigredv3/inside/cargo/store)
"Oj" = (
/obj/structure/table,
/obj/item/toy/beach_ball,
/turf/open/floor/tile/blue/whitebluefull,
/area/bigredv3/inside/cargo/store)
"Oq" = (
/turf/open/floor/tile/blue/whitebluefull,
/area/bigredv3/inside/cargo/store)
"Ox" = (
/obj/machinery/atmospherics/pipe/manifold/green/hidden{
	dir = 8
	},
/turf/open/floor,
/area/bigredv3/inside/cargo/store)
"OC" = (
/obj/effect/decal/cleanable/blood,
/turf/open/floor,
/area/bigredv3/inside/cargo/store)
"OR" = (
/obj/structure/table,
/obj/item/reagent_containers/food/drinks/cans/waterbottle,
/obj/item/reagent_containers/food/drinks/cans/cola,
/turf/open/floor/tile/blue/whitebluefull,
/area/bigredv3/inside/cargo/store)
"Pe" = (
/turf/open/floor/tile/yellow/full,
/area/bigredv3/inside/cargo/store)
"PR" = (
/obj/structure/table,
/obj/item/reagent_containers/food/drinks/flask/vacuumflask,
/obj/item/reagent_containers/food/drinks/flask,
/turf/open/floor/tile/blue/whitebluefull,
/area/bigredv3/inside/cargo/store)
"Qa" = (
/obj/structure/table,
/obj/item/storage/box/snappops,
/obj/item/storage/box/snappops,
/turf/open/floor/tile/blue/whitebluefull,
/area/bigredv3/inside/cargo/store)
"QJ" = (
/obj/effect/decal/cleanable/dirt,
/obj/machinery/vending/cola,
/turf/open/floor/tile/yellow/full,
/area/bigredv3/inside/cargo/store)
"QV" = (
/obj/machinery/atmospherics/pipe/simple/green/hidden,
/turf/open/floor,
/area/bigredv3/inside/cargo/store)
"QZ" = (
/obj/effect/decal/cleanable/blood,
/obj/effect/decal/cleanable/dirt,
/turf/open/floor/tile/yellow/full,
/area/bigredv3/inside/cargo/store)
"Re" = (
/obj/effect/decal/cleanable/dirt,
/obj/machinery/door/airlock/mainship/maint/free_access{
	name = "\improper General Store Storage"
	},
/turf/open/floor/plating,
/area/bigredv3/inside/secondary/maintence/cargo)
"Rs" = (
/obj/effect/ai_node,
/turf/open/floor,
/area/bigredv3/inside/cargo/store)
"RJ" = (
/obj/structure/table,
/obj/item/flashlight,
/turf/open/floor/tile/blue/whitebluefull,
/area/bigredv3/inside/cargo/store)
"Sb" = (
/obj/structure/table,
/obj/item/reagent_containers/food/drinks/cans/waterbottle,
/obj/item/reagent_containers/food/drinks/cans/aspen,
/turf/open/floor/tile/blue/whitebluefull,
/area/bigredv3/inside/cargo/store)
"Sd" = (
/obj/machinery/door/airlock/mainship/medical/glass/free_access{
	name = "\improper General Store"
	},
/turf/open/floor/tile/bar,
/area/bigredv3/inside/cargo/store)
"Sx" = (
/obj/structure/cable,
/obj/machinery/atmospherics/pipe/simple/green/hidden,
/obj/effect/decal/cleanable/dirt,
/turf/open/floor,
/area/bigredv3/inside/cargo/store)
"Ti" = (
/obj/structure/table,
/obj/effect/decal/cleanable/blood,
/obj/item/alien_embryo,
/obj/machinery/door_control{
	id = "General Store";
	name = "Storm Shutters"
	},
/turf/open/floor/tile/yellow/full,
/area/bigredv3/inside/cargo/store)
"Ty" = (
/obj/structure/cable,
/turf/open/floor/tile/blue/whitebluefull,
/area/bigredv3/inside/cargo/store)
"TL" = (
/obj/machinery/light,
/obj/effect/decal/cleanable/dirt,
/turf/open/floor/tile/blue/whitebluefull,
/area/bigredv3/inside/cargo/store)
"TU" = (
/obj/structure/table,
/obj/effect/spawner/random/food_or_drink/cheesewedge,
/obj/item/reagent_containers/food/snacks/chips,
/obj/item/reagent_containers/food/snacks/donkpocket,
/obj/effect/spawner/random/food_or_drink/donut,
/turf/open/floor/tile/blue/whitebluefull,
/area/bigredv3/inside/cargo/store)
"Ub" = (
/obj/structure/table,
/obj/item/toy/prize/ripley,
/obj/item/toy/prize/mauler,
/turf/open/floor/tile/blue/whitebluefull,
/area/bigredv3/inside/cargo/store)
"UB" = (
/obj/machinery/atmospherics/pipe/simple/green/hidden{
	dir = 4
	},
/turf/open/floor/tile/yellow/full,
/area/bigredv3/inside/cargo/store)
"VF" = (
/obj/item/flashlight,
/turf/open/floor/tile/yellow/full,
/area/bigredv3/inside/cargo/store)
"VZ" = (
/obj/structure/table,
/obj/item/reagent_containers/food/drinks/flask,
/turf/open/floor/tile/blue/whitebluefull,
/area/bigredv3/inside/cargo/store)
"Wc" = (
/obj/machinery/air_alarm{
	dir = 1
	},
/turf/open/floor/tile/blue/whitebluefull,
/area/bigredv3/inside/cargo/store)
"Wg" = (
/obj/effect/ai_node,
/turf/open/floor/plating,
/area/bigredv3/inside/secondary/maintence/cargo)
"Wo" = (
/obj/effect/decal/cleanable/dirt,
/obj/machinery/atmospherics/pipe/simple/green/hidden{
	dir = 4
	},
/turf/open/floor/tile/yellow/full,
/area/bigredv3/inside/cargo/store)
"Wp" = (
/obj/effect/decal/cleanable/dirt,
/obj/machinery/atmospherics/pipe/simple/green/hidden{
	dir = 10
	},
/turf/open/floor/tile/yellow/full,
/area/bigredv3/inside/cargo/store)
"WG" = (
/obj/machinery/atmospherics/pipe/simple/green/hidden{
	dir = 4
	},
/obj/effect/decal/cleanable/dirt,
/turf/open/floor,
/area/bigredv3/inside/cargo/store)
"WI" = (
/obj/structure/table,
/obj/machinery/computer/pod/old{
	name = "Register"
	},
/obj/machinery/light{
	dir = 1
	},
/turf/open/floor/tile/yellow/full,
/area/bigredv3/inside/cargo/store)
"Xh" = (
/obj/machinery/computer/arcade,
/turf/open/floor/tile/yellow/full,
/area/bigredv3/inside/cargo/store)
"ZW" = (
/obj/structure/cable,
/obj/machinery/atmospherics/pipe/simple/green/hidden,
/obj/machinery/door/airlock/mainship/maint/free_access{
	dir = 1;
	name = "\improper General Store Maintenance"
	},
/turf/open/floor,
/area/bigredv3/inside/secondary/maintence/cargo)

(1,1,1) = {"
dh
dh
dh
dh
dh
dh
dh
dh
ke
Sd
Lc
ke
dh
dh
"}
(2,1,1) = {"
mN
Oq
Oq
wr
Oq
Oq
wr
wr
Oq
Oq
Ty
GU
fH
dh
"}
(3,1,1) = {"
mN
Oq
Rs
mk
mk
Jm
mk
mk
Jm
mk
dD
Jm
qV
dh
"}
(4,1,1) = {"
mN
Oq
sa
Fz
dq
pH
TU
Ev
Ns
Jm
Ty
mk
BL
dh
"}
(5,1,1) = {"
mN
Oq
WG
zT
dh
dh
dh
dh
ym
Jm
Ty
mk
Ub
dh
"}
(6,1,1) = {"
dh
Oq
sA
yx
yx
wZ
qO
vs
oM
Jm
KK
Ef
Sx
ZW
"}
(7,1,1) = {"
dh
Oq
WG
Jm
Jm
Jm
mk
mk
zL
Ad
sA
Jm
FW
dh
"}
(8,1,1) = {"
dh
Oq
Ng
IO
IO
QV
IO
IO
QV
IO
gL
Oj
hf
dh
"}
(9,1,1) = {"
dh
Oq
sA
OR
aU
tl
xd
Sb
km
Jm
Oq
dh
dh
dh
"}
(10,1,1) = {"
dh
Oq
sA
uo
dh
dh
dh
dh
km
Jm
Oq
dh
JZ
dB
"}
(11,1,1) = {"
mN
Oq
sA
sk
NI
VZ
PR
mB
LI
Jm
Oq
dh
JZ
iA
"}
(12,1,1) = {"
mN
Oq
sA
Jm
Jm
Jm
Jm
Jm
Jm
OC
Oq
dh
Wg
dB
"}
(13,1,1) = {"
hA
Oq
sA
Jm
Jm
Jm
Jm
MK
Jm
Jm
Wc
dh
JZ
dB
"}
(14,1,1) = {"
hA
Oq
zq
Ie
EW
Ie
EW
Lt
RJ
Jm
Oq
dh
JZ
tz
"}
(15,1,1) = {"
mN
Oq
sA
EW
dh
dh
dh
dh
Ie
Jm
wr
dh
JZ
dB
"}
(16,1,1) = {"
mN
Oq
sA
KO
EW
KO
KO
qW
Qa
Jm
TL
dh
JZ
dB
"}
(17,1,1) = {"
mN
Oq
sA
mk
IV
Jm
Jm
Jm
mk
mk
tq
dh
JZ
dB
"}
(18,1,1) = {"
dh
zX
HC
Fk
QV
Ox
it
mk
Jm
Jm
oY
dh
JZ
dB
"}
(19,1,1) = {"
mN
Oq
mk
mk
mk
zj
Jm
mk
Fg
Rs
se
dh
Kg
dB
"}
(20,1,1) = {"
mN
Jm
Jm
Oq
rl
ci
Oq
Oq
wr
Oq
Mz
dh
JZ
dB
"}
(21,1,1) = {"
dh
EG
EG
dh
Ti
sA
kM
Jm
nU
mk
dh
dh
JZ
dB
"}
(22,1,1) = {"
IG
Jm
OC
hA
gJ
sA
kn
Jm
uk
mk
dh
yU
dB
dB
"}
(23,1,1) = {"
IG
Jm
Rs
hA
nX
sA
JV
Jm
lL
mk
dh
JZ
Wg
JZ
"}
(24,1,1) = {"
dh
EG
EG
dh
WI
sA
rm
Jm
rm
Jm
dh
JZ
JZ
JZ
"}
(25,1,1) = {"
mN
Jm
mk
Pe
Pe
UB
Pe
Pe
Pe
ex
dh
jp
JZ
JZ
"}
(26,1,1) = {"
dh
QZ
Rs
mk
mk
sA
Jm
Jm
wx
sv
dh
dh
jB
dh
"}
(27,1,1) = {"
mN
Xh
Jm
mk
uY
Wo
Pe
Pe
Pe
kt
dh
GR
JZ
GR
"}
(28,1,1) = {"
mN
lm
mk
Jm
Jm
UB
dh
hA
hA
hA
dh
GR
JZ
GR
"}
(29,1,1) = {"
mN
Pe
Jm
Jm
Jm
UB
hA
cE
cY
Pe
dh
GR
JZ
zl
"}
(30,1,1) = {"
mN
kl
QJ
ER
VF
Wp
jS
aq
cI
sv
dh
GR
JZ
GR
"}
(31,1,1) = {"
dh
dh
dh
dh
dh
dh
dh
dh
dh
dh
dh
dh
Re
dh
"}
