//MAP CONVERTED BY dmm2tgm.py THIS HEADER COMMENT PREVENTS RECONVERSION, DO NOT REMOVE
"a" = (
/obj/effect/ai_node,
/turf/open/floor/plating/ground/mars/random/cave,
/area/bigredv2/caves/northeast/garbledradio)
"f" = (
/obj/effect/landmark/lv624/fog_blocker,
/turf/open/floor/plating/ground/mars/random/cave,
/area/bigredv2/caves/northeast)
"g" = (
/turf/open/floor/plating,
/area/bigredv2/caves/lambda_lab)
"i" = (
/obj/effect/ai_node,
/turf/open/floor/plating/ground/mars/random/cave,
/area/bigredv2/caves/northeast)
"o" = (
/obj/effect/landmark/lv624/fog_blocker,
/turf/closed/mineral/smooth/bigred,
/area/bigredv2/caves/rock)
"p" = (
/obj/machinery/miner/damaged/platinum,
/turf/open/floor/plating/ground/mars/random/cave,
/area/bigredv2/caves/northeast)
"q" = (
/turf/closed/mineral/smooth/bigred,
/area/bigredv2/caves/rock)
"r" = (
/turf/open/floor/plating/ground/mars/random/cave,
/area/bigredv2/caves/northeast)
"s" = (
/obj/structure/fence/standard/xenoproof,
/turf/open/floor/plating/ground/mars/random/cave,
/area/bigredv2/caves/northeast)
"v" = (
/turf/closed/mineral/smooth/bigred/indestructible,
/area/space)
"y" = (
/turf/open/floor/plating/ground/mars/random/cave/rock,
/area/bigredv2/caves/northeast/garbledradio)
"A" = (
/obj/machinery/chem_dispenser,
/turf/open/floor/tile/whiteyellow{
	dir = 1
	},
/area/bigredv2/caves/lambda_lab)
"E" = (
/turf/open/floor/plating/ground/mars/random/cave/rock,
/area/bigredv2/caves/northeast)
"I" = (
/turf/closed/wall/r_wall,
/area/bigredv2/caves/rock)
"L" = (
/obj/structure/closet/crate/internals,
/turf/open/floor/plating,
/area/bigredv2/caves/lambda_lab)
"M" = (
/turf/closed/wall/r_wall,
/area/bigredv2/caves/lambda_lab)
"N" = (
/obj/structure/closet/crate/freezer/rations,
/turf/open/floor/plating,
/area/bigredv2/caves/lambda_lab)
"Q" = (
/obj/machinery/chem_master,
/turf/open/floor/tile/whiteyellow{
	dir = 5
	},
/area/bigredv2/caves/lambda_lab)
"R" = (
/obj/effect/ai_node,
/obj/effect/landmark/excavation_site_spawner,
/turf/open/floor/plating/ground/mars/random/cave,
/area/bigredv2/caves/northeast)
"S" = (
/obj/machinery/chem_dispenser,
/turf/open/floor/tile/whiteyellow{
	dir = 9
	},
/area/bigredv2/caves/lambda_lab)
"Y" = (
/turf/open/floor/plating/ground/mars/random/cave,
/area/bigredv2/caves/northeast/garbledradio)

(1,1,1) = {"
v
v
v
v
v
v
v
v
v
v
v
v
v
v
v
v
v
v
v
v
q
q
q
q
q
Y
Y
Y
Y
y
q
q
"}
(2,1,1) = {"
v
v
v
v
v
v
v
v
v
v
q
q
q
q
q
q
q
q
q
q
q
q
q
y
y
Y
Y
Y
Y
y
q
q
"}
(3,1,1) = {"
v
v
v
v
v
v
v
v
v
v
q
q
q
q
q
q
q
q
q
q
q
q
Y
Y
Y
Y
Y
Y
Y
y
q
q
"}
(4,1,1) = {"
v
v
v
v
v
v
v
v
v
v
q
q
q
q
q
q
q
q
q
q
q
Y
Y
Y
Y
Y
Y
Y
Y
Y
y
q
"}
(5,1,1) = {"
v
v
v
v
v
v
v
v
v
v
q
q
q
q
q
q
q
q
q
q
Y
Y
a
Y
a
Y
Y
Y
Y
a
y
q
"}
(6,1,1) = {"
v
v
v
v
v
v
v
v
v
v
q
q
q
q
q
q
q
a
Y
Y
Y
a
Y
y
Y
Y
Y
Y
Y
Y
y
q
"}
(7,1,1) = {"
v
v
v
v
v
v
v
v
v
v
q
q
q
q
q
q
Y
Y
Y
Y
Y
Y
Y
q
q
y
Y
Y
Y
Y
y
q
"}
(8,1,1) = {"
v
v
v
v
v
v
v
v
v
v
q
q
q
q
q
q
Y
Y
Y
q
Y
Y
q
q
q
q
Y
Y
Y
Y
Y
y
"}
(9,1,1) = {"
v
v
v
v
v
v
v
v
v
v
q
q
q
q
q
q
Y
a
Y
q
q
q
q
q
q
q
y
Y
Y
Y
Y
Y
"}
(10,1,1) = {"
v
v
v
v
v
v
v
v
v
v
q
q
q
q
q
Y
a
Y
Y
q
q
q
q
q
q
q
q
y
Y
a
Y
Y
"}
(11,1,1) = {"
v
v
v
v
v
v
v
v
v
v
q
q
q
q
Y
Y
Y
Y
Y
q
q
q
q
q
q
q
q
q
q
Y
a
Y
"}
(12,1,1) = {"
v
v
v
v
v
v
v
v
v
v
q
q
q
q
Y
Y
Y
Y
Y
q
q
q
q
q
q
q
q
q
q
y
Y
a
"}
(13,1,1) = {"
v
v
v
v
v
v
v
v
v
v
q
q
q
Y
Y
Y
Y
Y
q
q
q
q
q
q
q
q
q
q
q
q
q
q
"}
(14,1,1) = {"
v
v
v
v
v
v
v
v
v
v
q
q
a
Y
Y
Y
a
q
q
q
q
q
q
q
q
q
q
q
q
q
q
q
"}
(15,1,1) = {"
v
v
v
v
v
v
v
v
v
v
q
q
Y
Y
Y
q
q
q
q
q
q
q
q
q
q
q
q
q
q
I
I
I
"}
(16,1,1) = {"
v
v
v
v
v
v
v
v
v
v
q
q
Y
Y
Y
q
q
q
q
q
q
q
q
q
q
q
q
q
q
Y
Y
Y
"}
(17,1,1) = {"
v
v
v
v
v
v
v
v
v
v
q
Y
Y
Y
q
q
q
q
q
q
q
q
q
q
q
q
q
q
q
Y
Y
Y
"}
(18,1,1) = {"
v
v
v
v
v
v
v
v
v
v
q
Y
a
r
q
q
q
q
q
q
q
q
q
q
q
q
q
q
q
Y
Y
a
"}
(19,1,1) = {"
v
v
v
v
v
v
v
v
v
v
q
i
r
r
r
q
q
q
q
q
q
q
q
q
q
q
q
q
q
Y
Y
Y
"}
(20,1,1) = {"
v
v
v
v
v
v
v
v
v
v
q
q
r
r
r
r
r
q
q
q
q
q
q
q
q
q
q
q
q
Y
Y
Y
"}
(21,1,1) = {"
v
v
v
v
v
v
v
v
v
v
q
q
r
r
r
r
r
r
r
q
q
q
q
q
q
q
q
q
q
q
Y
Y
"}
(22,1,1) = {"
v
v
v
v
v
v
v
v
v
v
q
q
i
r
r
r
i
r
r
q
q
q
q
q
q
q
q
q
q
q
Y
Y
"}
(23,1,1) = {"
v
v
v
v
v
v
v
v
v
v
q
q
q
r
r
r
r
r
r
q
q
q
q
q
q
q
q
q
q
q
Y
a
"}
(24,1,1) = {"
v
v
v
v
v
v
v
v
v
v
q
q
q
q
r
r
r
r
r
r
q
q
q
q
q
q
q
q
q
q
Y
Y
"}
(25,1,1) = {"
v
v
v
v
v
v
v
v
v
v
q
q
q
q
r
r
r
q
r
r
q
q
q
q
q
q
q
q
q
q
q
Y
"}
(26,1,1) = {"
v
v
v
v
v
v
v
v
v
v
q
q
q
q
r
r
r
q
r
r
r
q
q
q
q
r
q
q
q
q
q
q
"}
(27,1,1) = {"
v
v
v
v
v
v
v
v
v
v
q
q
q
q
q
r
r
r
r
r
r
r
r
r
r
r
r
q
q
q
q
q
"}
(28,1,1) = {"
v
v
v
v
v
v
v
v
v
v
q
q
q
q
q
r
i
r
r
r
r
r
i
r
r
r
i
q
q
q
q
o
"}
(29,1,1) = {"
v
v
v
v
v
v
v
v
v
v
q
q
q
q
q
q
r
r
r
r
r
r
r
r
r
r
r
q
q
q
o
q
"}
(30,1,1) = {"
v
v
v
v
v
v
v
v
v
v
q
q
q
q
q
q
q
q
q
r
r
r
r
r
r
r
r
q
q
o
q
q
"}
(31,1,1) = {"
v
v
v
v
v
v
v
v
v
v
q
q
q
q
q
q
q
q
q
q
q
q
q
r
r
r
r
q
q
o
q
M
"}
(32,1,1) = {"
v
v
v
v
v
v
v
v
v
v
q
q
q
q
q
q
q
q
q
q
q
q
q
r
r
r
r
q
q
o
q
M
"}
(33,1,1) = {"
v
v
v
v
v
v
v
v
v
v
q
q
q
q
q
q
q
q
q
q
q
q
q
i
r
r
i
q
q
o
q
M
"}
(34,1,1) = {"
v
v
v
v
v
v
v
v
v
v
q
q
q
q
q
q
q
q
q
q
q
q
q
r
r
r
r
q
q
o
q
M
"}
(35,1,1) = {"
v
v
v
v
v
v
v
v
v
v
q
q
q
q
q
q
q
q
q
q
q
q
q
r
r
r
r
q
q
o
q
M
"}
(36,1,1) = {"
v
v
v
v
v
v
v
v
v
v
q
q
q
q
q
q
q
q
q
q
q
q
q
r
r
r
r
r
q
o
q
q
"}
(37,1,1) = {"
v
v
v
v
v
v
v
v
v
v
q
q
q
q
q
q
q
q
q
q
q
q
q
r
r
r
r
r
q
o
q
q
"}
(38,1,1) = {"
v
v
v
v
v
v
v
v
v
v
q
q
q
q
q
q
q
q
q
q
q
q
q
r
r
r
r
r
q
o
q
q
"}
(39,1,1) = {"
v
v
v
v
v
v
v
v
v
v
q
q
q
q
q
q
q
q
q
q
q
q
q
r
r
r
r
r
q
o
M
M
"}
(40,1,1) = {"
v
v
v
v
v
v
v
v
v
v
v
v
v
v
v
v
v
v
v
v
q
q
q
r
r
r
r
r
q
o
M
g
"}
(41,1,1) = {"
v
v
v
v
v
v
v
v
v
v
v
v
v
v
v
v
v
v
v
v
q
q
q
r
r
r
r
r
q
o
M
L
"}
(42,1,1) = {"
v
v
v
v
v
v
v
v
v
v
v
v
v
v
v
v
v
v
v
v
q
q
q
r
r
r
r
r
q
o
M
N
"}
(43,1,1) = {"
v
v
v
v
v
v
v
v
v
v
v
v
v
v
v
v
v
v
v
v
q
q
q
i
r
r
i
r
q
o
M
M
"}
(44,1,1) = {"
v
v
v
v
v
v
v
v
v
v
v
v
v
v
v
v
v
v
v
v
q
q
q
r
r
r
r
r
s
o
M
S
"}
(45,1,1) = {"
v
v
v
v
v
v
v
v
v
v
v
v
v
v
v
v
v
v
v
v
q
q
q
r
r
r
r
r
s
f
M
A
"}
(46,1,1) = {"
v
v
v
v
v
v
v
v
v
v
v
v
v
v
v
v
v
v
v
v
q
q
q
r
r
r
r
r
s
f
M
A
"}
(47,1,1) = {"
v
v
v
v
v
v
v
v
v
v
v
v
v
v
v
v
v
v
v
v
q
q
q
r
r
r
r
r
q
o
M
Q
"}
(48,1,1) = {"
v
v
v
v
v
v
v
v
v
v
v
v
v
v
v
v
v
v
v
v
q
q
q
q
r
r
r
r
q
o
M
M
"}
(49,1,1) = {"
v
v
v
v
v
v
v
v
v
v
v
v
v
v
v
v
v
v
v
v
q
q
q
q
r
r
r
r
q
q
o
M
"}
(50,1,1) = {"
v
v
v
v
v
v
v
v
v
v
v
v
v
v
v
v
v
v
v
v
q
q
q
q
r
r
r
r
r
r
q
o
"}
(51,1,1) = {"
v
v
v
v
v
v
v
v
v
v
v
v
v
v
v
v
v
v
v
v
q
q
q
q
q
r
r
R
r
r
r
E
"}
(52,1,1) = {"
v
v
v
v
v
v
v
v
v
v
v
v
v
v
v
v
v
v
v
v
q
q
q
q
q
r
i
r
r
r
i
r
"}
(53,1,1) = {"
v
v
v
v
v
v
v
v
v
v
v
v
v
v
v
v
v
v
v
v
q
q
q
q
q
q
r
r
r
r
r
r
"}
(54,1,1) = {"
v
v
v
v
v
v
v
v
v
v
v
v
v
v
v
v
v
v
v
v
q
q
q
q
q
q
r
r
r
r
r
r
"}
(55,1,1) = {"
v
v
v
v
v
v
v
v
v
v
v
v
v
v
v
v
v
v
v
v
q
q
q
q
q
q
q
r
p
r
r
r
"}
(56,1,1) = {"
v
v
v
v
v
v
v
v
v
v
v
v
v
v
v
v
v
v
v
v
q
q
q
q
q
q
q
r
r
r
r
r
"}
(57,1,1) = {"
v
v
v
v
v
v
v
v
v
v
v
v
v
v
v
v
v
v
v
v
q
q
q
q
q
q
q
r
r
r
r
r
"}
(58,1,1) = {"
v
v
v
v
v
v
v
v
v
v
v
v
v
v
v
v
v
v
v
v
q
q
q
q
q
q
q
r
r
r
i
r
"}
(59,1,1) = {"
v
v
v
v
v
v
v
v
v
v
v
v
v
v
v
v
v
v
v
v
q
q
q
q
q
q
q
r
r
r
r
r
"}
(60,1,1) = {"
v
v
v
v
v
v
v
v
v
v
v
v
v
v
v
v
v
v
v
v
q
q
q
q
q
q
q
q
r
r
i
r
"}
(61,1,1) = {"
v
v
v
v
v
v
v
v
v
v
v
v
v
v
v
v
v
v
v
v
q
q
q
q
q
q
q
q
q
r
r
r
"}
(62,1,1) = {"
v
v
v
v
v
v
v
v
v
v
v
v
v
v
v
v
v
v
v
v
q
q
q
q
q
q
q
q
q
r
r
r
"}
(63,1,1) = {"
v
v
v
v
v
v
v
v
v
v
v
v
v
v
v
v
v
v
v
v
q
q
q
q
q
q
q
q
q
r
r
r
"}
(64,1,1) = {"
v
v
v
v
v
v
v
v
v
v
v
v
v
v
v
v
v
v
v
v
q
q
q
q
q
q
q
q
q
r
r
r
"}
(65,1,1) = {"
v
v
v
v
v
v
v
v
v
v
v
v
v
v
v
v
v
v
v
v
q
q
q
q
q
q
q
q
q
r
r
r
"}
