//MAP CONVERTED BY dmm2tgm.py THIS HEADER COMMENT PREVENTS RECONVERSION, DO NOT REMOVE
"aw" = (
/obj/machinery/light,
/obj/machinery/atmospherics/pipe/manifold/green/hidden,
/obj/structure/cable,
/turf/open/floor,
/area/bigredv3/inside/colony/dorm)
"aH" = (
/obj/structure/cable,
/turf/open/floor,
/area/bigredv3/inside/colony/dorm)
"aU" = (
/obj/structure/table,
/obj/item/pizzabox/margherita,
/obj/item/pizzabox/meat{
	pixel_x = -5;
	pixel_y = 12
	},
/obj/structure/cable,
/turf/open/floor,
/area/bigredv3/inside/colony/dorm)
"aW" = (
/obj/machinery/door_control{
	dir = 1;
	id = "Dormitories";
	name = "Storm Shutters"
	},
/obj/machinery/atmospherics/pipe/simple/green/hidden{
	dir = 8
	},
/obj/effect/ai_node,
/obj/structure/cable,
/turf/open/floor,
/area/bigredv3/inside/colony/dorm)
"aY" = (
/obj/machinery/light{
	dir = 1
	},
/obj/effect/decal/cleanable/dirt,
/turf/open/floor,
/area/bigredv3/inside/colony/dorm)
"bM" = (
/obj/machinery/atmospherics/pipe/simple/green/hidden,
/obj/structure/cable,
/turf/open/floor,
/area/bigredv3/inside/colony/dorm)
"cC" = (
/obj/effect/decal/cleanable/dirt,
/obj/machinery/atmospherics/pipe/simple/green/hidden,
/obj/item/trash/chunk,
/obj/structure/cable,
/turf/open/floor/grimy,
/area/bigredv3/inside/colony/dorm)
"dI" = (
/obj/machinery/atmospherics/pipe/simple/green/hidden{
	dir = 8
	},
/obj/effect/decal/cleanable/dirt,
/obj/structure/cable,
/turf/open/floor,
/area/bigredv3/inside/colony/dorm)
"ez" = (
/obj/machinery/atmospherics/pipe/simple/green/hidden,
/obj/effect/decal/cleanable/dirt,
/obj/structure/cable,
/turf/open/floor/grimy,
/area/bigredv3/inside/colony/dorm)
"eI" = (
/obj/structure/bed/chair{
	dir = 4
	},
/turf/open/floor,
/area/bigredv3/inside/colony/dorm)
"gf" = (
/obj/machinery/atmospherics/pipe/simple/green/hidden,
/obj/effect/ai_node,
/obj/structure/cable,
/turf/open/floor,
/area/bigredv3/inside/colony/dorm)
"gU" = (
/turf/open/floor,
/area/bigredv3/inside/colony/dorm)
"iV" = (
/obj/machinery/atmospherics/components/unary/vent_pump,
/obj/effect/decal/cleanable/blood/gibs/limb,
/turf/open/floor/grimy,
/area/bigredv3/inside/colony/dorm)
"iW" = (
/obj/structure/bed/chair{
	dir = 1
	},
/turf/open/floor,
/area/bigredv3/inside/colony/dorm)
"jz" = (
/obj/item/reagent_containers/food/drinks/bottle/absinthe,
/turf/open/floor,
/area/bigredv3/inside/colony/dorm)
"mn" = (
/obj/effect/decal/cleanable/dirt,
/obj/machinery/atmospherics/pipe/simple/green/hidden{
	dir = 9
	},
/obj/structure/cable,
/turf/open/floor/grimy,
/area/bigredv3/inside/colony/dorm)
"mI" = (
/obj/structure/bed/chair,
/turf/open/floor,
/area/bigredv3/inside/colony/dorm)
"nc" = (
/obj/item/reagent_containers/food/drinks/bottle/rum,
/turf/open/floor,
/area/bigredv3/inside/colony/dorm)
"nU" = (
/obj/effect/decal/cleanable/dirt,
/obj/structure/reagent_dispensers/beerkeg,
/turf/open/floor,
/area/bigredv3/inside/colony/dorm)
"pl" = (
/obj/machinery/atmospherics/pipe/simple/green/hidden{
	dir = 6
	},
/obj/structure/cable,
/turf/open/floor/grimy,
/area/bigredv3/inside/colony/dorm)
"pF" = (
/obj/structure/table,
/obj/item/ashtray/bronze,
/turf/open/floor,
/area/bigredv3/inside/colony/dorm)
"pH" = (
/obj/effect/ai_node,
/turf/open/floor,
/area/bigredv3/inside/colony/dorm)
"pR" = (
/obj/item/trash/chunk,
/turf/open/floor,
/area/bigredv3/inside/colony/dorm)
"rL" = (
/obj/effect/decal/cleanable/dirt,
/obj/machinery/atmospherics/pipe/simple/green/hidden{
	dir = 8
	},
/obj/structure/cable,
/turf/open/floor,
/area/bigredv3/inside/colony/dorm)
"tW" = (
/obj/item/megaphone,
/turf/open/floor/grimy,
/area/bigredv3/inside/colony/dorm)
"up" = (
/obj/effect/decal/cleanable/dirt,
/turf/open/floor/grimy,
/area/bigredv3/inside/colony/dorm)
"uE" = (
/obj/structure/table,
/obj/item/toy/deck,
/turf/open/floor,
/area/bigredv3/inside/colony/dorm)
"uN" = (
/obj/item/radio/intercom{
	anyai = 1;
	freerange = 1;
	frequency = 1469;
	name = "General Listening Channel"
	},
/turf/open/floor,
/area/bigredv3/inside/colony/dorm)
"vl" = (
/obj/machinery/vending/cola,
/obj/machinery/atmospherics/pipe/simple/green/hidden{
	dir = 8
	},
/obj/structure/cable,
/turf/open/floor,
/area/bigredv3/inside/colony/dorm)
"zx" = (
/obj/item/reagent_containers/food/drinks/bottle/rum,
/obj/machinery/atmospherics/pipe/manifold/green/hidden{
	dir = 8
	},
/obj/structure/cable,
/turf/open/floor/grimy,
/area/bigredv3/inside/colony/dorm)
"AW" = (
/obj/structure/table,
/obj/machinery/atmospherics/components/unary/vent_pump,
/turf/open/floor,
/area/bigredv3/inside/colony/dorm)
"BF" = (
/obj/item/trash/chunk,
/turf/open/floor/grimy,
/area/bigredv3/inside/colony/dorm)
"BU" = (
/obj/machinery/power/apc/weak/ntf{
	name = "Fitness APC"
	},
/obj/structure/cable,
/turf/open/floor,
/area/bigredv3/inside/colony/dorm)
"Ck" = (
/obj/structure/bed/chair{
	dir = 8
	},
/turf/open/floor,
/area/bigredv3/inside/colony/dorm)
"Dh" = (
/obj/machinery/light,
/obj/machinery/atmospherics/pipe/simple/green/hidden{
	dir = 8
	},
/obj/effect/ai_node,
/obj/structure/cable,
/turf/open/floor,
/area/bigredv3/inside/colony/dorm)
"Ep" = (
/obj/structure/table,
/turf/open/floor,
/area/bigredv3/inside/colony/dorm)
"EO" = (
/obj/machinery/light{
	dir = 1
	},
/turf/open/floor,
/area/bigredv3/inside/colony/dorm)
"FL" = (
/obj/machinery/atmospherics/pipe/simple/green/hidden,
/obj/item/trash/chunk{
	pixel_y = 5
	},
/obj/structure/cable,
/turf/open/floor/grimy,
/area/bigredv3/inside/colony/dorm)
"FW" = (
/obj/structure/bed/chair{
	dir = 1
	},
/obj/machinery/atmospherics/pipe/simple/green/hidden,
/turf/open/floor,
/area/bigredv3/inside/colony/dorm)
"Gi" = (
/obj/effect/decal/cleanable/dirt,
/obj/item/trash/chunk{
	pixel_x = -3;
	pixel_y = 4
	},
/obj/item/reagent_containers/food/drinks/bottle/rum,
/turf/open/floor/grimy,
/area/bigredv3/inside/colony/dorm)
"Hb" = (
/obj/machinery/vending/cigarette/colony,
/obj/machinery/atmospherics/pipe/simple/green/hidden{
	dir = 8
	},
/obj/structure/cable,
/turf/open/floor,
/area/bigredv3/inside/colony/dorm)
"Hf" = (
/obj/effect/decal/cleanable/blood/gibs/xeno/up,
/turf/open/floor/grimy,
/area/bigredv3/inside/colony/dorm)
"Ii" = (
/obj/machinery/atmospherics/pipe/simple/green/hidden{
	dir = 5
	},
/obj/structure/cable,
/turf/open/floor,
/area/bigredv3/inside/colony/dorm)
"Ip" = (
/obj/effect/decal/cleanable/dirt,
/turf/open/floor,
/area/bigredv3/inside/colony/dorm)
"IE" = (
/obj/structure/table,
/obj/item/trash/plate,
/obj/item/reagent_containers/food/snacks/pizzapasta/meatpizzaslice,
/turf/open/floor,
/area/bigredv3/inside/colony/dorm)
"Ji" = (
/obj/machinery/atmospherics/pipe/simple/green/hidden{
	dir = 8
	},
/obj/machinery/air_alarm{
	dir = 1;
	pixel_y = -30
	},
/obj/structure/cable,
/turf/open/floor,
/area/bigredv3/inside/colony/dorm)
"Jn" = (
/obj/machinery/atmospherics/pipe/simple/green/hidden{
	dir = 8
	},
/obj/structure/prop/tgbrokenvendor/snackbrokebed,
/obj/structure/cable,
/turf/open/floor,
/area/bigredv3/inside/colony/dorm)
"Jp" = (
/obj/structure/bed/chair,
/obj/structure/cable,
/turf/open/floor,
/area/bigredv3/inside/colony/dorm)
"Kj" = (
/obj/structure/noticeboard{
	dir = 1;
	pixel_y = -27
	},
/obj/machinery/atmospherics/pipe/simple/green/hidden{
	dir = 8
	},
/obj/structure/cable,
/turf/open/floor,
/area/bigredv3/inside/colony/dorm)
"Ni" = (
/obj/item/trash/chunk{
	pixel_x = 3;
	pixel_y = -4
	},
/obj/effect/ai_node,
/turf/open/floor/grimy,
/area/bigredv3/inside/colony/dorm)
"Nk" = (
/obj/machinery/atmospherics/pipe/manifold/green/hidden,
/obj/structure/cable,
/turf/open/floor,
/area/bigredv3/inside/colony/dorm)
"NO" = (
/obj/machinery/atmospherics/pipe/simple/green/hidden,
/obj/effect/decal/cleanable/dirt,
/turf/open/floor/grimy,
/area/bigredv3/inside/colony/dorm)
"Pr" = (
/obj/machinery/atmospherics/pipe/simple/green/hidden,
/turf/open/floor,
/area/bigredv3/inside/colony/dorm)
"TK" = (
/obj/effect/decal/cleanable/dirt,
/obj/effect/decal/cleanable/dirt,
/obj/item/trash/plate,
/turf/open/floor,
/area/bigredv3/inside/colony/dorm)
"TX" = (
/obj/machinery/atmospherics/pipe/simple/green/hidden{
	dir = 8
	},
/obj/structure/cable,
/turf/open/floor,
/area/bigredv3/inside/colony/dorm)
"UP" = (
/obj/structure/bed/chair{
	dir = 1
	},
/obj/structure/cable,
/turf/open/floor,
/area/bigredv3/inside/colony/dorm)
"Xw" = (
/turf/open/floor/grimy,
/area/bigredv3/inside/colony/dorm)
"Yz" = (
/obj/structure/table,
/obj/item/storage/donut_box/empty,
/obj/structure/cable,
/turf/open/floor,
/area/bigredv3/inside/colony/dorm)
"YD" = (
/obj/effect/decal/cleanable/dirt,
/obj/effect/decal/cleanable/dirt,
/obj/machinery/atmospherics/pipe/simple/green/hidden{
	dir = 8
	},
/obj/structure/cable,
/turf/open/floor/grimy,
/area/bigredv3/inside/colony/dorm)
"Zn" = (
/obj/item/reagent_containers/food/drinks/bottle/rum,
/turf/open/floor/grimy,
/area/bigredv3/inside/colony/dorm)
"ZZ" = (
/obj/machinery/vending/boozeomat,
/turf/open/floor/grimy,
/area/bigredv3/inside/colony/dorm)

(1,1,1) = {"
bM
gf
bM
bM
bM
bM
Ii
"}
(2,1,1) = {"
TK
Ip
pH
Ip
pR
Ip
rL
"}
(3,1,1) = {"
aY
jz
gU
pH
gU
pH
dI
"}
(4,1,1) = {"
gU
gU
gU
Ip
gU
Ip
TX
"}
(5,1,1) = {"
gU
gU
gU
gU
gU
gU
Jn
"}
(6,1,1) = {"
gU
pH
eI
eI
gU
gU
Hb
"}
(7,1,1) = {"
gU
mI
uE
Ep
iW
gU
vl
"}
(8,1,1) = {"
gU
mI
pF
AW
FW
Pr
aw
"}
(9,1,1) = {"
gU
mI
Ep
IE
iW
gU
TX
"}
(10,1,1) = {"
gU
mI
Ep
Ep
iW
gU
Kj
"}
(11,1,1) = {"
BU
Jp
Yz
aU
UP
aH
aW
"}
(12,1,1) = {"
gU
pH
Ck
Ck
gU
pH
TX
"}
(13,1,1) = {"
gU
gU
nU
nU
nc
Ip
TX
"}
(14,1,1) = {"
gU
Zn
up
up
up
up
Ji
"}
(15,1,1) = {"
EO
Xw
ZZ
Xw
tW
up
TX
"}
(16,1,1) = {"
gU
BF
iV
NO
zx
ez
Nk
"}
(17,1,1) = {"
gU
Ni
Hf
Gi
YD
up
Dh
"}
(18,1,1) = {"
pH
pl
FL
cC
mn
Xw
TX
"}
(19,1,1) = {"
gU
TX
gU
gU
uN
gU
TX
"}
