//MAP CONVERTED BY dmm2tgm.py THIS HEADER COMMENT PREVENTS RECONVERSION, DO NOT REMOVE
"ab" = (
/obj/structure/cable,
/obj/machinery/atmospherics/pipe/simple/green/hidden,
/obj/effect/decal/cleanable/dirt,
/turf/open/floor/marking/asteroidwarning{
	dir = 1
	},
/area/bigredv2/outside/nw)
"aj" = (
/obj/effect/turf_decal/sandedge,
/turf/open/floor/marking/asteroidwarning{
	dir = 9
	},
/area/bigredv2/outside/nw)
"ap" = (
/turf/open/floor/plating/ground/mars/random/sand,
/area/bigredv2/outside/virology)
"be" = (
/obj/structure/cable,
/obj/machinery/power/apc/high/ntf{
	dir = 4
	},
/turf/open/floor/plating,
/area/bigredv2/outside/nw)
"bl" = (
/turf/open/floor/marking/asteroidwarning{
	dir = 1
	},
/area/bigredv2/outside/virology)
"cf" = (
/obj/effect/decal/cleanable/dirt,
/obj/structure/cable,
/obj/effect/decal/cleanable/dirt,
/turf/open/floor/plating,
/area/bigredv2/outside/nw)
"cM" = (
/turf/open/floor/plating/ground/mars/random/dirt,
/area/bigredv2/outside/virology)
"dn" = (
/turf/open/floor/tile/white,
/area/bigredv2/outside/nw)
"dr" = (
/turf/open/floor/plating/ground/mars/dirttosand/autosmooth{
	dir = 4
	},
/area/bigredv2/caves/northwest)
"dY" = (
/obj/structure/cable,
/obj/effect/decal/cleanable/dirt,
/turf/open/floor/plating,
/area/bigredv2/outside/nw)
"fw" = (
/obj/effect/decal/cleanable/dirt,
/turf/open/floor/marking/asteroidwarning{
	dir = 8
	},
/area/bigredv2/outside/nw)
"fA" = (
/obj/effect/spawner/random/engineering/structure/tank/fuelweighted,
/turf/open/floor/plating,
/area/bigredv2/outside/nw)
"fF" = (
/obj/machinery/light,
/turf/open/floor/plating,
/area/bigredv2/outside/nw)
"fS" = (
/turf/open/floor/marking/asteroidwarning,
/area/bigredv2/outside/nw)
"go" = (
/obj/structure/cable,
/turf/open/floor/marking/asteroidwarning,
/area/bigredv2/outside/nw)
"gC" = (
/turf/open/floor/marking/asteroidwarning{
	dir = 4
	},
/area/bigredv2/outside/virology)
"gK" = (
/obj/machinery/light{
	dir = 4
	},
/turf/open/floor/marking/asteroidwarning{
	dir = 1
	},
/area/bigredv2/outside/virology)
"hl" = (
/obj/structure/cable,
/obj/machinery/atmospherics/pipe/simple/green/hidden,
/turf/open/floor/plating,
/area/bigredv2/outside/nw)
"iV" = (
/obj/machinery/light{
	dir = 8
	},
/turf/open/floor/asteroidfloor,
/area/bigredv2/outside/nw)
"ko" = (
/obj/effect/decal/cleanable/dirt,
/obj/structure/cable,
/obj/effect/decal/cleanable/dirt,
/turf/open/floor/marking/asteroidwarning,
/area/bigredv2/outside/nw)
"kx" = (
/obj/machinery/atmospherics/pipe/simple/green/hidden,
/turf/open/floor/marking/asteroidwarning{
	dir = 4
	},
/area/bigredv2/outside/nw)
"kP" = (
/turf/open/floor/marking/asteroidwarning{
	dir = 9
	},
/area/bigredv2/outside/nw)
"kU" = (
/turf/open/floor/marking/asteroidwarning{
	dir = 5
	},
/area/bigredv2/outside/virology)
"lf" = (
/obj/structure/cable,
/obj/machinery/atmospherics/pipe/simple/green/hidden,
/turf/open/floor/marking/asteroidwarning{
	dir = 4
	},
/area/bigredv2/outside/nw)
"lv" = (
/obj/effect/ai_node,
/turf/open/floor/plating/ground/mars/random/dirt,
/area/bigredv2/outside/virology)
"mj" = (
/obj/structure/cable,
/turf/closed/mineral/smooth/bigred,
/area/bigredv2/caves/rock)
"mm" = (
/obj/effect/ai_node,
/turf/open/floor/plating/ground/mars/random/cave/rock,
/area/bigredv2/caves/west)
"mz" = (
/turf/open/floor/plating/ground/mars/dirttosand/autosmooth{
	dir = 6
	},
/area/bigredv2/caves/northwest)
"mK" = (
/obj/effect/turf_decal/sandedge,
/turf/open/floor/marking/asteroidwarning{
	dir = 5
	},
/area/bigredv2/outside/nw)
"nq" = (
/obj/machinery/atmospherics/pipe/manifold/green/hidden,
/obj/structure/cable,
/turf/open/floor/plating,
/area/bigredv2/outside/nw)
"of" = (
/turf/open/floor/marking/asteroidwarning{
	dir = 1
	},
/area/bigredv2/outside/nw)
"ol" = (
/turf/open/floor/plating/ground/mars/random/cave/rock,
/area/bigredv2/caves/northwest)
"oo" = (
/obj/structure/cable,
/obj/machinery/atmospherics/pipe/simple/green/hidden{
	dir = 4
	},
/turf/open/floor/asteroidfloor,
/area/bigredv2/outside/nw)
"oz" = (
/obj/effect/decal/cleanable/dirt,
/obj/effect/ai_node,
/turf/open/floor/marking/asteroidwarning{
	dir = 10
	},
/area/bigredv2/outside/nw)
"oC" = (
/obj/machinery/atmospherics/pipe/simple/green/hidden,
/turf/open/floor/plating/warning{
	dir = 1
	},
/area/bigredv2/outside/nw)
"pT" = (
/obj/effect/decal/cleanable/dirt,
/obj/effect/decal/cleanable/dirt,
/obj/effect/decal/cleanable/dirt,
/turf/open/floor/marking/asteroidwarning{
	dir = 8
	},
/area/bigredv2/outside/nw)
"rl" = (
/turf/open/floor/plating/ground/mars/cavetodirt{
	dir = 6
	},
/area/bigredv2/caves/west)
"ry" = (
/obj/structure/fence/standard/xenoproof,
/turf/open/floor/plating/ground/mars/random/cave,
/area/bigredv2/caves/west)
"rH" = (
/obj/structure/cable,
/turf/open/floor/plating,
/area/bigredv2/outside/nw)
"sB" = (
/obj/machinery/atmospherics/pipe/simple/green/hidden{
	dir = 4
	},
/obj/structure/cable,
/turf/open/floor/asteroidfloor,
/area/bigredv2/outside/nw)
"sS" = (
/obj/machinery/light,
/obj/effect/ai_node,
/turf/open/floor/plating,
/area/bigredv2/outside/nw)
"tb" = (
/obj/machinery/light,
/obj/effect/spawner/random/engineering/structure/tank/fuelweighted,
/turf/open/floor/plating,
/area/bigredv2/outside/nw)
"tc" = (
/obj/effect/decal/cleanable/dirt,
/obj/structure/cable,
/turf/open/floor/plating,
/area/bigredv2/outside/nw)
"th" = (
/obj/structure/cable,
/obj/machinery/atmospherics/pipe/simple/green/hidden{
	dir = 5
	},
/turf/open/floor/asteroidfloor,
/area/bigredv2/outside/nw)
"tm" = (
/turf/open/floor/marking/asteroidwarning{
	dir = 4
	},
/area/bigredv2/outside/nw)
"to" = (
/obj/effect/decal/cleanable/dirt,
/obj/effect/decal/cleanable/dirt,
/turf/open/floor/marking/asteroidwarning{
	dir = 10
	},
/area/bigredv2/outside/nw)
"tZ" = (
/obj/machinery/light{
	dir = 1
	},
/turf/open/floor/plating,
/area/bigredv2/outside/nw)
"ur" = (
/obj/structure/fence/standard/xenoproof,
/turf/open/floor/plating/ground/mars/cavetodirt{
	dir = 4
	},
/area/bigredv2/caves/west)
"wx" = (
/obj/effect/ai_node,
/turf/open/floor/plating,
/area/bigredv2/outside/nw)
"xS" = (
/turf/open/floor/marking/asteroidwarning{
	dir = 5
	},
/area/bigredv2/outside/nw)
"xY" = (
/obj/machinery/light{
	dir = 8
	},
/turf/open/floor/marking/asteroidwarning{
	dir = 1
	},
/area/bigredv2/outside/nw)
"xZ" = (
/obj/machinery/atmospherics/pipe/simple/green/hidden,
/obj/structure/cable,
/turf/open/floor/marking/asteroidwarning{
	dir = 4
	},
/area/bigredv2/outside/nw)
"yi" = (
/obj/docking_port/stationary/crashmode,
/turf/open/floor/plating/ground/mars/random/sand,
/area/bigredv2/outside/nw)
"ys" = (
/obj/machinery/light{
	dir = 1
	},
/obj/structure/cable,
/turf/open/floor/plating,
/area/bigredv2/outside/nw)
"yD" = (
/turf/open/floor/marking/asteroidwarning{
	dir = 10
	},
/area/bigredv2/outside/nw)
"yL" = (
/obj/structure/cable,
/turf/open/floor/marking/asteroidwarning{
	dir = 1
	},
/area/bigredv2/outside/nw)
"yN" = (
/obj/structure/cargo_container/horizontal{
	dir = 4
	},
/turf/open/floor/plating,
/area/bigredv2/outside/nw)
"yR" = (
/obj/structure/largecrate/random/case/double,
/turf/open/floor/plating,
/area/bigredv2/outside/nw)
"zm" = (
/turf/open/floor/marking/asteroidwarning{
	dir = 8
	},
/area/bigredv2/outside/nw)
"zL" = (
/obj/effect/decal/cleanable/blood,
/turf/open/floor/plating/ground/mars/random/sand,
/area/bigredv2/outside/nw)
"As" = (
/obj/machinery/atmospherics/pipe/simple/green/hidden{
	dir = 4
	},
/obj/structure/cable,
/turf/open/floor/marking/asteroidwarning{
	dir = 1
	},
/area/bigredv2/outside/nw)
"AF" = (
/obj/structure/cable,
/obj/machinery/atmospherics/pipe/simple/green/hidden{
	dir = 6
	},
/obj/effect/ai_node,
/turf/open/floor/plating,
/area/bigredv2/outside/nw)
"AL" = (
/turf/open/floor/marking/asteroidwarning{
	dir = 8
	},
/area/bigredv2/outside/virology)
"AW" = (
/obj/effect/ai_node,
/turf/open/floor/marking/asteroidwarning{
	dir = 4
	},
/area/bigredv2/outside/virology)
"Bu" = (
/obj/machinery/atmospherics/pipe/simple/green/hidden{
	dir = 4
	},
/obj/structure/cable,
/obj/effect/decal/cleanable/dirt,
/turf/open/floor/plating,
/area/bigredv2/outside/nw)
"Bz" = (
/turf/closed/mineral/smooth/bigred,
/area/bigredv2/caves/rock)
"BS" = (
/turf/open/floor/plating/ground/mars/dirttosand/autosmooth{
	dir = 5
	},
/area/bigredv2/outside/virology)
"BU" = (
/obj/effect/decal/cleanable/dirt,
/turf/open/floor/marking/asteroidwarning{
	dir = 4
	},
/area/bigredv2/outside/nw)
"BW" = (
/obj/machinery/atmospherics/pipe/simple/green/hidden,
/obj/structure/cable,
/obj/effect/ai_node,
/turf/open/floor/marking/asteroidwarning{
	dir = 4
	},
/area/bigredv2/outside/nw)
"Cp" = (
/obj/effect/decal/cleanable/dirt,
/turf/open/floor/plating,
/area/bigredv2/outside/nw)
"CN" = (
/turf/open/floor/plating/ground/mars/dirttosand/autosmooth,
/area/bigredv2/outside/nw)
"CU" = (
/turf/closed/mineral/smooth/bigred/indestructible,
/area/space)
"Dy" = (
/obj/machinery/light{
	dir = 8
	},
/turf/open/floor/plating,
/area/bigredv2/outside/nw)
"DB" = (
/obj/effect/turf_decal/sandedge{
	dir = 4
	},
/obj/structure/fence/standard/xenoproof,
/turf/open/floor/plating/ground/mars/random/dirt,
/area/bigredv2/caves/northwest)
"Eg" = (
/obj/structure/cargo_container/horizontal{
	dir = 1
	},
/turf/open/floor/plating,
/area/bigredv2/outside/nw)
"EE" = (
/obj/machinery/atmospherics/pipe/simple/green/hidden{
	dir = 4
	},
/obj/structure/cable,
/obj/effect/ai_node,
/turf/open/floor/plating,
/area/bigredv2/outside/nw)
"EY" = (
/turf/open/floor/plating/ground/mars/dirttosand/autosmooth{
	dir = 5
	},
/area/bigredv2/caves/northwest)
"Fn" = (
/obj/machinery/atmospherics/pipe/simple/green/hidden{
	dir = 4
	},
/obj/structure/cable,
/turf/open/floor/plating,
/area/bigredv2/outside/nw)
"FC" = (
/obj/effect/decal/cleanable/dirt,
/turf/open/floor/marking/asteroidwarning{
	dir = 5
	},
/area/bigredv2/outside/nw)
"FL" = (
/turf/open/floor/plating/ground/mars/random/cave/rock,
/area/bigredv2/caves/west)
"FZ" = (
/turf/open/floor/plating/ground/mars/random/cave,
/area/bigredv2/caves/west)
"Gx" = (
/turf/open/floor/marking/asteroidwarning{
	dir = 9
	},
/area/bigredv2/outside/virology)
"GQ" = (
/turf/open/floor/plating/ground/mars/random/cave,
/area/bigredv2/caves/northwest)
"HK" = (
/obj/structure/cable,
/turf/open/floor/asteroidfloor,
/area/bigredv2/outside/nw)
"HY" = (
/obj/machinery/atmospherics/pipe/simple/green/hidden{
	dir = 4
	},
/obj/structure/cable,
/obj/machinery/door/airlock/multi_tile/mainship/medidoor{
	dir = 1;
	name = "\improper Medical Clinic"
	},
/turf/open/floor/tile/white,
/area/bigredv2/outside/nw)
"IA" = (
/turf/open/floor/plating/ground/mars/dirttosand/autosmooth{
	dir = 4
	},
/area/bigredv2/outside/nw)
"IX" = (
/obj/effect/landmark/excavation_site_spawner,
/turf/open/floor/plating,
/area/bigredv2/outside/nw)
"Js" = (
/obj/machinery/light{
	dir = 1
	},
/obj/structure/largecrate/random/case/small,
/turf/open/floor/plating,
/area/bigredv2/outside/nw)
"JA" = (
/obj/machinery/atmospherics/pipe/simple/green/hidden{
	dir = 10
	},
/obj/structure/cable,
/turf/open/floor/marking/asteroidwarning{
	dir = 5
	},
/area/bigredv2/outside/nw)
"JV" = (
/obj/effect/ai_node,
/turf/open/floor/marking/asteroidwarning{
	dir = 10
	},
/area/bigredv2/outside/nw)
"KT" = (
/turf/open/floor/plating/warning{
	dir = 8
	},
/area/bigredv2/outside/nw)
"Mr" = (
/turf/open/floor/asteroidfloor,
/area/bigredv2/outside/nw)
"Mz" = (
/turf/open/floor/plating/ground/mars/random/dirt,
/area/bigredv2/outside/nw)
"ME" = (
/turf/open/floor/plating/ground/mars/dirttosand/autosmooth{
	dir = 5
	},
/area/bigredv2/outside/nw)
"MH" = (
/obj/effect/ai_node,
/turf/open/floor/plating/ground/mars/random/sand,
/area/bigredv2/outside/nw)
"MV" = (
/turf/open/floor/plating/ground/mars/random/dirt,
/area/bigredv2/caves/west)
"Ng" = (
/obj/effect/ai_node,
/turf/open/floor/asteroidfloor,
/area/bigredv2/outside/nw)
"NE" = (
/obj/effect/decal/cleanable/dirt,
/obj/structure/cable,
/turf/open/floor/asteroidfloor,
/area/bigredv2/outside/nw)
"NF" = (
/turf/closed/wall/r_wall,
/area/bigredv2/outside/virology)
"OD" = (
/obj/effect/ai_node,
/turf/open/floor/plating/ground/mars/random/cave,
/area/bigredv2/caves/northwest)
"Po" = (
/obj/effect/turf_decal/sandedge,
/turf/open/floor/plating/ground/mars/random/sand,
/area/bigredv2/outside/nw)
"PU" = (
/obj/structure/cable,
/obj/machinery/atmospherics/pipe/simple/green/hidden{
	dir = 4
	},
/turf/open/floor/plating/warning{
	dir = 8
	},
/area/bigredv2/outside/nw)
"QF" = (
/turf/open/floor/plating/ground/mars/dirttosand/autosmooth{
	dir = 8
	},
/area/bigredv2/outside/nw)
"QH" = (
/turf/open/floor/plating/ground/mars/dirttosand/autosmooth{
	dir = 1
	},
/area/bigredv2/outside/nw)
"QI" = (
/obj/effect/decal/cleanable/dirt,
/turf/open/floor/marking/asteroidwarning,
/area/bigredv2/outside/nw)
"Rp" = (
/obj/effect/decal/cleanable/dirt,
/turf/open/floor/marking/asteroidwarning{
	dir = 1
	},
/area/bigredv2/outside/nw)
"Sc" = (
/obj/effect/ai_node,
/turf/open/floor/plating/ground/mars/random/cave,
/area/bigredv2/caves/west)
"Se" = (
/obj/structure/cargo_container/horizontal,
/turf/open/floor/plating,
/area/bigredv2/outside/nw)
"SJ" = (
/turf/open/floor/plating/ground/mars/dirttosand/autosmooth{
	dir = 9
	},
/area/bigredv2/outside/nw)
"Uk" = (
/obj/effect/decal/cleanable/dirt,
/turf/open/floor/asteroidfloor,
/area/bigredv2/outside/nw)
"UX" = (
/turf/open/floor/plating/ground/mars/random/sand,
/area/bigredv2/outside/nw)
"Vv" = (
/obj/machinery/atmospherics/pipe/simple/green/hidden,
/obj/structure/cable,
/turf/open/floor/plating,
/area/bigredv2/outside/nw)
"Wh" = (
/turf/open/floor/asteroidfloor,
/area/bigredv2/outside/virology)
"Wk" = (
/obj/structure/cable,
/obj/machinery/atmospherics/pipe/simple/green/hidden,
/obj/effect/ai_node,
/turf/open/floor/asteroidfloor,
/area/bigredv2/outside/nw)
"Wp" = (
/turf/open/floor/plating/warning{
	dir = 1
	},
/area/bigredv2/outside/nw)
"Wu" = (
/turf/closed/wall/r_wall,
/area/bigredv2/caves/northwest)
"Wx" = (
/obj/effect/decal/cleanable/dirt,
/turf/open/floor/marking/asteroidwarning{
	dir = 6
	},
/area/bigredv2/outside/nw)
"WF" = (
/obj/structure/rack,
/turf/open/floor/plating,
/area/bigredv2/outside/nw)
"WG" = (
/turf/open/floor/plating,
/area/bigredv2/outside/nw)
"WI" = (
/turf/closed/wall/r_wall,
/area/bigredv2/outside/nw)
"XK" = (
/obj/effect/decal/cleanable/dirt,
/obj/effect/decal/cleanable/dirt,
/obj/effect/decal/cleanable/dirt,
/turf/open/floor/marking/asteroidwarning{
	dir = 9
	},
/area/bigredv2/outside/nw)
"YI" = (
/obj/machinery/atmospherics/pipe/simple/green/hidden,
/turf/open/floor/marking/asteroidwarning{
	dir = 1
	},
/area/bigredv2/outside/nw)
"Zd" = (
/turf/open/floor/plating/ground/mars/random/sand,
/area/bigredv2/caves/northwest)
"Zk" = (
/obj/structure/cable,
/turf/open/floor/plating/warning{
	dir = 1
	},
/area/bigredv2/outside/nw)
"Zq" = (
/obj/effect/decal/cleanable/dirt,
/obj/effect/ai_node,
/turf/open/floor/marking/asteroidwarning{
	dir = 8
	},
/area/bigredv2/outside/nw)
"ZQ" = (
/obj/structure/cable,
/obj/effect/ai_node,
/turf/open/floor/asteroidfloor,
/area/bigredv2/outside/nw)

(1,1,1) = {"
CU
CU
CU
CU
CU
CU
CU
CU
CU
CU
CU
CU
CU
CU
CU
CU
CU
CU
CU
CU
CU
CU
"}
(2,1,1) = {"
Bz
Bz
Bz
Bz
Bz
Bz
Bz
Bz
Bz
Bz
Bz
Bz
Bz
Bz
Bz
Bz
Bz
Bz
Bz
Bz
Bz
Bz
"}
(3,1,1) = {"
Bz
Bz
Bz
Bz
Bz
Bz
Bz
Bz
Bz
Bz
Bz
Bz
Bz
Bz
Bz
Bz
FL
FL
FL
FL
Bz
Bz
"}
(4,1,1) = {"
Bz
Bz
Bz
Bz
Bz
Bz
Bz
Bz
Bz
Bz
Bz
Bz
Bz
Bz
Bz
FL
FZ
FZ
FZ
FZ
FL
Bz
"}
(5,1,1) = {"
Bz
Bz
Bz
Bz
Bz
Bz
Bz
Bz
Bz
Bz
Bz
Bz
Bz
Bz
FL
FZ
FZ
FZ
FZ
FZ
FZ
FL
"}
(6,1,1) = {"
Bz
Bz
Bz
Bz
Bz
Bz
Bz
Bz
Bz
Bz
Bz
Bz
Bz
Bz
FZ
FZ
FZ
FZ
FZ
FZ
FZ
FZ
"}
(7,1,1) = {"
Bz
Bz
Bz
Bz
Bz
Bz
Bz
Bz
Bz
Bz
Bz
Bz
Bz
ol
FZ
FZ
FZ
FZ
FZ
FZ
FL
FZ
"}
(8,1,1) = {"
Bz
Bz
Bz
Bz
Bz
Bz
Bz
Bz
GQ
GQ
GQ
GQ
GQ
OD
FZ
FZ
FZ
FZ
FZ
FZ
mm
FZ
"}
(9,1,1) = {"
Bz
GQ
GQ
GQ
GQ
GQ
GQ
GQ
GQ
GQ
GQ
GQ
GQ
GQ
FZ
FZ
FZ
FZ
FZ
FZ
FL
FZ
"}
(10,1,1) = {"
GQ
GQ
GQ
GQ
GQ
GQ
GQ
GQ
GQ
GQ
GQ
GQ
ol
GQ
FZ
FZ
FZ
FZ
FZ
FZ
FL
FZ
"}
(11,1,1) = {"
GQ
GQ
GQ
GQ
GQ
ol
GQ
GQ
GQ
GQ
GQ
GQ
GQ
GQ
FZ
FZ
FZ
FZ
FZ
FZ
FL
Bz
"}
(12,1,1) = {"
GQ
GQ
ol
ol
GQ
GQ
OD
GQ
GQ
GQ
GQ
OD
GQ
OD
FZ
FZ
FZ
FZ
FZ
FZ
mm
Bz
"}
(13,1,1) = {"
ol
GQ
GQ
GQ
GQ
GQ
GQ
GQ
GQ
GQ
GQ
ol
GQ
GQ
FZ
FZ
FZ
FZ
FZ
FZ
FZ
FL
"}
(14,1,1) = {"
GQ
GQ
GQ
GQ
GQ
GQ
Bz
Bz
Bz
Wu
DB
DB
DB
Wu
Bz
Bz
Bz
FZ
FZ
FZ
Sc
FL
"}
(15,1,1) = {"
GQ
GQ
GQ
GQ
GQ
Bz
Bz
Bz
Bz
EY
dr
dr
mz
Zd
Bz
Bz
Bz
FZ
Bz
Bz
ry
ur
"}
(16,1,1) = {"
GQ
GQ
GQ
Bz
Bz
Bz
Bz
Bz
Bz
Zd
Zd
Zd
Zd
Zd
Bz
Bz
Bz
Bz
Bz
Bz
rl
MV
"}
(17,1,1) = {"
GQ
GQ
Bz
Bz
Bz
Bz
Bz
Bz
Bz
Zd
Zd
Zd
Zd
Zd
Bz
Bz
Bz
Bz
Bz
Bz
cM
cM
"}
(18,1,1) = {"
Bz
Bz
Bz
Bz
Bz
Bz
Bz
WI
WI
WI
WG
WG
WG
WI
WI
Bz
Bz
Bz
Bz
cM
cM
cM
"}
(19,1,1) = {"
Bz
Bz
Bz
Bz
Bz
Bz
Bz
WI
WG
WG
WG
WG
WG
WG
WI
WI
WI
WI
NF
cM
cM
cM
"}
(20,1,1) = {"
Bz
Bz
Bz
Bz
Bz
Bz
Bz
WI
tZ
WG
WG
wx
WG
WG
WG
Eg
yN
Se
NF
cM
lv
Gx
"}
(21,1,1) = {"
Bz
Bz
Bz
Bz
Bz
Bz
Bz
WI
WG
WG
WG
WG
wx
WG
WG
WG
WG
WG
NF
BS
cM
bl
"}
(22,1,1) = {"
Bz
Bz
Bz
Bz
Bz
Bz
Bz
WI
WG
WG
WG
WG
WG
wx
WG
WG
WG
sS
NF
ap
BS
bl
"}
(23,1,1) = {"
Bz
Bz
Bz
Bz
Bz
Bz
Bz
WI
WG
Eg
yN
Se
WG
WG
WG
WG
WG
WG
NF
ap
ap
bl
"}
(24,1,1) = {"
Bz
Bz
Bz
Bz
Bz
Bz
Bz
WI
WG
WG
WG
WG
IX
WG
WG
WG
WG
WG
Gx
AL
AL
Wh
"}
(25,1,1) = {"
Bz
Bz
Bz
UX
UX
UX
UX
WI
WG
WG
WG
WG
WG
WG
WG
WG
WG
wx
bl
Wh
Wh
Wh
"}
(26,1,1) = {"
Bz
UX
UX
UX
UX
UX
UX
WI
WG
WG
WG
WG
WG
WG
WG
WG
wx
WG
kU
gC
AW
Wh
"}
(27,1,1) = {"
Po
UX
UX
UX
UX
UX
WI
WI
WG
WG
WG
WG
WG
WG
WG
WG
WG
WG
NF
cM
cM
bl
"}
(28,1,1) = {"
aj
zm
JV
UX
UX
UX
WI
be
WG
WG
wx
WG
wx
WG
WG
WG
WG
WG
NF
cM
cM
bl
"}
(29,1,1) = {"
mK
Mr
fS
UX
UX
UX
WI
rH
WG
WG
WG
WG
WG
WG
WG
WG
WG
WG
NF
cM
cM
bl
"}
(30,1,1) = {"
mj
yL
go
UX
UX
UX
WI
ys
WG
WG
WG
Eg
yN
Se
WG
WG
WG
fF
NF
cM
cM
bl
"}
(31,1,1) = {"
Bz
of
ko
UX
UX
SJ
WI
rH
WG
WG
WG
WG
WG
WG
WG
WG
WG
WG
NF
cM
Gx
AL
"}
(32,1,1) = {"
UX
of
go
QF
QF
Mz
WI
rH
WG
WG
WG
WG
WG
WG
WG
WG
WG
WG
NF
cM
gK
Wh
"}
(33,1,1) = {"
UX
of
HK
fw
zm
fw
yD
tc
Cp
WG
WG
WG
WG
WG
Cp
XK
pT
to
NF
NF
NF
Wh
"}
(34,1,1) = {"
UX
of
ZQ
NE
NE
NE
go
dY
cf
rH
AF
hl
hl
hl
hl
ab
Wk
th
oz
Mz
xY
Mr
"}
(35,1,1) = {"
SJ
of
Mr
Mr
Mr
tm
Wx
WG
WG
WG
Bu
WG
WG
WG
WG
Rp
Uk
sB
QI
Mz
xS
tm
"}
(36,1,1) = {"
QH
of
Uk
Uk
Wx
Mz
WI
WG
WG
Cp
Fn
Cp
WG
WG
WG
FC
BU
oo
QI
Mz
Mz
of
"}
(37,1,1) = {"
QH
Rp
Mr
QI
Mz
IA
WI
WI
WI
KT
PU
KT
WI
WI
WI
WI
Mz
As
QI
Mz
Mz
of
"}
(38,1,1) = {"
QH
of
Mr
QI
CN
UX
WI
fA
WG
WG
Fn
WG
Dy
WG
WG
WI
Mz
As
fS
Mz
Mz
of
"}
(39,1,1) = {"
QH
of
Mr
fS
CN
UX
WI
Js
WG
WG
Fn
WG
Eg
yN
Se
WI
Mz
As
Mr
fw
zm
Mr
"}
(40,1,1) = {"
Zq
Mr
Ng
QI
CN
UX
WI
WG
WG
WG
Fn
WG
WG
WG
WG
WI
Mz
JA
BW
xZ
xZ
lf
"}
(41,1,1) = {"
Uk
Mr
Uk
fS
CN
UX
WI
WG
WG
WG
EE
WG
Eg
yN
Se
WI
IA
IA
IA
IA
Mz
Mz
"}
(42,1,1) = {"
tm
tm
BU
Wx
CN
UX
WI
WG
WG
WG
Fn
WG
WG
WG
WG
WI
UX
UX
UX
UX
ME
IA
"}
(43,1,1) = {"
Mz
Mz
Mz
Mz
Mz
UX
WI
WG
WG
WG
Fn
WG
WG
WG
WG
WI
UX
UX
UX
UX
UX
UX
"}
(44,1,1) = {"
Mz
Mz
Mz
Mz
Mz
kP
WI
tZ
WG
WG
Fn
WG
WG
WG
tb
WI
UX
UX
UX
UX
UX
UX
"}
(45,1,1) = {"
zm
zm
zm
zm
zm
of
Wp
WG
WG
WG
Fn
WG
WG
WG
WG
WI
UX
UX
MH
UX
UX
UX
"}
(46,1,1) = {"
HK
HK
ZQ
HK
ZQ
yL
Zk
WG
WG
WG
EE
WG
WG
WG
WG
WI
UX
UX
UX
UX
UX
UX
"}
(47,1,1) = {"
kx
kx
kx
kx
kx
YI
oC
Vv
Vv
Vv
nq
WG
WG
WG
WF
WI
UX
UX
UX
UX
UX
UX
"}
(48,1,1) = {"
IA
IA
Mz
Mz
Mz
xS
WI
yR
WG
WG
Fn
WG
WG
WG
WG
WI
UX
UX
UX
UX
UX
UX
"}
(49,1,1) = {"
UX
UX
ME
IA
IA
IA
WI
Js
WG
WG
Fn
WG
WG
WG
fF
WI
UX
UX
UX
UX
UX
UX
"}
(50,1,1) = {"
UX
UX
UX
UX
UX
UX
WI
yR
WG
WG
Fn
WG
Eg
yN
Se
WI
UX
UX
UX
UX
UX
UX
"}
(51,1,1) = {"
UX
UX
UX
UX
UX
UX
WI
WG
WG
WG
Fn
WG
WG
WG
WG
WI
UX
UX
UX
UX
UX
UX
"}
(52,1,1) = {"
UX
UX
UX
UX
UX
UX
WI
WG
WG
WG
EE
WG
WG
WG
WG
WI
UX
UX
UX
UX
UX
zL
"}
(53,1,1) = {"
UX
UX
UX
UX
UX
UX
WI
WI
WI
dn
HY
WI
WI
WI
WI
WI
UX
UX
UX
UX
UX
UX
"}
(54,1,1) = {"
UX
UX
UX
UX
UX
yi
of
iV
Mr
Mr
sB
Mr
Mr
iV
Mr
fS
UX
UX
MH
UX
UX
UX
"}
