//MAP CONVERTED BY dmm2tgm.py THIS HEADER COMMENT PREVENTS RECONVERSION, DO NOT REMOVE
"ag" = (
/obj/machinery/atmospherics/pipe/simple/green/hidden,
/obj/machinery/door/airlock/multi_tile/mainship/generic{
	name = "\improper Robotics"
	},
/turf/open/floor,
/area/bigredv3/inside/secondary/office_complex)
"aC" = (
/obj/structure/mopbucket,
/turf/open/floor/tile/whiteyellow/full,
/area/bigredv3/inside/secondary/office_complex)
"aE" = (
/obj/structure/table,
/obj/structure/flora/pottedplant/fifteen{
	pixel_y = 10
	},
/turf/open/floor/grimy,
/area/bigredv3/inside/secondary/office_complex)
"aL" = (
/obj/machinery/door/airlock/mainship/generic{
	dir = 1;
	name = "\improper Private Office"
	},
/turf/open/floor,
/area/bigredv3/inside/secondary/office_complex)
"aO" = (
/obj/machinery/door/airlock/multi_tile/mainship/generic{
	name = "\improper Office Complex Janitor Room"
	},
/turf/open/floor,
/area/bigredv3/inside/secondary/office_complex)
"aR" = (
/obj/structure/janitorialcart,
/obj/effect/decal/cleanable/dirt,
/turf/open/floor/tile/whiteyellow/full,
/area/bigredv3/inside/secondary/office_complex)
"bh" = (
/obj/machinery/atmospherics/components/unary/vent_pump{
	dir = 4;
	on = 1
	},
/obj/effect/decal/cleanable/dirt,
/obj/machinery/power/apc/weak/ntf,
/obj/structure/cable,
/turf/open/floor/tile/dark,
/area/bigredv3/inside/secondary/office_complex)
"cK" = (
/obj/structure/bed/chair/comfy/lime{
	dir = 4
	},
/obj/machinery/light{
	dir = 8
	},
/turf/open/floor,
/area/bigredv3/inside/secondary/office_complex)
"dr" = (
/obj/effect/decal/cleanable/blood/gibs,
/turf/open/floor/marking/asteroidwarning,
/area/bigredv3/outside/directions/central)
"dw" = (
/obj/structure/table,
/obj/item/paper,
/turf/open/floor/grimy,
/area/bigredv3/inside/secondary/office_complex)
"dO" = (
/turf/open/floor/plating/ground/mars/random/sand,
/area/bigredv3/outside/directions/central)
"dR" = (
/turf/open/floor/marking/asteroidwarning{
	dir = 8
	},
/area/bigredv3/outside/directions/central)
"eA" = (
/obj/effect/ai_node,
/turf/open/floor/tile/red/redtaupecorner,
/area/bigredv3/inside/secondary/office_complex)
"eF" = (
/obj/machinery/atmospherics/pipe/simple/green/hidden{
	dir = 4
	},
/obj/item/trash/cheesie,
/turf/open/floor/tile/red/redtaupecorner,
/area/bigredv3/inside/secondary/office_complex)
"eH" = (
/turf/open/floor/marking/asteroidwarning{
	dir = 8
	},
/area/bigredv3/outside/directions/e)
"fZ" = (
/obj/machinery/prop/autolathe,
/turf/open/floor/tile/white,
/area/bigredv3/inside/secondary/office_complex)
"ge" = (
/obj/effect/decal/cleanable/dirt,
/obj/structure/cable,
/obj/machinery/atmospherics/pipe/simple/green/hidden,
/turf/open/floor/tile/red/redtaupecorner{
	dir = 8
	},
/area/bigredv3/inside/secondary/office_complex)
"gt" = (
/obj/structure/sign/safety/breakroom,
/turf/open/floor,
/area/bigredv3/inside/secondary/office_complex)
"gz" = (
/obj/effect/ai_node,
/turf/open/floor/asteroidfloor,
/area/bigredv3/outside/directions/e)
"gS" = (
/obj/machinery/atmospherics/pipe/simple/green/hidden,
/turf/open/floor/tile/red/redtaupecorner{
	dir = 4
	},
/area/bigredv3/inside/secondary/office_complex)
"hp" = (
/obj/machinery/light{
	dir = 4
	},
/turf/open/floor/tile/dark,
/area/bigredv3/inside/secondary/office_complex)
"hw" = (
/obj/machinery/atmospherics/pipe/simple/green/hidden{
	dir = 4
	},
/obj/structure/cable,
/obj/effect/ai_node,
/turf/open/floor,
/area/bigredv3/inside/secondary/office_complex)
"hB" = (
/turf/open/floor/asteroidfloor,
/area/bigredv3/outside/directions/e)
"iy" = (
/obj/structure/table,
/obj/item/paper,
/obj/item/tool/pen/blue,
/obj/machinery/light{
	dir = 4
	},
/turf/open/floor/tile/white,
/area/bigredv3/inside/secondary/office_complex)
"iP" = (
/turf/open/floor/plating/ground/mars/dirttosand/autosmooth{
	dir = 6
	},
/area/bigredv3/outside/directions/central)
"iQ" = (
/turf/open/floor/tile/dark,
/area/bigredv3/inside/secondary/office_complex)
"iS" = (
/obj/effect/decal/cleanable/dirt,
/obj/machinery/atmospherics/pipe/manifold/green/hidden,
/obj/structure/cable,
/turf/open/floor/tile/red/redtaupecorner,
/area/bigredv3/inside/secondary/office_complex)
"ja" = (
/turf/open/floor/tile/white,
/area/bigredv3/inside/secondary/office_complex)
"jc" = (
/obj/effect/decal/cleanable/dirt,
/obj/item/paper,
/turf/open/floor/tile/whiteyellow/full,
/area/bigredv3/inside/secondary/office_complex)
"jt" = (
/obj/effect/decal/cleanable/dirt,
/obj/structure/bed/chair{
	dir = 4
	},
/turf/open/floor/tile/white,
/area/bigredv3/inside/secondary/office_complex)
"jR" = (
/obj/machinery/atmospherics/pipe/simple/green/hidden,
/turf/open/floor,
/area/bigredv3/inside/secondary/office_complex)
"jS" = (
/turf/open/floor/marking/asteroidwarning{
	dir = 5
	},
/area/bigredv3/outside/directions/e)
"kc" = (
/obj/structure/bed/chair{
	dir = 1
	},
/turf/open/floor,
/area/bigredv3/inside/secondary/office_complex)
"kj" = (
/obj/effect/decal/cleanable/dirt,
/obj/machinery/light{
	dir = 1
	},
/turf/open/floor,
/area/bigredv3/inside/secondary/office_complex)
"kR" = (
/obj/machinery/light{
	dir = 4
	},
/obj/structure/bed/chair/comfy/black{
	dir = 8
	},
/obj/effect/decal/cleanable/dirt,
/turf/open/floor,
/area/bigredv3/inside/secondary/office_complex)
"lt" = (
/obj/effect/decal/cleanable/dirt,
/obj/machinery/atmospherics/pipe/simple/green/hidden,
/obj/structure/cable,
/turf/open/floor/tile/red/redtaupecorner{
	dir = 8
	},
/area/bigredv3/inside/secondary/office_complex)
"lx" = (
/obj/item/trash/raisins,
/turf/open/floor/tile/dark,
/area/bigredv3/inside/secondary/office_complex)
"lE" = (
/obj/structure/cable,
/obj/machinery/atmospherics/pipe/simple/green/hidden,
/turf/open/floor/tile/red/redtaupecorner{
	dir = 8
	},
/area/bigredv3/inside/secondary/office_complex)
"lN" = (
/obj/structure/cable,
/obj/machinery/atmospherics/pipe/simple/green/hidden,
/obj/machinery/door/airlock/multi_tile/mainship/generic{
	name = "\improper Office Complex"
	},
/turf/open/floor,
/area/bigredv3/inside/secondary/office_complex)
"lQ" = (
/obj/effect/decal/cleanable/dirt,
/obj/item/tool/lighter/random,
/obj/effect/ai_node,
/turf/open/floor/tile/whiteyellow/full,
/area/bigredv3/inside/secondary/office_complex)
"lR" = (
/obj/effect/decal/cleanable/blood/gibs/down,
/turf/open/floor/tile/dark,
/area/bigredv3/inside/secondary/office_complex)
"md" = (
/obj/structure/table,
/obj/effect/decal/cleanable/dirt,
/turf/open/floor/tile/dark,
/area/bigredv3/inside/secondary/office_complex)
"mO" = (
/obj/effect/decal/cleanable/dirt,
/obj/effect/spawner/random/misc/trash,
/turf/open/floor/tile/white,
/area/bigredv3/inside/secondary/office_complex)
"nL" = (
/obj/effect/decal/cleanable/dirt,
/turf/open/floor/marking/asteroidwarning,
/area/bigredv3/outside/directions/central)
"nP" = (
/turf/open/floor/grimy,
/area/bigredv3/inside/secondary/office_complex)
"nZ" = (
/obj/structure/table,
/obj/item/trash/kepler,
/turf/open/floor/tile/whiteyellow/full,
/area/bigredv3/inside/secondary/office_complex)
"ok" = (
/obj/effect/decal/cleanable/dirt,
/turf/open/floor/marking/asteroidwarning,
/area/bigredv3/outside/directions/se)
"oD" = (
/obj/structure/bed/chair{
	dir = 1
	},
/obj/machinery/light,
/turf/open/floor,
/area/bigredv3/inside/secondary/office_complex)
"oM" = (
/turf/open/floor/marking/asteroidwarning{
	dir = 4
	},
/area/bigredv3/outside/directions/e)
"oU" = (
/obj/structure/table,
/obj/structure/flora/pottedplant/fifteen{
	pixel_y = 10
	},
/turf/open/floor/tile/white,
/area/bigredv3/inside/secondary/office_complex)
"oY" = (
/obj/machinery/atmospherics/pipe/simple/green/hidden{
	dir = 4
	},
/obj/effect/decal/cleanable/dirt,
/obj/effect/ai_node,
/turf/open/floor,
/area/bigredv3/inside/secondary/office_complex)
"pp" = (
/obj/machinery/vending/snack,
/turf/open/floor,
/area/bigredv3/inside/secondary/office_complex)
"px" = (
/obj/structure/table,
/obj/item/storage/box/m94,
/turf/open/floor/tile/whiteyellow/full,
/area/bigredv3/inside/secondary/office_complex)
"pM" = (
/obj/machinery/light{
	dir = 8
	},
/turf/open/floor/wood,
/area/bigredv3/inside/secondary/office_complex)
"qW" = (
/obj/machinery/light{
	dir = 8
	},
/turf/open/floor/tile/whiteyellow/full,
/area/bigredv3/inside/secondary/office_complex)
"rl" = (
/turf/open/floor/plating/ground/mars/dirttosand/autosmooth{
	dir = 1
	},
/area/bigredv3/outside/directions/e)
"rq" = (
/turf/open/floor/marking/asteroidwarning,
/area/bigredv3/outside/directions/se)
"rK" = (
/obj/structure/closet/jcloset,
/obj/item/clothing/head/beret/jan,
/obj/item/clothing/head/beret/jan,
/obj/item/clothing/head/beret/jan,
/obj/item/clothing/head/beret/jan,
/obj/item/clothing/head/beret/jan,
/obj/item/clothing/head/beret/jan,
/obj/item/clothing/head/beret/jan,
/obj/machinery/light{
	dir = 4
	},
/turf/open/floor/tile/whiteyellow/full,
/area/bigredv3/inside/secondary/office_complex)
"rL" = (
/obj/structure/janitorialcart,
/turf/open/floor/tile/whiteyellow/full,
/area/bigredv3/inside/secondary/office_complex)
"rN" = (
/turf/open/floor/plating/ground/mars/dirttosand/autosmooth,
/area/bigredv3/outside/directions/central)
"so" = (
/obj/structure/window/framed/colony,
/turf/open/floor/plating,
/area/bigredv3/inside/wall)
"sG" = (
/turf/open/floor/marking/asteroidwarning{
	dir = 10
	},
/area/bigredv3/outside/directions/central)
"sJ" = (
/turf/open/floor,
/area/bigredv3/inside/secondary/office_complex)
"sL" = (
/obj/machinery/atmospherics/pipe/manifold/green/hidden{
	dir = 1
	},
/obj/effect/decal/cleanable/dirt,
/turf/open/floor,
/area/bigredv3/inside/secondary/office_complex)
"to" = (
/obj/structure/table,
/obj/item/tool/multitool,
/turf/open/floor/tile/dark,
/area/bigredv3/inside/secondary/office_complex)
"tp" = (
/turf/open/floor/marking/asteroidwarning{
	dir = 1
	},
/area/bigredv3/outside/directions/central)
"tJ" = (
/obj/machinery/door/airlock/multi_tile/mainship/generic{
	name = "\improper Office Complex"
	},
/turf/open/floor,
/area/bigredv3/inside/secondary/office_complex)
"uA" = (
/obj/machinery/atmospherics/pipe/simple/green/hidden,
/obj/effect/decal/cleanable/dirt,
/obj/item/folder/red,
/turf/open/floor,
/area/bigredv3/inside/secondary/office_complex)
"uH" = (
/obj/structure/table,
/obj/machinery/computer/pod/old{
	name = "Personal Computer"
	},
/turf/open/floor,
/area/bigredv3/inside/secondary/office_complex)
"vl" = (
/obj/machinery/atmospherics/pipe/simple/green/hidden,
/obj/structure/cable,
/obj/machinery/light{
	dir = 8
	},
/turf/open/floor/tile/red/redtaupecorner{
	dir = 8
	},
/area/bigredv3/inside/secondary/office_complex)
"vp" = (
/turf/open/floor/wood,
/area/bigredv3/inside/secondary/office_complex)
"we" = (
/obj/machinery/door_control{
	dir = 4;
	id = "Office Complex 1";
	name = "Storm Shutters"
	},
/obj/structure/cable,
/obj/machinery/atmospherics/pipe/simple/green/hidden,
/turf/open/floor/tile/red/redtaupecorner{
	dir = 8
	},
/area/bigredv3/inside/secondary/office_complex)
"wh" = (
/obj/machinery/atmospherics/pipe/simple/green/hidden,
/obj/structure/cable,
/turf/open/floor/tile/red/redtaupecorner{
	dir = 8
	},
/area/bigredv3/inside/secondary/office_complex)
"wF" = (
/turf/closed/wall,
/area/bigredv3/inside/wall)
"wX" = (
/obj/machinery/atmospherics/pipe/simple/green/hidden,
/obj/machinery/door/airlock/multi_tile/mainship/generic{
	name = "\improper Office Complex Janitor Room"
	},
/turf/open/floor/tile/whiteyellow/full,
/area/bigredv3/inside/secondary/office_complex)
"xP" = (
/obj/machinery/atmospherics/pipe/simple/green/hidden{
	dir = 4
	},
/obj/machinery/door/airlock/mainship/generic{
	name = "\improper Office Complex Storage"
	},
/turf/open/floor,
/area/bigredv3/inside/secondary/office_complex)
"xW" = (
/turf/open/floor/marking/asteroidwarning,
/area/bigredv3/outside/directions/central)
"yb" = (
/obj/structure/table,
/obj/effect/decal/cleanable/dirt,
/obj/item/trash/syndi_cakes,
/turf/open/floor/tile/dark,
/area/bigredv3/inside/secondary/office_complex)
"yq" = (
/obj/structure/table,
/obj/item/clothing/mask/cigarette,
/turf/open/floor/tile/dark,
/area/bigredv3/inside/secondary/office_complex)
"yF" = (
/obj/effect/decal/cleanable/blood,
/obj/effect/decal/cleanable/dirt,
/turf/open/floor/tile/white,
/area/bigredv3/inside/secondary/office_complex)
"yH" = (
/obj/machinery/atmospherics/pipe/simple/green/hidden{
	dir = 4
	},
/obj/effect/spawner/random/misc/trash,
/turf/open/floor/tile/red/redtaupecorner,
/area/bigredv3/inside/secondary/office_complex)
"yN" = (
/obj/structure/bed/chair/office/light,
/turf/open/floor,
/area/bigredv3/inside/secondary/office_complex)
"yO" = (
/obj/machinery/light{
	dir = 4
	},
/turf/open/floor/tile/red/redtaupecorner,
/area/bigredv3/inside/secondary/office_complex)
"zw" = (
/obj/effect/decal/cleanable/dirt,
/obj/machinery/atmospherics/pipe/simple/green/hidden,
/turf/open/floor/tile/whiteyellow/full,
/area/bigredv3/inside/secondary/office_complex)
"zZ" = (
/obj/effect/decal/cleanable/dirt,
/obj/structure/cable,
/obj/machinery/atmospherics/pipe/simple/green/hidden,
/obj/machinery/light{
	dir = 8
	},
/turf/open/floor/tile/red/redtaupecorner{
	dir = 8
	},
/area/bigredv3/inside/secondary/office_complex)
"Az" = (
/turf/open/floor/marking/asteroidwarning{
	dir = 4
	},
/area/bigredv3/outside/directions/se)
"AH" = (
/obj/effect/decal/cleanable/dirt,
/turf/open/floor,
/area/bigredv3/inside/secondary/office_complex)
"Ba" = (
/obj/machinery/vending/cola,
/obj/machinery/light{
	dir = 8
	},
/turf/open/floor,
/area/bigredv3/inside/secondary/office_complex)
"Bf" = (
/obj/structure/bed/chair/comfy/black{
	dir = 8
	},
/obj/effect/decal/cleanable/dirt,
/turf/open/floor,
/area/bigredv3/inside/secondary/office_complex)
"Bl" = (
/obj/machinery/atmospherics/pipe/simple/green/hidden{
	dir = 4
	},
/turf/open/floor/tile/red/redtaupecorner,
/area/bigredv3/inside/secondary/office_complex)
"BI" = (
/obj/machinery/atmospherics/pipe/simple/green/hidden{
	dir = 9
	},
/turf/open/floor,
/area/bigredv3/inside/secondary/office_complex)
"BU" = (
/obj/machinery/atmospherics/pipe/simple/green/hidden{
	dir = 4
	},
/obj/machinery/light,
/turf/open/floor/tile/red/redtaupecorner,
/area/bigredv3/inside/secondary/office_complex)
"Ce" = (
/obj/machinery/photocopier,
/obj/machinery/light{
	dir = 8
	},
/turf/open/floor/tile/white,
/area/bigredv3/inside/secondary/office_complex)
"Cl" = (
/obj/effect/ai_node,
/turf/open/floor/tile/red/redtaupecorner{
	dir = 4
	},
/area/bigredv3/inside/secondary/office_complex)
"Co" = (
/obj/effect/decal/cleanable/dirt,
/turf/open/floor/tile/white,
/area/bigredv3/inside/secondary/office_complex)
"CN" = (
/obj/effect/ai_node,
/obj/machinery/light{
	dir = 1
	},
/turf/open/floor/tile/red/redtaupecorner{
	dir = 4
	},
/area/bigredv3/inside/secondary/office_complex)
"CU" = (
/obj/machinery/atmospherics/pipe/manifold/green/hidden{
	dir = 1
	},
/obj/structure/cable,
/turf/open/floor/tile/red/redtaupecorner{
	dir = 8
	},
/area/bigredv3/inside/secondary/office_complex)
"Dj" = (
/obj/machinery/light{
	dir = 4
	},
/turf/open/floor,
/area/bigredv3/inside/secondary/office_complex)
"Dt" = (
/obj/effect/decal/cleanable/dirt,
/turf/open/floor/wood,
/area/bigredv3/inside/secondary/office_complex)
"DW" = (
/obj/effect/decal/cleanable/dirt,
/obj/item/trash/eat,
/turf/open/floor,
/area/bigredv3/inside/secondary/office_complex)
"Ea" = (
/obj/structure/table,
/turf/open/floor/tile/dark,
/area/bigredv3/inside/secondary/office_complex)
"Es" = (
/turf/open/floor/marking/asteroidwarning{
	dir = 1
	},
/area/bigredv3/outside/directions/e)
"Ez" = (
/obj/machinery/atmospherics/pipe/simple/green/hidden{
	dir = 4
	},
/obj/structure/cable,
/obj/effect/ai_node,
/turf/open/floor/tile/red/redtaupecorner,
/area/bigredv3/inside/secondary/office_complex)
"EF" = (
/turf/open/floor/tile/red/redtaupecorner{
	dir = 8
	},
/area/bigredv3/inside/secondary/office_complex)
"EM" = (
/obj/structure/table,
/obj/item/tool/pen/blue,
/turf/open/floor/grimy,
/area/bigredv3/inside/secondary/office_complex)
"EO" = (
/obj/structure/bed/chair{
	dir = 4
	},
/turf/open/floor,
/area/bigredv3/inside/secondary/office_complex)
"EX" = (
/obj/structure/table,
/obj/structure/sign/prop3,
/obj/machinery/light,
/turf/open/floor,
/area/bigredv3/inside/secondary/office_complex)
"EZ" = (
/obj/structure/closet/jcloset,
/turf/open/floor/tile/whiteyellow/full,
/area/bigredv3/inside/secondary/office_complex)
"GR" = (
/obj/machinery/door/airlock/multi_tile/mainship/generic{
	dir = 1;
	name = "\improper Office Complex"
	},
/turf/open/floor,
/area/bigredv3/inside/secondary/office_complex)
"GX" = (
/obj/machinery/atmospherics/pipe/simple/green/hidden{
	dir = 6
	},
/turf/open/floor,
/area/bigredv3/inside/secondary/office_complex)
"Hk" = (
/obj/machinery/door/airlock/mainship/generic{
	dir = 1;
	name = "\improper Private Office"
	},
/obj/machinery/atmospherics/pipe/simple/green/hidden,
/turf/open/floor,
/area/bigredv3/inside/secondary/office_complex)
"HD" = (
/obj/structure/table,
/obj/item/paper,
/obj/machinery/light{
	dir = 8
	},
/turf/open/floor,
/area/bigredv3/inside/secondary/office_complex)
"HK" = (
/obj/structure/table,
/obj/effect/spawner/random/misc/paperbin,
/turf/open/floor,
/area/bigredv3/inside/secondary/office_complex)
"HM" = (
/obj/effect/decal/cleanable/dirt,
/turf/open/floor/tile/dark,
/area/bigredv3/inside/secondary/office_complex)
"HQ" = (
/obj/effect/decal/cleanable/dirt,
/turf/open/floor/tile/whiteyellow/full,
/area/bigredv3/inside/secondary/office_complex)
"Iw" = (
/turf/open/floor/marking/asteroidwarning{
	dir = 6
	},
/area/bigredv3/outside/directions/se)
"IY" = (
/obj/machinery/atmospherics/components/unary/vent_pump,
/turf/open/floor,
/area/bigredv3/inside/secondary/office_complex)
"Jd" = (
/obj/structure/window/framed/colony,
/turf/open/floor/asteroidfloor,
/area/bigredv3/inside/wall)
"Jh" = (
/obj/structure/bed/chair{
	dir = 1
	},
/obj/effect/decal/cleanable/dirt,
/turf/open/floor,
/area/bigredv3/inside/secondary/office_complex)
"Jn" = (
/obj/machinery/light{
	dir = 4
	},
/obj/structure/table,
/obj/item/paper,
/turf/open/floor,
/area/bigredv3/inside/secondary/office_complex)
"Jr" = (
/obj/machinery/atmospherics/pipe/simple/green/hidden{
	dir = 4
	},
/obj/effect/decal/cleanable/dirt,
/obj/effect/ai_node,
/turf/open/floor/tile/red/redtaupecorner,
/area/bigredv3/inside/secondary/office_complex)
"JJ" = (
/obj/structure/table,
/obj/effect/decal/cleanable/dirt,
/obj/item/paper/janitor,
/turf/open/floor/tile/whiteyellow/full,
/area/bigredv3/inside/secondary/office_complex)
"Kn" = (
/obj/machinery/light,
/obj/effect/decal/cleanable/dirt,
/obj/effect/ai_node,
/turf/open/floor/tile/white,
/area/bigredv3/inside/secondary/office_complex)
"Kv" = (
/obj/structure/flora/pottedplant,
/turf/open/floor/wood,
/area/bigredv3/inside/secondary/office_complex)
"KU" = (
/obj/machinery/door/airlock/mainship/generic{
	name = "\improper Private Office"
	},
/turf/open/floor,
/area/bigredv3/inside/secondary/office_complex)
"MN" = (
/obj/machinery/atmospherics/components/unary/vent_pump{
	dir = 1;
	on = 1
	},
/obj/machinery/light{
	dir = 4
	},
/turf/open/floor/tile/red/redtaupecorner,
/area/bigredv3/inside/secondary/office_complex)
"MU" = (
/obj/structure/table,
/turf/open/floor/tile/white,
/area/bigredv3/inside/secondary/office_complex)
"MX" = (
/obj/structure/window/framed/colony,
/obj/machinery/door/poddoor/shutters/mainship{
	id = "Office Complex 1";
	name = "\improper Office Complex Shutters"
	},
/turf/open/floor/plating,
/area/bigredv3/inside/wall)
"NA" = (
/obj/structure/table,
/obj/item/paper,
/turf/open/floor,
/area/bigredv3/inside/secondary/office_complex)
"Ob" = (
/obj/effect/decal/cleanable/dirt,
/turf/open/floor/tile/red/redtaupecorner,
/area/bigredv3/inside/secondary/office_complex)
"Ot" = (
/turf/open/floor/asteroidfloor,
/area/bigredv3/outside/directions/central)
"OJ" = (
/obj/effect/landmark/start/job/survivor,
/obj/effect/landmark/start/latejoinsurvivor,
/turf/open/floor/tile/red/redtaupecorner{
	dir = 8
	},
/area/bigredv3/inside/secondary/office_complex)
"OO" = (
/obj/machinery/atmospherics/pipe/simple/green/hidden{
	dir = 10
	},
/turf/open/floor/tile/red/redtaupecorner,
/area/bigredv3/inside/secondary/office_complex)
"OQ" = (
/obj/machinery/air_alarm{
	dir = 4
	},
/obj/machinery/light{
	dir = 8
	},
/turf/open/floor/tile/red/redtaupecorner{
	dir = 8
	},
/area/bigredv3/inside/secondary/office_complex)
"Pd" = (
/obj/machinery/atmospherics/pipe/simple/green/hidden{
	dir = 4
	},
/obj/structure/cable,
/turf/open/floor/tile/dark,
/area/bigredv3/inside/secondary/office_complex)
"Pg" = (
/obj/structure/bed/chair/comfy/black{
	dir = 8
	},
/turf/open/floor,
/area/bigredv3/inside/secondary/office_complex)
"Pp" = (
/turf/open/floor/plating/ground/mars/random/dirt,
/area/bigredv3/outside/directions/e)
"Qh" = (
/obj/effect/decal/cleanable/dirt,
/obj/machinery/light{
	dir = 4
	},
/turf/open/floor/tile/red/redtaupecorner,
/area/bigredv3/inside/secondary/office_complex)
"Qi" = (
/obj/structure/table,
/obj/machinery/microwave,
/turf/open/floor,
/area/bigredv3/inside/secondary/office_complex)
"QD" = (
/obj/structure/cable,
/obj/machinery/atmospherics/pipe/simple/green/hidden,
/turf/open/floor,
/area/bigredv3/inside/secondary/office_complex)
"QN" = (
/obj/structure/bed/chair/office/light{
	dir = 8
	},
/obj/machinery/light{
	dir = 4
	},
/turf/open/floor/grimy,
/area/bigredv3/inside/secondary/office_complex)
"RF" = (
/obj/structure/bed/chair{
	dir = 4
	},
/turf/open/floor/grimy,
/area/bigredv3/inside/secondary/office_complex)
"Se" = (
/obj/structure/bed/chair/comfy/lime{
	dir = 4
	},
/turf/open/floor,
/area/bigredv3/inside/secondary/office_complex)
"Sh" = (
/obj/effect/decal/cleanable/dirt,
/obj/effect/landmark/start/job/survivor,
/obj/effect/landmark/start/latejoinsurvivor,
/turf/open/floor,
/area/bigredv3/inside/secondary/office_complex)
"Sk" = (
/obj/structure/table,
/obj/item/reagent_containers/food/drinks/flask,
/obj/machinery/light{
	dir = 8
	},
/turf/open/floor/tile/dark,
/area/bigredv3/inside/secondary/office_complex)
"St" = (
/obj/effect/decal/cleanable/dirt,
/turf/open/floor/tile/red/redtaupecorner{
	dir = 8
	},
/area/bigredv3/inside/secondary/office_complex)
"SB" = (
/obj/item/taperecorder,
/turf/open/floor/tile/white,
/area/bigredv3/inside/secondary/office_complex)
"SQ" = (
/turf/open/floor/tile/whiteyellow/full,
/area/bigredv3/inside/secondary/office_complex)
"SX" = (
/obj/machinery/atmospherics/pipe/manifold/green/hidden,
/obj/structure/cable,
/turf/open/floor/tile/red/redtaupecorner,
/area/bigredv3/inside/secondary/office_complex)
"TN" = (
/obj/machinery/atmospherics/pipe/simple/green/hidden,
/turf/open/floor/tile/red/redtaupecorner,
/area/bigredv3/inside/secondary/office_complex)
"Uk" = (
/obj/item/clothing/shoes/galoshes,
/turf/open/floor/tile/whiteyellow/full,
/area/bigredv3/inside/secondary/office_complex)
"UF" = (
/obj/item/mass_spectrometer,
/turf/open/floor/tile/white,
/area/bigredv3/inside/secondary/office_complex)
"UM" = (
/obj/structure/bed/chair{
	dir = 1
	},
/obj/effect/decal/cleanable/dirt,
/obj/structure/sign/prop1,
/turf/open/floor,
/area/bigredv3/inside/secondary/office_complex)
"UT" = (
/turf/open/floor/tile/red/redtaupecorner,
/area/bigredv3/inside/secondary/office_complex)
"Vi" = (
/obj/effect/decal/cleanable/dirt,
/obj/effect/ai_node,
/turf/open/floor,
/area/bigredv3/inside/secondary/office_complex)
"Vp" = (
/obj/effect/decal/cleanable/dirt,
/obj/structure/cable,
/obj/machinery/atmospherics/pipe/simple/green/hidden,
/turf/open/floor,
/area/bigredv3/inside/secondary/office_complex)
"Vx" = (
/obj/machinery/light{
	dir = 4
	},
/obj/structure/bed/chair/office/light{
	dir = 1
	},
/obj/effect/decal/cleanable/dirt,
/turf/open/floor,
/area/bigredv3/inside/secondary/office_complex)
"VM" = (
/turf/open/floor/marking/asteroidwarning{
	dir = 9
	},
/area/bigredv3/outside/directions/central)
"VT" = (
/obj/structure/flora/pottedplant/ten,
/turf/open/floor/wood,
/area/bigredv3/inside/secondary/office_complex)
"VU" = (
/obj/effect/decal/cleanable/dirt,
/turf/open/floor/tile/red/redtaupecorner{
	dir = 4
	},
/area/bigredv3/inside/secondary/office_complex)
"Wr" = (
/obj/effect/decal/cleanable/dirt,
/turf/closed/wall,
/area/bigredv3/inside/wall)
"Wt" = (
/obj/machinery/light{
	dir = 1
	},
/turf/open/floor/tile/red/redtaupecorner{
	dir = 4
	},
/area/bigredv3/inside/secondary/office_complex)
"WC" = (
/obj/machinery/light,
/obj/effect/decal/cleanable/dirt,
/obj/machinery/door/airlock/mainship/generic{
	dir = 1;
	name = "\improper Private Office"
	},
/turf/open/floor,
/area/bigredv3/inside/secondary/office_complex)
"Xw" = (
/obj/machinery/light,
/obj/machinery/atmospherics/pipe/simple/green/hidden{
	dir = 4
	},
/obj/effect/decal/cleanable/dirt,
/obj/structure/cable,
/turf/open/floor/tile/red/redtaupecorner,
/area/bigredv3/inside/secondary/office_complex)
"XD" = (
/obj/machinery/atmospherics/components/unary/vent_pump{
	dir = 1;
	on = 1
	},
/turf/open/floor/tile/whiteyellow/full,
/area/bigredv3/inside/secondary/office_complex)
"XE" = (
/obj/structure/table,
/obj/machinery/computer3/laptop/secure_data,
/turf/open/floor/grimy,
/area/bigredv3/inside/secondary/office_complex)
"Yj" = (
/turf/open/floor/tile/red/redtaupecorner{
	dir = 4
	},
/area/bigredv3/inside/secondary/office_complex)
"Yr" = (
/obj/structure/window/framed/colony,
/obj/machinery/door/poddoor/shutters/mainship{
	dir = 2;
	id = "Office Complex 1";
	name = "\improper Office Complex Shutters"
	},
/turf/open/floor/plating,
/area/bigredv3/inside/wall)
"Yw" = (
/obj/structure/noticeboard{
	dir = 1;
	pixel_y = -27
	},
/obj/effect/decal/cleanable/dirt,
/turf/open/floor/tile/whiteyellow/full,
/area/bigredv3/inside/secondary/office_complex)
"Za" = (
/obj/machinery/atmospherics/pipe/simple/green/hidden,
/obj/effect/decal/cleanable/dirt,
/turf/open/floor/tile/red/redtaupecorner,
/area/bigredv3/inside/secondary/office_complex)
"Zq" = (
/obj/structure/bed/chair/office/light{
	dir = 1
	},
/turf/open/floor,
/area/bigredv3/inside/secondary/office_complex)
"Zt" = (
/obj/machinery/photocopier,
/turf/open/floor/tile/white,
/area/bigredv3/inside/secondary/office_complex)
"ZH" = (
/obj/structure/table,
/obj/item/trash/semki,
/obj/machinery/light{
	dir = 8
	},
/turf/open/floor/tile/dark,
/area/bigredv3/inside/secondary/office_complex)
"ZQ" = (
/obj/machinery/door_control{
	dir = 4;
	id = "Office Complex 1";
	name = "Storm Shutters"
	},
/turf/open/floor/tile/red/redtaupecorner{
	dir = 8
	},
/area/bigredv3/inside/secondary/office_complex)

(1,1,1) = {"
rN
dO
dO
VM
dR
dR
dR
dR
dR
dR
dR
dR
dR
dR
dR
dR
dR
dR
dR
dR
sG
dO
dO
"}
(2,1,1) = {"
rN
dO
dO
tp
Ot
Ot
Ot
Ot
wF
wF
wF
wF
wF
wF
wF
MX
MX
MX
wF
wF
xW
dO
dO
"}
(3,1,1) = {"
rN
dO
dO
tp
Ot
Ot
Ot
Ot
wF
ja
Ce
Zt
fZ
wF
Sk
Ea
iQ
Ea
ZH
wF
xW
dO
dO
"}
(4,1,1) = {"
rN
dO
dO
tp
wF
Wr
Wr
wF
Wr
mO
Co
UF
ja
wF
Ea
lx
HM
HM
yq
Yr
xW
dO
dO
"}
(5,1,1) = {"
rN
dO
dO
tp
wF
yN
HD
Zq
Wr
Co
yF
mO
Kn
wF
iQ
iQ
lR
iQ
iQ
so
dr
dO
dO
"}
(6,1,1) = {"
rN
dO
dO
tp
Jd
sJ
sJ
sJ
WC
ja
oU
jt
SB
wF
bh
HM
iQ
iQ
to
Yr
xW
dO
dO
"}
(7,1,1) = {"
rN
dO
dO
tp
wF
wF
wF
wF
Wr
ja
MU
iy
ja
wF
Pd
iQ
hp
yb
md
wF
nL
dO
dO
"}
(8,1,1) = {"
rN
dO
dO
tp
wF
yN
HD
Zq
wF
KU
wF
wF
wF
wF
xP
wF
wF
wF
wF
wF
Wr
wF
wF
"}
(9,1,1) = {"
rN
dO
dO
tp
Jd
sJ
sJ
sJ
aL
sJ
cK
Se
wF
St
CU
wh
wh
vl
wh
wh
lt
wh
lE
"}
(10,1,1) = {"
iP
dO
dO
tp
wF
wF
Wr
Wr
wF
sJ
AH
sJ
wF
Wt
hw
Ob
Ob
Ob
UT
UT
UT
yO
UT
"}
(11,1,1) = {"
dO
dO
dO
tp
wF
yN
HD
Zq
wF
GX
uA
jR
ag
gS
SX
wF
wF
KU
wF
wF
wF
wF
wF
"}
(12,1,1) = {"
wF
wF
wF
wF
wF
sJ
IY
jR
Hk
BI
Dj
AH
sJ
Yj
Ez
wF
Dt
vp
vp
pM
VT
wF
rq
"}
(13,1,1) = {"
wF
pp
Ba
Qi
wF
wF
wF
wF
wF
wF
wF
wF
wF
VU
Xw
wF
vp
vp
Dt
Dt
vp
Yr
ok
"}
(14,1,1) = {"
lN
QD
QD
QD
lE
lE
lE
ge
zZ
ge
lE
we
lE
Vp
iS
wF
RF
nP
RF
Dt
Dt
wF
ok
"}
(15,1,1) = {"
sJ
sJ
sJ
AH
Ob
Qh
Ob
UT
eA
UT
Ob
Qh
UT
Sh
Jr
wF
XE
EM
dw
vp
vp
Yr
ok
"}
(16,1,1) = {"
Yr
AH
DW
gt
wF
wF
wF
wF
wF
wF
wF
wF
wF
Yj
yH
wF
aE
QN
nP
vp
Kv
wF
ok
"}
(17,1,1) = {"
wF
Bf
kR
Pg
wF
yN
NA
Zq
wF
EO
EO
EX
wF
Wt
Bl
wF
wF
wF
wF
wF
wF
wF
rq
"}
(18,1,1) = {"
wF
wF
wF
wF
wF
sJ
Dj
sJ
aL
AH
sJ
kc
wF
Yj
oY
St
OQ
EF
ZQ
OJ
EF
tJ
rq
"}
(19,1,1) = {"
rl
Es
hB
gz
wF
wF
wF
wF
wF
Vi
sJ
AH
aL
Cl
sL
Za
TN
Za
Za
MN
UT
sJ
rq
"}
(20,1,1) = {"
Pp
Es
hB
hB
Yr
yN
NA
Zq
wF
kj
sJ
UM
wF
Yj
eF
wF
wF
wF
wF
wF
wF
wF
rq
"}
(21,1,1) = {"
eH
Es
hB
hB
wF
sJ
Dj
sJ
aL
sJ
sJ
Jh
wF
Yj
BU
wF
aR
qW
px
nZ
JJ
wF
ok
"}
(22,1,1) = {"
oM
Es
hB
hB
wF
wF
wF
wF
wF
sJ
AH
oD
wF
Yj
Bl
wF
aR
SQ
HQ
HQ
Uk
wF
ok
"}
(23,1,1) = {"
Pp
Es
hB
hB
wF
sJ
sJ
sJ
aL
sJ
AH
kc
wF
Yj
Bl
wF
rL
SQ
HQ
HQ
SQ
aO
ok
"}
(24,1,1) = {"
rl
Es
hB
hB
Yr
yN
Jn
Zq
wF
wF
KU
wF
wF
CN
OO
wX
zw
zw
XD
lQ
HQ
sJ
ok
"}
(25,1,1) = {"
rl
Es
hB
hB
wF
wF
wF
wF
wF
HK
sJ
sJ
wF
Yj
UT
SQ
SQ
HQ
HQ
jc
Yw
wF
rq
"}
(26,1,1) = {"
rl
Es
hB
gz
hB
hB
hB
hB
wF
uH
Vx
AH
wF
Yj
UT
wF
aC
aC
SQ
rK
EZ
wF
rq
"}
(27,1,1) = {"
rl
Es
hB
hB
hB
hB
hB
hB
wF
wF
wF
wF
wF
sJ
GR
wF
wF
wF
wF
wF
wF
wF
rq
"}
(28,1,1) = {"
rl
jS
oM
oM
oM
oM
oM
oM
oM
oM
oM
oM
Az
Az
Az
Az
Az
Az
Az
Az
Az
Az
Iw
"}
