//MAP CONVERTED BY dmm2tgm.py THIS HEADER COMMENT PREVENTS RECONVERSION, DO NOT REMOVE
"aj" = (
/turf/open/floor,
/area/bigredv3/inside/colony/dorm/recreation)
"as" = (
/obj/structure/window/framed/colony,
/obj/machinery/door/poddoor/shutters/mainship{
	dir = 2;
	id = "Dormitories";
	name = "\improper Dormitories Shutters"
	},
/turf/open/floor/plating,
/area/bigredv3/inside/wall)
"aE" = (
/obj/structure/bed,
/turf/open/floor/wood,
/area/bigredv3/inside/colony/dorm)
"bd" = (
/obj/effect/ai_node,
/turf/open/floor/plating/ground/mars/random/sand,
/area/bigredv3/outside/directions/ne)
"bw" = (
/obj/structure/table,
/obj/item/paper/hydroponics,
/turf/open/floor,
/area/bigredv3/inside/colony/hydroponics)
"ca" = (
/obj/machinery/atmospherics/components/unary/vent_pump{
	dir = 8;
	on = 1
	},
/obj/effect/spawner/random/clothing/general,
/turf/open/floor/wood,
/area/bigredv3/inside/colony/dorm)
"ck" = (
/obj/machinery/vending/snack,
/turf/open/floor,
/area/bigredv3/inside/colony/dorm)
"cH" = (
/obj/effect/spawner/random/misc/trash,
/obj/machinery/light{
	dir = 8
	},
/turf/open/floor,
/area/bigredv3/inside/colony/dorm)
"dU" = (
/obj/machinery/washing_machine,
/turf/open/floor/freezer,
/area/bigredv3/inside/colony/dorm)
"fe" = (
/obj/structure/cable,
/obj/machinery/atmospherics/pipe/simple/green/hidden,
/turf/open/floor/asteroidfloor,
/area/bigredv3/outside/directions/ne)
"fo" = (
/obj/structure/cable,
/obj/machinery/atmospherics/pipe/simple/green/hidden{
	dir = 4
	},
/turf/open/floor/asteroidfloor,
/area/bigredv3/outside/directions/ne)
"fq" = (
/obj/structure/table,
/obj/effect/decal/cleanable/dirt,
/obj/effect/spawner/random/food_or_drink/kitchen,
/turf/open/floor/wood,
/area/bigredv3/inside/colony/dorm)
"fW" = (
/turf/open/floor/plating/ground/mars/random/sand,
/area/bigredv3/caves/northeast/garbledradio)
"gm" = (
/obj/machinery/light,
/obj/effect/decal/cleanable/dirt,
/obj/structure/cable,
/turf/open/floor,
/area/bigredv3/inside/colony/dorm)
"hc" = (
/obj/effect/ai_node,
/obj/structure/cable,
/turf/open/floor,
/area/bigredv3/inside/colony/dorm)
"ih" = (
/obj/machinery/light{
	dir = 8
	},
/turf/open/floor/plating,
/area/bigredv3/inside/secondary/maintence)
"ir" = (
/obj/machinery/light{
	dir = 1
	},
/obj/effect/decal/cleanable/dirt,
/turf/open/floor,
/area/bigredv3/inside/colony/dorm)
"iw" = (
/obj/machinery/atmospherics/pipe/manifold/green/hidden,
/turf/open/floor,
/area/bigredv3/inside/colony/dorm/recreation)
"iD" = (
/obj/structure/table,
/obj/structure/bedsheetbin,
/turf/open/floor/freezer,
/area/bigredv3/inside/colony/dorm)
"iP" = (
/obj/structure/table,
/obj/item/paper,
/obj/item/paper,
/obj/item/tool/pen/invisible,
/turf/open/floor/wood,
/area/bigredv3/inside/colony/dorm)
"iV" = (
/obj/structure/table,
/turf/open/floor,
/area/bigredv3/inside/colony/hydroponics)
"jq" = (
/obj/structure/closet/toolcloset,
/turf/open/floor,
/area/bigredv3/inside/colony/dorm)
"jZ" = (
/obj/machinery/atmospherics/pipe/simple/green/hidden{
	dir = 4
	},
/obj/structure/cable,
/turf/open/floor/plating,
/area/bigredv3/inside/secondary/maintence)
"ko" = (
/obj/item/clothing/under/darkred,
/turf/open/floor/freezer,
/area/bigredv3/inside/colony/dorm)
"lb" = (
/turf/open/floor/asteroidfloor,
/area/bigredv3/caves/northeast/garbledradio)
"lf" = (
/obj/effect/landmark/lv624/fog_blocker,
/turf/open/floor/plating/ground/mars/random/sand,
/area/bigredv3/caves/northeast/garbledradio)
"lo" = (
/obj/machinery/washing_machine,
/obj/item/clothing/under/darkred,
/turf/open/floor/freezer,
/area/bigredv3/inside/colony/dorm)
"lC" = (
/obj/effect/ai_node,
/turf/open/floor/plating/ground/mars/random/dirt,
/area/bigredv3/caves/northeast/garbledradio)
"mm" = (
/obj/machinery/atmospherics/pipe/manifold/green/hidden{
	dir = 4
	},
/turf/open/floor,
/area/bigredv3/inside/colony/dorm/recreation)
"mn" = (
/obj/effect/decal/cleanable/dirt,
/turf/open/floor/asteroidfloor,
/area/bigredv3/outside/directions/ne)
"mq" = (
/obj/machinery/light{
	dir = 1
	},
/turf/open/floor/plating,
/area/bigredv3/inside/secondary/maintence)
"nj" = (
/obj/machinery/atmospherics/pipe/simple/green/hidden{
	dir = 4
	},
/turf/open/floor/wood,
/area/bigredv3/inside/colony/dorm)
"nx" = (
/turf/open/floor/marking/asteroidwarning,
/area/bigredv3/outside/directions/ne)
"nP" = (
/obj/structure/cable,
/turf/open/floor/plating,
/area/bigredv3/inside/secondary/maintence)
"ph" = (
/turf/closed/wall/r_wall,
/area/bigredv3/inside/wall)
"pp" = (
/obj/machinery/atmospherics/pipe/manifold4w/green/hidden,
/obj/effect/decal/cleanable/blood/oil,
/turf/open/floor,
/area/bigredv3/inside/colony/dorm)
"ps" = (
/obj/machinery/atmospherics/pipe/manifold4w/green/hidden,
/turf/open/floor,
/area/bigredv3/inside/colony/dorm)
"pP" = (
/obj/machinery/light{
	dir = 1
	},
/turf/open/floor,
/area/bigredv3/inside/colony/dorm)
"pU" = (
/obj/machinery/vending/hydronutrients,
/turf/open/floor,
/area/bigredv3/inside/colony/hydroponics)
"qk" = (
/obj/machinery/light{
	dir = 8
	},
/obj/structure/cable,
/obj/machinery/atmospherics/pipe/simple/green/hidden,
/turf/open/floor/asteroidfloor,
/area/bigredv3/outside/directions/ne)
"qr" = (
/obj/item/clothing/under/brown,
/turf/open/floor/freezer,
/area/bigredv3/inside/colony/dorm)
"qt" = (
/turf/open/floor/marking/asteroidwarning{
	dir = 4
	},
/area/bigredv3/outside/directions/ne)
"qB" = (
/obj/machinery/vending/hydroseeds,
/turf/open/floor,
/area/bigredv3/inside/colony/hydroponics)
"qG" = (
/obj/structure/rack,
/obj/effect/spawner/random/engineering/toolbox,
/turf/open/floor,
/area/bigredv3/inside/colony/dorm)
"qM" = (
/obj/machinery/atmospherics/pipe/simple/green/hidden{
	dir = 4
	},
/turf/open/floor/freezer,
/area/bigredv3/inside/colony/dorm)
"qX" = (
/obj/structure/bed/chair{
	dir = 1
	},
/turf/open/floor,
/area/bigredv3/inside/colony/dorm/recreation)
"rT" = (
/turf/open/floor/plating/ground/mars/random/sand,
/area/bigredv3/outside/directions/ne)
"sa" = (
/obj/machinery/atmospherics/pipe/simple/green/hidden,
/turf/open/floor,
/area/bigredv3/inside/colony/dorm)
"sB" = (
/turf/closed/wall,
/area/bigredv3/inside/wall)
"sR" = (
/obj/effect/decal/cleanable/dirt,
/turf/open/floor/marking/asteroidwarning{
	dir = 1
	},
/area/bigredv3/caves/northeast/garbledradio)
"tp" = (
/obj/machinery/atmospherics/pipe/simple/green/hidden{
	dir = 4
	},
/obj/structure/cable,
/turf/open/floor,
/area/bigredv3/inside/colony/dorm)
"tZ" = (
/obj/machinery/atmospherics/pipe/simple/green/hidden{
	dir = 9
	},
/turf/open/floor,
/area/bigredv3/inside/colony/dorm)
"ul" = (
/obj/structure/rack,
/obj/effect/spawner/random/engineering/tool,
/obj/effect/spawner/random/engineering/tool,
/turf/open/floor,
/area/bigredv3/inside/colony/dorm)
"um" = (
/obj/structure/table,
/turf/open/floor/wood,
/area/bigredv3/inside/colony/dorm)
"us" = (
/obj/machinery/atmospherics/pipe/manifold/green/hidden{
	dir = 4
	},
/obj/structure/cable,
/obj/effect/ai_node,
/turf/open/floor/asteroidfloor,
/area/bigredv3/outside/directions/ne)
"uL" = (
/turf/open/floor/wood,
/area/bigredv3/inside/colony/dorm)
"uU" = (
/obj/effect/decal/cleanable/dirt,
/turf/open/floor/wood,
/area/bigredv3/inside/colony/dorm)
"uX" = (
/obj/effect/decal/cleanable/dirt,
/obj/effect/decal/cleanable/dirt,
/turf/open/floor/asteroidfloor,
/area/bigredv3/caves/northeast/garbledradio)
"va" = (
/obj/structure/bed/chair{
	dir = 8
	},
/turf/open/floor,
/area/bigredv3/inside/colony/dorm/recreation)
"vP" = (
/obj/structure/closet/secure_closet/personal/cabinet,
/obj/effect/spawner/random/clothing/general,
/obj/machinery/light/small{
	dir = 4
	},
/turf/open/floor/wood,
/area/bigredv3/inside/colony/dorm)
"wi" = (
/obj/machinery/light{
	dir = 8
	},
/turf/open/floor,
/area/bigredv3/inside/colony/dorm)
"wA" = (
/turf/open/floor/freezer,
/area/bigredv3/inside/colony/dorm)
"wB" = (
/turf/open/floor/plating/ground/mars/random/sand,
/area/bigredv3/outside/directions/n)
"wH" = (
/obj/machinery/atmospherics/pipe/simple/green/hidden,
/obj/effect/decal/cleanable/dirt,
/turf/open/floor,
/area/bigredv3/inside/colony/dorm)
"xj" = (
/obj/machinery/door/airlock/multi_tile/mainship/generic{
	name = "\improper Dormitories Tool Storage"
	},
/turf/open/floor,
/area/bigredv3/inside/colony/dorm)
"xs" = (
/obj/machinery/atmospherics/pipe/simple/green/hidden,
/obj/structure/cable,
/turf/open/floor/tile/green/whitegreenfull,
/area/bigredv3/inside/colony/hydroponics)
"xt" = (
/obj/structure/cable,
/obj/machinery/atmospherics/pipe/simple/green/hidden{
	dir = 4
	},
/obj/effect/decal/cleanable/dirt,
/turf/open/floor/asteroidfloor,
/area/bigredv3/outside/directions/ne)
"ye" = (
/obj/machinery/atmospherics/pipe/simple/green/hidden{
	dir = 4
	},
/obj/item/paper/crumpled/bloody,
/turf/open/floor/wood,
/area/bigredv3/inside/colony/dorm)
"yn" = (
/obj/structure/table,
/obj/effect/decal/cleanable/dirt,
/turf/open/floor/wood,
/area/bigredv3/inside/colony/dorm)
"yG" = (
/obj/effect/landmark/lv624/fog_blocker,
/turf/closed/mineral/smooth/bigred,
/area/bigredv3/caves/rock)
"yS" = (
/turf/closed/mineral/smooth/bigred,
/area/bigredv3/caves/rock)
"zO" = (
/obj/effect/spawner/random/clothing/general,
/obj/effect/decal/cleanable/dirt,
/obj/structure/bed/chair/wood{
	dir = 4
	},
/turf/open/floor/wood,
/area/bigredv3/inside/colony/dorm)
"zY" = (
/obj/machinery/vending/tool,
/turf/open/floor,
/area/bigredv3/inside/colony/dorm)
"AS" = (
/obj/structure/cable,
/obj/machinery/atmospherics/pipe/simple/green/hidden{
	dir = 4
	},
/obj/machinery/door/airlock/mainship/maint/free_access{
	name = "\improper Bar Maintenance"
	},
/turf/open/floor/plating,
/area/bigredv3/inside/secondary/maintence)
"Bh" = (
/obj/structure/bed,
/obj/effect/spawner/random/clothing/general,
/turf/open/floor/wood,
/area/bigredv3/inside/colony/dorm)
"Bk" = (
/obj/structure/window/framed/colony,
/obj/machinery/door/poddoor/shutters/mainship{
	dir = 2;
	id = "Greenhouse";
	name = "\improper Greenhouse Shutters"
	},
/turf/open/floor/plating,
/area/bigredv3/inside/wall)
"Bq" = (
/obj/effect/ai_node,
/turf/open/floor,
/area/bigredv3/inside/colony/dorm)
"BD" = (
/obj/structure/table,
/obj/effect/spawner/random/engineering/toolbox,
/obj/machinery/atmospherics/components/unary/vent_pump,
/turf/open/floor,
/area/bigredv3/inside/colony/dorm)
"BK" = (
/obj/effect/decal/cleanable/dirt,
/obj/structure/cable,
/turf/open/floor,
/area/bigredv3/inside/colony/dorm)
"Cd" = (
/obj/effect/decal/cleanable/dirt,
/obj/machinery/atmospherics/pipe/simple/green/hidden{
	dir = 6
	},
/obj/effect/ai_node,
/turf/open/floor,
/area/bigredv3/inside/colony/dorm)
"CD" = (
/obj/machinery/door/airlock/mainship/medical/glass/free_access{
	name = "\improper Dormitories Lavatory"
	},
/obj/machinery/atmospherics/pipe/simple/green/hidden{
	dir = 4
	},
/turf/open/floor/freezer,
/area/bigredv3/inside/colony/dorm)
"CJ" = (
/obj/machinery/vending/engivend,
/turf/open/floor,
/area/bigredv3/inside/colony/dorm)
"Dw" = (
/obj/machinery/light{
	dir = 1
	},
/turf/open/floor,
/area/bigredv3/inside/colony/dorm/recreation)
"DX" = (
/obj/machinery/door/airlock/mainship/maint/free_access{
	dir = 1;
	name = "\improper Dormitories Tool Storage Maintenance"
	},
/obj/structure/cable,
/turf/open/floor/plating,
/area/bigredv3/inside/secondary/maintence)
"Ef" = (
/obj/machinery/atmospherics/components/unary/vent_pump{
	dir = 8;
	on = 1
	},
/obj/effect/ai_node,
/turf/open/floor/freezer,
/area/bigredv3/inside/colony/dorm)
"Es" = (
/obj/machinery/atmospherics/pipe/simple/green/hidden{
	dir = 4
	},
/turf/open/floor,
/area/bigredv3/inside/colony/dorm/recreation)
"Ex" = (
/turf/open/floor/plating,
/area/bigredv3/inside/secondary/maintence)
"Ey" = (
/turf/open/floor/plating/ground/mars/random/dirt,
/area/bigredv3/outside/directions/ne)
"EF" = (
/obj/structure/cable,
/turf/open/floor,
/area/bigredv3/inside/colony/dorm)
"EP" = (
/obj/effect/decal/cleanable/dirt,
/turf/open/floor/asteroidfloor,
/area/bigredv3/caves/northeast/garbledradio)
"EU" = (
/turf/open/floor/plating/ground/mars/dirttosand/autosmooth{
	dir = 8
	},
/area/bigredv3/caves/northeast/garbledradio)
"FO" = (
/obj/effect/decal/cleanable/dirt,
/obj/machinery/atmospherics/pipe/simple/green/hidden{
	dir = 9
	},
/turf/open/floor,
/area/bigredv3/inside/colony/dorm)
"Gb" = (
/obj/machinery/atmospherics/pipe/simple/green/hidden{
	dir = 9
	},
/obj/structure/cable,
/obj/effect/ai_node,
/turf/open/floor,
/area/bigredv3/inside/colony/dorm)
"Go" = (
/turf/open/floor/plating/ground/mars/dirttosand/autosmooth{
	dir = 10
	},
/area/bigredv3/outside/directions/ne)
"GG" = (
/obj/machinery/atmospherics/pipe/manifold/green/hidden{
	dir = 1
	},
/turf/open/floor,
/area/bigredv3/inside/colony/dorm)
"GV" = (
/obj/structure/closet/secure_closet/personal/cabinet,
/obj/machinery/light/small{
	dir = 4
	},
/turf/open/floor/wood,
/area/bigredv3/inside/colony/dorm)
"Hh" = (
/obj/machinery/vending/cola,
/turf/open/floor,
/area/bigredv3/inside/colony/dorm)
"Hm" = (
/obj/structure/window/framed/colony,
/turf/open/floor/plating,
/area/bigredv3/inside/wall)
"Hw" = (
/obj/machinery/door/airlock/mainship/generic{
	dir = 1;
	name = "\improper Dormitories Bedroom"
	},
/turf/open/floor/wood,
/area/bigredv3/inside/colony/dorm)
"HK" = (
/obj/structure/cable,
/obj/machinery/atmospherics/pipe/simple/green/hidden{
	dir = 4
	},
/obj/effect/ai_node,
/turf/open/floor/asteroidfloor,
/area/bigredv3/outside/directions/ne)
"HV" = (
/obj/structure/cable,
/obj/machinery/atmospherics/pipe/simple/green/hidden,
/obj/machinery/door/airlock/multi_tile/mainship/generic{
	name = "\improper Dormitories"
	},
/turf/open/floor,
/area/bigredv3/inside/colony/dorm)
"HX" = (
/obj/machinery/washing_machine,
/obj/machinery/light,
/turf/open/floor/freezer,
/area/bigredv3/inside/colony/dorm)
"IW" = (
/obj/machinery/floodlight/outpost/bigred,
/turf/open/floor/plating/ground/mars/random/sand,
/area/bigredv3/outside/directions/ne)
"Kt" = (
/obj/effect/decal/cleanable/blood/oil,
/turf/open/floor,
/area/bigredv3/inside/colony/dorm)
"Kz" = (
/obj/machinery/hydroponics,
/turf/open/floor/tile/green/whitegreenfull,
/area/bigredv3/inside/colony/hydroponics)
"KI" = (
/obj/effect/decal/cleanable/dirt,
/obj/machinery/atmospherics/pipe/simple/green/hidden,
/turf/open/floor,
/area/bigredv3/inside/colony/dorm)
"Lm" = (
/obj/machinery/light{
	dir = 8
	},
/turf/open/floor/wood,
/area/bigredv3/inside/colony/dorm)
"Lo" = (
/obj/structure/closet/secure_closet/personal/cabinet,
/obj/effect/spawner/random/clothing/hats,
/obj/machinery/light/small{
	dir = 4
	},
/turf/open/floor/wood,
/area/bigredv3/inside/colony/dorm)
"Lu" = (
/obj/structure/bed/fancy,
/turf/open/floor/wood,
/area/bigredv3/inside/colony/dorm)
"LV" = (
/turf/open/floor,
/area/bigredv3/inside/colony/dorm)
"Mj" = (
/turf/open/floor,
/area/bigredv3/inside/colony/hydroponics)
"Ms" = (
/obj/machinery/atmospherics/pipe/simple/green/hidden{
	dir = 4
	},
/obj/effect/decal/cleanable/dirt,
/turf/open/floor,
/area/bigredv3/inside/colony/dorm)
"ME" = (
/obj/machinery/atmospherics/pipe/simple/green/hidden,
/obj/structure/cable,
/obj/machinery/door/airlock/mainship/medical/glass/free_access{
	dir = 1;
	name = "\improper Greenhouse"
	},
/turf/open/floor,
/area/bigredv3/inside/colony/hydroponics)
"MJ" = (
/obj/machinery/atmospherics/components/unary/vent_pump{
	dir = 4;
	on = 1
	},
/obj/effect/decal/cleanable/dirt,
/turf/open/floor/wood,
/area/bigredv3/inside/colony/dorm)
"Nf" = (
/obj/machinery/atmospherics/pipe/manifold/green/hidden,
/obj/effect/ai_node,
/obj/structure/cable,
/turf/open/floor,
/area/bigredv3/inside/colony/dorm)
"ND" = (
/obj/effect/decal/cleanable/blood/oil,
/obj/machinery/light{
	dir = 4
	},
/turf/open/floor,
/area/bigredv3/inside/colony/dorm)
"Oj" = (
/obj/machinery/door/airlock/mainship/generic{
	name = "\improper Dormitories Bedroom"
	},
/obj/machinery/atmospherics/pipe/simple/green/hidden{
	dir = 4
	},
/turf/open/floor,
/area/bigredv3/inside/colony/dorm)
"Oy" = (
/obj/structure/table,
/obj/effect/spawner/random/clothing/general,
/turf/open/floor/wood,
/area/bigredv3/inside/colony/dorm)
"OG" = (
/obj/structure/cable,
/obj/effect/ai_node,
/turf/open/floor/plating,
/area/bigredv3/inside/secondary/maintence)
"OP" = (
/obj/structure/table,
/obj/effect/spawner/random/engineering/technology_scanner,
/obj/effect/spawner/random/engineering/technology_scanner,
/turf/open/floor,
/area/bigredv3/inside/colony/dorm)
"Pq" = (
/obj/machinery/atmospherics/pipe/simple/green/hidden{
	dir = 4
	},
/turf/open/floor,
/area/bigredv3/inside/colony/dorm)
"Ps" = (
/turf/open/floor/marking/asteroidwarning{
	dir = 9
	},
/area/bigredv3/caves/northeast/garbledradio)
"Pw" = (
/obj/machinery/atmospherics/components/unary/vent_pump{
	dir = 4;
	on = 1
	},
/turf/open/floor/wood,
/area/bigredv3/inside/colony/dorm)
"PA" = (
/obj/machinery/light,
/turf/open/floor,
/area/bigredv3/inside/colony/dorm)
"Qs" = (
/obj/structure/table,
/turf/open/floor,
/area/bigredv3/inside/colony/dorm/recreation)
"QQ" = (
/obj/machinery/atmospherics/pipe/simple/green/hidden{
	dir = 6
	},
/turf/open/floor,
/area/bigredv3/inside/colony/dorm/recreation)
"Rq" = (
/obj/effect/decal/cleanable/dirt,
/obj/machinery/atmospherics/pipe/simple/green/hidden,
/obj/structure/cable,
/turf/open/floor,
/area/bigredv3/inside/colony/dorm)
"RA" = (
/obj/structure/bed/fancy,
/obj/effect/spawner/random/clothing/general,
/obj/effect/spawner/random/clothing/hats,
/turf/open/floor/wood,
/area/bigredv3/inside/colony/dorm)
"Sd" = (
/obj/machinery/atmospherics/pipe/simple/green/hidden,
/turf/open/floor,
/area/bigredv3/inside/colony/dorm/recreation)
"Sj" = (
/obj/effect/ai_node,
/turf/open/floor/plating/ground/mars/random/sand,
/area/bigredv3/caves/northeast/garbledradio)
"St" = (
/obj/machinery/power/apc/weak/ntf{
	dir = 4
	},
/obj/structure/cable,
/turf/open/floor/plating,
/area/bigredv3/inside/secondary/maintence)
"Sy" = (
/turf/open/floor/asteroidfloor,
/area/bigredv3/outside/directions/ne)
"SG" = (
/obj/structure/table,
/obj/effect/spawner/random/engineering/toolbox,
/obj/item/stack/cable_coil,
/turf/open/floor,
/area/bigredv3/inside/colony/dorm)
"SH" = (
/obj/machinery/atmospherics/pipe/simple/green/hidden{
	dir = 4
	},
/obj/effect/decal/cleanable/blood/oil,
/turf/open/floor,
/area/bigredv3/inside/colony/dorm)
"SP" = (
/obj/item/clothing/under/lightbrown,
/turf/open/floor/freezer,
/area/bigredv3/inside/colony/dorm)
"SU" = (
/obj/structure/table,
/obj/item/tool/shovel/spade,
/turf/open/floor,
/area/bigredv3/inside/colony/hydroponics)
"SV" = (
/turf/open/floor/marking/asteroidwarning{
	dir = 1
	},
/area/bigredv3/caves/northeast/garbledradio)
"TI" = (
/turf/open/floor/plating/ground/mars/random/dirt,
/area/bigredv3/caves/northeast/garbledradio)
"Ub" = (
/obj/structure/window/framed/colony,
/obj/machinery/door/poddoor/shutters/mainship{
	id = "Greenhouse";
	name = "\improper Greenhouse Shutters"
	},
/turf/open/floor/plating,
/area/bigredv3/inside/wall)
"Uf" = (
/obj/machinery/washing_machine,
/obj/item/clothing/under/brown,
/turf/open/floor/freezer,
/area/bigredv3/inside/colony/dorm)
"Ug" = (
/obj/machinery/washing_machine,
/obj/item/clothing/under/lightbrown,
/turf/open/floor/freezer,
/area/bigredv3/inside/colony/dorm)
"Uy" = (
/obj/machinery/vending/cigarette/colony,
/turf/open/floor,
/area/bigredv3/inside/colony/dorm)
"US" = (
/obj/structure/table,
/obj/effect/spawner/random/food_or_drink/drink_alcohol_bottle,
/turf/open/floor/wood,
/area/bigredv3/inside/colony/dorm)
"Vo" = (
/obj/machinery/atmospherics/components/unary/vent_pump{
	dir = 8;
	on = 1
	},
/turf/open/floor/wood,
/area/bigredv3/inside/colony/dorm)
"VW" = (
/obj/machinery/light{
	dir = 4
	},
/turf/open/floor,
/area/bigredv3/inside/colony/dorm)
"Wm" = (
/obj/effect/decal/cleanable/dirt,
/turf/open/floor,
/area/bigredv3/inside/colony/dorm)
"Wn" = (
/obj/structure/table,
/obj/item/flashlight/lamp/green,
/turf/open/floor/wood,
/area/bigredv3/inside/colony/dorm)
"Xv" = (
/obj/structure/bed,
/obj/effect/decal/cleanable/dirt,
/obj/effect/spawner/random/food_or_drink/outdoors_snacks,
/turf/open/floor/wood,
/area/bigredv3/inside/colony/dorm)
"Xy" = (
/obj/machinery/door/airlock/mainship/maint/free_access{
	dir = 1;
	name = "\improper Dormitories Tool Storage Maintenance"
	},
/turf/open/floor/plating,
/area/bigredv3/inside/secondary/maintence)
"Xz" = (
/turf/open/floor/plating/ground/mars/dirttosand/autosmooth,
/area/bigredv3/outside/directions/ne)
"XF" = (
/obj/machinery/atmospherics/components/unary/vent_pump{
	dir = 4;
	on = 1
	},
/obj/effect/spawner/random/clothing/general,
/obj/effect/decal/cleanable/dirt,
/turf/open/floor/wood,
/area/bigredv3/inside/colony/dorm)
"XZ" = (
/obj/structure/sign/safety/EVA{
	dir = 1
	},
/turf/open/floor,
/area/bigredv3/inside/colony/dorm)
"Yn" = (
/obj/effect/ai_node,
/turf/open/floor/marking/asteroidwarning{
	dir = 6
	},
/area/bigredv3/outside/directions/ne)
"YL" = (
/obj/structure/closet/secure_closet/personal/cabinet,
/obj/machinery/light/small{
	dir = 8
	},
/turf/open/floor/wood,
/area/bigredv3/inside/colony/dorm)
"YO" = (
/obj/machinery/atmospherics/pipe/simple/green/hidden,
/obj/structure/cable,
/turf/open/floor,
/area/bigredv3/inside/colony/dorm)
"YX" = (
/obj/structure/rack,
/obj/effect/spawner/random/engineering/tool,
/obj/effect/spawner/random/engineering/tool,
/obj/effect/spawner/random/engineering/tool,
/turf/open/floor,
/area/bigredv3/inside/colony/dorm)
"Zd" = (
/obj/machinery/atmospherics/pipe/manifold/green/hidden{
	dir = 1
	},
/obj/structure/cable,
/obj/effect/ai_node,
/turf/open/floor,
/area/bigredv3/inside/colony/dorm)
"Zy" = (
/obj/machinery/washing_machine,
/obj/item/clothing/under/lightred,
/turf/open/floor/freezer,
/area/bigredv3/inside/colony/dorm)

(1,1,1) = {"
wB
wB
as
aj
aj
QQ
Sd
mm
Sd
Sd
Sd
Sd
Sd
Sd
iw
aj
aj
qX
sB
mq
jZ
Ex
Ex
sB
"}
(2,1,1) = {"
wB
wB
sB
sB
sB
CD
sB
sB
sB
sB
sB
sB
sB
Dw
Es
aj
va
Qs
sB
Ex
jZ
Ex
Ex
sB
"}
(3,1,1) = {"
wB
wB
sB
lo
wA
qM
wA
Ug
sB
YX
ul
ul
sB
LV
Pq
LV
sB
sB
sB
sB
AS
sB
sB
sB
"}
(4,1,1) = {"
wB
wB
sB
dU
wA
qM
wA
dU
sB
pP
Wm
LV
sB
Wm
Pq
LV
Hw
uL
Lm
sB
xt
nx
Ey
sB
"}
(5,1,1) = {"
wB
wB
sB
dU
wA
qM
wA
Uf
sB
LV
Wm
LV
sB
Wm
Pq
LV
sB
um
aE
sB
xt
nx
Ey
sB
"}
(6,1,1) = {"
wB
wB
sB
dU
ko
Ef
wA
HX
sB
CJ
Wm
LV
sB
Wm
Pq
PA
sB
sB
sB
sB
xt
nx
Ey
sB
"}
(7,1,1) = {"
yS
yS
sB
dU
wA
iD
qr
dU
sB
zY
LV
LV
xj
LV
Pq
LV
Hw
uL
Lm
sB
xt
nx
Ey
sB
"}
(8,1,1) = {"
yG
yS
sB
Uf
SP
iD
wA
dU
sB
SG
Cd
Rq
YO
YO
Nf
LV
sB
um
aE
sB
fo
nx
Xz
rT
"}
(9,1,1) = {"
yS
yG
sB
dU
wA
wA
wA
Zy
sB
BD
FO
BK
sB
LV
tp
LV
sB
sB
sB
sB
HK
nx
Ey
Go
"}
(10,1,1) = {"
yS
yG
sB
sB
sB
sB
sB
sB
sB
jq
Wm
gm
sB
Wm
tp
LV
Hw
uL
Lm
sB
xt
nx
Ey
Xz
"}
(11,1,1) = {"
fW
lf
fW
sB
St
ih
Ex
Ex
sB
jq
Wm
BK
sB
Wm
tp
LV
sB
um
aE
sB
xt
nx
sB
Ub
"}
(12,1,1) = {"
Sj
lf
fW
Xy
OG
nP
nP
nP
DX
EF
hc
EF
sB
Wm
tp
PA
sB
sB
sB
sB
fo
nx
Bk
Kz
"}
(13,1,1) = {"
fW
lf
Ps
sB
sB
sB
sB
sB
sB
sB
sB
sB
sB
ir
Zd
YO
HV
fe
qk
fe
us
fe
ME
xs
"}
(14,1,1) = {"
fW
lf
sR
sB
YL
RA
sB
YL
Lu
sB
YL
Lu
sB
LV
tp
Bq
LV
Sy
Sy
mn
qt
Yn
sB
Kz
"}
(15,1,1) = {"
fW
lf
sR
sB
uL
MJ
sB
zO
Pw
sB
uL
XF
sB
XZ
tp
LV
sB
sB
sB
sB
rT
rT
Bk
Kz
"}
(16,1,1) = {"
fW
lf
SV
sB
Oy
nj
sB
Wn
nj
sB
fq
nj
sB
LV
tp
LV
Hw
uL
Lm
sB
rT
rT
Bk
Kz
"}
(17,1,1) = {"
EU
yG
EP
sB
sB
Oj
sB
sB
Oj
sB
sB
Oj
sB
LV
Gb
LV
sB
um
aE
sB
rT
IW
sB
Kz
"}
(18,1,1) = {"
TI
yG
EP
sB
LV
Pq
cH
Wm
Pq
wi
Wm
SH
wi
Wm
Pq
Kt
sB
sB
sB
sB
rT
rT
Bk
Kz
"}
(19,1,1) = {"
TI
yG
EP
sB
qG
GG
wH
wH
pp
wH
sa
ps
wH
KI
tZ
LV
Hw
uL
Lm
sB
rT
rT
Bk
Kz
"}
(20,1,1) = {"
lC
yG
lb
sB
OP
Ms
ND
Wm
Pq
VW
Wm
Pq
VW
LV
LV
PA
sB
um
aE
sB
rT
rT
sB
Hm
"}
(21,1,1) = {"
TI
yG
lb
ph
sB
Oj
sB
sB
Oj
sB
sB
Oj
ph
Wm
LV
LV
sB
sB
sB
sB
rT
bd
sB
pU
"}
(22,1,1) = {"
yS
yG
lb
ph
iP
nj
sB
yn
ye
sB
US
nj
ph
Wm
LV
LV
sB
yS
rT
rT
rT
rT
sB
qB
"}
(23,1,1) = {"
yS
yG
EP
ph
uU
Vo
sB
uL
Vo
sB
uL
ca
ph
Wm
Kt
LV
sB
yS
rT
rT
IW
rT
sB
iV
"}
(24,1,1) = {"
yS
yG
lb
ph
vP
aE
sB
GV
Bh
sB
Lo
Xv
ph
Wm
LV
LV
sB
yS
yS
rT
rT
rT
sB
SU
"}
(25,1,1) = {"
yS
yG
EP
ph
ph
ph
ph
ph
ph
ph
ph
ph
ph
pP
LV
LV
sB
yS
yS
rT
rT
rT
sB
bw
"}
(26,1,1) = {"
yS
yG
lb
EP
lb
EP
lb
lb
EP
uX
EP
lb
ph
Hh
Uy
ck
sB
yS
yS
rT
rT
rT
sB
Mj
"}
