//MAP CONVERTED BY dmm2tgm.py THIS HEADER COMMENT PREVENTS RECONVERSION, DO NOT REMOVE
"ah" = (
/obj/machinery/atmospherics/pipe/simple/green/hidden{
	dir = 4
	},
/obj/structure/cable,
/turf/open/floor/marking/asteroidwarning{
	dir = 8
	},
/area/bigredv3/outside/directions/nw)
"at" = (
/obj/effect/ai_node,
/turf/open/floor/marking/asteroidwarning{
	dir = 8
	},
/area/bigredv3/outside/directions/nw)
"aQ" = (
/obj/effect/decal/cleanable/dirt,
/turf/open/floor/plating/warning{
	dir = 8
	},
/area/bigredv3/outside/directions/nw)
"cd" = (
/obj/structure/fence/standard/xenoproof,
/turf/open/floor/plating/ground/mars/random/cave,
/area/bigredv3/caves/west)
"cJ" = (
/obj/machinery/atmospherics/pipe/simple/green/hidden{
	dir = 4
	},
/obj/structure/cable,
/turf/open/floor/plating,
/area/bigredv3/outside/directions/nw)
"cN" = (
/obj/effect/decal/cleanable/dirt,
/obj/effect/ai_node,
/turf/open/floor/marking/asteroidwarning{
	dir = 9
	},
/area/bigredv3/outside/directions/nw)
"dx" = (
/turf/open/floor/plating/ground/mars/dirttosand/autosmooth{
	dir = 9
	},
/area/bigredv3/outside/directions/nw)
"eF" = (
/obj/effect/ai_node,
/turf/open/floor/marking/asteroidwarning{
	dir = 9
	},
/area/bigredv3/outside/directions/nw)
"eM" = (
/obj/effect/decal/cleanable/dirt,
/turf/open/floor/plating,
/area/bigredv3/outside/directions/nw)
"eQ" = (
/obj/effect/ai_node,
/turf/open/floor/marking/asteroidwarning{
	dir = 1
	},
/area/bigredv3/outside/medical/virology)
"eS" = (
/obj/structure/rack,
/obj/effect/spawner/random/engineering/tool,
/obj/effect/spawner/random/engineering/tool,
/turf/open/floor/plating,
/area/bigredv3/outside/directions/nw)
"fw" = (
/turf/open/floor/marking/asteroidwarning{
	dir = 9
	},
/area/bigredv3/outside/directions/nw)
"fB" = (
/obj/effect/ai_node,
/turf/open/floor/plating/ground/mars/random/cave,
/area/bigredv3/caves/west)
"fN" = (
/obj/machinery/floodlight/outpost/bigred,
/turf/open/floor/plating/ground/mars/dirttosand/autosmooth{
	dir = 4
	},
/area/bigredv3/outside/directions/nw)
"fQ" = (
/obj/structure/cargo_container/green{
	dir = 4
	},
/turf/open/floor/plating,
/area/bigredv3/outside/directions/nw)
"gc" = (
/obj/effect/decal/cleanable/dirt,
/turf/open/floor/marking/asteroidwarning{
	dir = 6
	},
/area/bigredv3/outside/directions/nw)
"gr" = (
/obj/structure/cargo_container/green{
	dir = 8
	},
/turf/open/floor/plating,
/area/bigredv3/outside/directions/nw)
"hn" = (
/turf/open/floor/marking/asteroidwarning{
	dir = 8
	},
/area/bigredv3/outside/directions/nw)
"hy" = (
/obj/machinery/atmospherics/pipe/simple/green/hidden,
/obj/structure/cable,
/turf/open/floor/plating/warning{
	dir = 1
	},
/area/bigredv3/outside/directions/nw)
"hI" = (
/obj/machinery/atmospherics/pipe/simple/green/hidden,
/obj/structure/cable,
/turf/open/floor/marking/asteroidwarning{
	dir = 4
	},
/area/bigredv3/outside/directions/nw)
"hQ" = (
/obj/machinery/atmospherics/pipe/simple/green/hidden{
	dir = 10
	},
/obj/structure/cable,
/turf/open/floor/asteroidfloor,
/area/bigredv3/outside/directions/nw)
"hV" = (
/turf/closed/mineral/smooth/bigred/indestructible,
/area/space)
"jb" = (
/turf/open/floor/plating/ground/mars/random/cave,
/area/bigredv3/caves/west)
"jP" = (
/obj/effect/ai_node,
/turf/open/floor/marking/asteroidwarning{
	dir = 4
	},
/area/bigredv3/outside/directions/nw)
"kO" = (
/obj/effect/ai_node,
/turf/open/floor/plating/ground/mars/random/dirt,
/area/bigredv3/outside/directions/nw)
"ll" = (
/turf/open/floor/plating/warning{
	dir = 1
	},
/area/bigredv3/outside/directions/nw)
"lG" = (
/obj/effect/decal/cleanable/dirt,
/turf/open/floor/marking/asteroidwarning{
	dir = 8
	},
/area/bigredv3/outside/directions/nw)
"mz" = (
/obj/effect/turf_decal/sandedge,
/turf/open/floor/plating/ground/mars/random/sand,
/area/bigredv3/caves/northwest)
"mQ" = (
/obj/structure/cargo_container/hd{
	dir = 4
	},
/turf/open/floor/plating,
/area/bigredv3/outside/directions/nw)
"ne" = (
/turf/open/floor/marking/asteroidwarning{
	dir = 10
	},
/area/bigredv3/outside/directions/nw)
"oh" = (
/turf/open/floor/asteroidfloor,
/area/bigredv3/outside/directions/nw)
"om" = (
/obj/effect/ai_node,
/turf/open/floor/plating/ground/mars/random/cave,
/area/bigredv3/caves/northwest)
"oZ" = (
/obj/machinery/light{
	dir = 1
	},
/turf/open/floor/plating/ground/mars/random/dirt,
/area/bigredv3/outside/medical/virology)
"pc" = (
/obj/effect/decal/cleanable/dirt,
/turf/open/floor/marking/asteroidwarning{
	dir = 10
	},
/area/bigredv3/outside/directions/nw)
"pj" = (
/turf/open/floor/asteroidfloor,
/area/bigredv3/outside/medical/virology)
"pJ" = (
/obj/machinery/light{
	dir = 1
	},
/turf/open/floor/plating/ground/mars/random/sand,
/area/bigredv3/outside/medical/virology)
"pY" = (
/obj/machinery/atmospherics/pipe/simple/green/hidden,
/obj/structure/cable,
/turf/open/floor/asteroidfloor,
/area/bigredv3/outside/directions/nw)
"pZ" = (
/turf/open/floor/plating/warning{
	dir = 8
	},
/area/bigredv3/outside/directions/nw)
"qg" = (
/obj/structure/cable,
/obj/machinery/atmospherics/pipe/simple/green/hidden{
	dir = 4
	},
/turf/open/floor/plating,
/area/bigredv3/outside/directions/nw)
"qi" = (
/turf/open/floor/plating/ground/mars/random/dirt,
/area/bigredv3/outside/directions/nw)
"qy" = (
/turf/open/floor/marking/asteroidwarning{
	dir = 9
	},
/area/bigredv3/outside/medical/virology)
"qE" = (
/obj/effect/decal/cleanable/dirt,
/obj/effect/ai_node,
/turf/open/floor/marking/asteroidwarning{
	dir = 8
	},
/area/bigredv3/outside/directions/nw)
"qK" = (
/obj/structure/fence/standard/xenoproof,
/turf/open/floor/plating/ground/mars/cavetodirt{
	dir = 4
	},
/area/bigredv3/outside/directions/nw)
"qO" = (
/obj/machinery/atmospherics/pipe/manifold/green/hidden,
/obj/structure/cable,
/turf/open/floor/plating,
/area/bigredv3/outside/directions/nw)
"sq" = (
/turf/closed/wall/r_wall,
/area/bigredv3/inside/wall)
"sz" = (
/turf/open/floor/plating/ground/mars/dirttosand/autosmooth,
/area/bigredv3/outside/directions/nw)
"sI" = (
/obj/structure/cargo_container/ch_red{
	dir = 4
	},
/turf/open/floor/plating,
/area/bigredv3/outside/directions/nw)
"sT" = (
/obj/structure/cargo_container/ch_red{
	dir = 1
	},
/turf/open/floor/plating,
/area/bigredv3/outside/directions/nw)
"uu" = (
/turf/open/floor/plating/ground/mars/cavetodirt{
	dir = 6
	},
/area/bigredv3/caves/west)
"vj" = (
/obj/machinery/atmospherics/pipe/simple/green/hidden,
/obj/structure/cable,
/obj/effect/decal/cleanable/dirt,
/turf/open/floor/asteroidfloor,
/area/bigredv3/outside/directions/nw)
"vF" = (
/obj/effect/ai_node,
/obj/effect/decal/cleanable/dirt,
/turf/open/floor/plating,
/area/bigredv3/outside/directions/nw)
"wN" = (
/obj/machinery/atmospherics/pipe/simple/green/hidden,
/obj/structure/cable,
/obj/effect/ai_node,
/turf/open/floor/marking/asteroidwarning{
	dir = 1
	},
/area/bigredv3/outside/directions/nw)
"xh" = (
/turf/open/floor/marking/asteroidwarning{
	dir = 5
	},
/area/bigredv3/outside/directions/nw)
"xp" = (
/obj/machinery/atmospherics/pipe/simple/green/hidden,
/obj/structure/cable,
/turf/open/floor/marking/asteroidwarning,
/area/bigredv3/outside/directions/nw)
"yb" = (
/turf/open/floor/plating/ground/mars/random/dirt,
/area/bigredv3/caves/west)
"yj" = (
/obj/effect/ai_node,
/obj/machinery/light,
/turf/open/floor/plating,
/area/bigredv3/outside/directions/nw)
"yw" = (
/obj/effect/ai_node,
/turf/open/floor/plating/ground/mars/random/sand,
/area/bigredv3/outside/directions/nw)
"yN" = (
/obj/structure/cable,
/obj/machinery/atmospherics/pipe/simple/green/hidden{
	dir = 4
	},
/turf/open/floor/marking/asteroidwarning{
	dir = 1
	},
/area/bigredv3/outside/directions/nw)
"zb" = (
/obj/machinery/light{
	dir = 4
	},
/turf/open/floor/marking/asteroidwarning{
	dir = 1
	},
/area/bigredv3/outside/medical/virology)
"zg" = (
/obj/effect/turf_decal/sandedge/corner2,
/turf/open/floor/plating/ground/mars/random/sand,
/area/bigredv3/caves/northwest)
"zv" = (
/turf/open/floor/plating/ground/mars/random/cave/rock,
/area/bigredv3/caves/northwest)
"zA" = (
/turf/open/floor/tile/white,
/area/bigredv3/outside/directions/nw)
"zP" = (
/obj/structure/cargo_container/ch_red,
/turf/open/floor/plating,
/area/bigredv3/outside/directions/nw)
"Aa" = (
/turf/open/floor/plating,
/area/bigredv3/outside/directions/nw)
"Ae" = (
/turf/open/floor/marking/asteroidwarning,
/area/bigredv3/outside/directions/nw)
"Aq" = (
/obj/structure/cargo_container/hd_blue,
/turf/open/floor/plating,
/area/bigredv3/outside/directions/nw)
"Av" = (
/turf/open/floor/marking/asteroidwarning{
	dir = 8
	},
/area/bigredv3/outside/medical/virology)
"Bu" = (
/obj/effect/ai_node,
/turf/open/floor/plating,
/area/bigredv3/outside/directions/nw)
"CO" = (
/turf/open/floor/plating/ground/mars/dirttosand/autosmooth{
	dir = 1
	},
/area/bigredv3/outside/directions/nw)
"CQ" = (
/obj/structure/cable,
/obj/machinery/atmospherics/pipe/simple/green/hidden{
	dir = 4
	},
/obj/effect/ai_node,
/turf/open/floor/plating,
/area/bigredv3/outside/directions/nw)
"Dp" = (
/obj/structure/cargo_container/hd_blue{
	dir = 1
	},
/turf/open/floor/plating,
/area/bigredv3/outside/directions/nw)
"Dw" = (
/obj/machinery/atmospherics/pipe/simple/green/hidden{
	dir = 4
	},
/obj/structure/cable,
/turf/open/floor/tile/white,
/area/bigredv3/outside/directions/nw)
"DM" = (
/obj/structure/cargo_container/horizontal{
	dir = 2
	},
/turf/open/floor/plating,
/area/bigredv3/outside/directions/nw)
"EG" = (
/obj/machinery/atmospherics/pipe/simple/green/hidden{
	dir = 4
	},
/obj/structure/cable,
/obj/effect/ai_node,
/obj/effect/decal/cleanable/dirt,
/turf/open/floor/plating,
/area/bigredv3/outside/directions/nw)
"EI" = (
/turf/open/floor/plating/ground/mars/dirttosand/autosmooth{
	dir = 5
	},
/area/bigredv3/outside/medical/virology)
"EM" = (
/turf/open/floor/plating/ground/mars/random/sand,
/area/bigredv3/outside/directions/nw)
"Fs" = (
/turf/open/floor/plating/ground/mars/dirttosand/autosmooth{
	dir = 5
	},
/area/bigredv3/outside/directions/nw)
"FH" = (
/turf/open/floor/plating/ground/mars/dirttosand/autosmooth{
	dir = 8
	},
/area/bigredv3/outside/directions/nw)
"Hb" = (
/turf/open/floor/plating/ground/mars/dirttosand/autosmooth{
	dir = 10
	},
/area/bigredv3/outside/directions/nw)
"HO" = (
/turf/open/floor/plating/ground/mars/random/dirt,
/area/bigredv3/outside/medical/virology)
"HW" = (
/obj/effect/ai_node,
/turf/open/floor/plating/warning{
	dir = 1
	},
/area/bigredv3/outside/directions/nw)
"IK" = (
/obj/machinery/light{
	dir = 1
	},
/turf/open/floor/plating,
/area/bigredv3/outside/directions/nw)
"IP" = (
/turf/open/floor/plating/ground/mars/random/cave,
/area/bigredv3/caves/northwest)
"IW" = (
/turf/open/floor/plating/ground/mars/random/cave/rock,
/area/bigredv3/caves/west)
"Je" = (
/obj/effect/decal/cleanable/dirt,
/obj/structure/cable,
/turf/open/floor/plating,
/area/bigredv3/outside/directions/nw)
"Jx" = (
/turf/open/floor/marking/asteroidwarning{
	dir = 6
	},
/area/bigredv3/outside/directions/nw)
"JB" = (
/obj/structure/cable,
/obj/machinery/atmospherics/pipe/simple/green/hidden{
	dir = 6
	},
/turf/open/floor/marking/asteroidwarning{
	dir = 4
	},
/area/bigredv3/outside/directions/nw)
"Ks" = (
/turf/closed/wall,
/area/bigredv3/inside/wall)
"Kv" = (
/turf/open/floor/marking/asteroidwarning{
	dir = 1
	},
/area/bigredv3/outside/medical/virology)
"KC" = (
/obj/structure/cargo_container/green{
	dir = 1
	},
/turf/open/floor/plating,
/area/bigredv3/outside/directions/nw)
"KD" = (
/obj/effect/ai_node,
/turf/open/floor/plating/ground/mars/random/cave/rock,
/area/bigredv3/caves/west)
"KL" = (
/obj/structure/cable,
/obj/machinery/atmospherics/pipe/simple/green/hidden,
/obj/effect/ai_node,
/turf/open/floor/marking/asteroidwarning{
	dir = 4
	},
/area/bigredv3/outside/directions/nw)
"Lh" = (
/obj/effect/ai_node,
/turf/open/floor/plating/ground/mars/random/dirt,
/area/bigredv3/outside/medical/virology)
"Ll" = (
/obj/structure/cable,
/obj/machinery/atmospherics/pipe/simple/green/hidden,
/turf/open/floor/marking/asteroidwarning{
	dir = 4
	},
/area/bigredv3/outside/directions/nw)
"Ln" = (
/obj/effect/decal/cleanable/dirt,
/turf/open/floor/marking/asteroidwarning,
/area/bigredv3/outside/directions/nw)
"LU" = (
/obj/machinery/atmospherics/pipe/simple/green/hidden{
	dir = 4
	},
/obj/structure/cable,
/turf/open/floor/marking/asteroidwarning{
	dir = 1
	},
/area/bigredv3/outside/directions/nw)
"Ml" = (
/obj/structure/cargo_container/horizontal{
	dir = 1
	},
/turf/open/floor/plating,
/area/bigredv3/outside/directions/nw)
"Ms" = (
/obj/effect/decal/cleanable/dirt,
/obj/structure/cable,
/obj/machinery/atmospherics/pipe/simple/green/hidden{
	dir = 5
	},
/turf/open/floor/asteroidfloor,
/area/bigredv3/outside/directions/nw)
"MD" = (
/obj/effect/decal/cleanable/blood,
/turf/open/floor/plating/ground/mars/random/sand,
/area/bigredv3/outside/directions/nw)
"ME" = (
/obj/structure/rack/nometal,
/obj/effect/spawner/random/engineering/tool,
/obj/effect/spawner/random/engineering/tool,
/turf/open/floor/plating,
/area/bigredv3/outside/directions/nw)
"MZ" = (
/obj/effect/ai_node,
/turf/open/floor/asteroidfloor,
/area/bigredv3/outside/directions/nw)
"OA" = (
/obj/machinery/light{
	dir = 8
	},
/turf/open/floor/plating,
/area/bigredv3/outside/directions/nw)
"OV" = (
/obj/structure/cargo_container/horizontal{
	dir = 4
	},
/turf/open/floor/plating,
/area/bigredv3/outside/directions/nw)
"OY" = (
/obj/machinery/atmospherics/pipe/simple/green/hidden{
	dir = 4
	},
/obj/structure/cable,
/obj/effect/decal/cleanable/dirt,
/turf/open/floor/plating,
/area/bigredv3/outside/directions/nw)
"Pa" = (
/obj/effect/ai_node,
/obj/structure/cable,
/obj/machinery/power/apc/weak/ntf,
/turf/open/floor/plating,
/area/bigredv3/outside/directions/nw)
"Pp" = (
/obj/effect/decal/cleanable/dirt,
/turf/open/floor/asteroidfloor,
/area/bigredv3/outside/directions/nw)
"Pq" = (
/turf/open/floor/plating/ground/mars/dirttosand/autosmooth{
	dir = 4
	},
/area/bigredv3/outside/directions/nw)
"Ps" = (
/obj/machinery/floodlight/outpost/bigred,
/turf/open/floor/plating/ground/mars/random/sand,
/area/bigredv3/outside/directions/nw)
"PK" = (
/obj/machinery/atmospherics/pipe/simple/green/hidden,
/obj/structure/cable,
/turf/open/floor/plating,
/area/bigredv3/outside/directions/nw)
"PZ" = (
/turf/open/floor/marking/asteroidwarning{
	dir = 1
	},
/area/bigredv3/outside/directions/nw)
"QO" = (
/obj/structure/fence/standard/xenoproof,
/turf/open/floor/plating/ground/mars/cavetodirt{
	dir = 4
	},
/area/bigredv3/caves/west)
"QW" = (
/turf/open/floor/plating/ground/mars/random/sand,
/area/bigredv3/caves/northwest)
"Rg" = (
/turf/open/floor/marking/asteroidwarning{
	dir = 4
	},
/area/bigredv3/outside/directions/nw)
"Ro" = (
/turf/open/floor/plating/ground/mars/dirttosand/autosmooth{
	dir = 9
	},
/area/bigredv3/outside/medical/virology)
"Rp" = (
/obj/structure/cargo_container/hd_blue{
	dir = 4
	},
/turf/open/floor/plating,
/area/bigredv3/outside/directions/nw)
"Sh" = (
/obj/effect/ai_node,
/turf/open/floor/plating/ground/mars/random/cave/rock,
/area/bigredv3/caves/northwest)
"SD" = (
/obj/structure/cargo_container/hd{
	dir = 1
	},
/turf/open/floor/plating,
/area/bigredv3/outside/directions/nw)
"Tr" = (
/obj/machinery/floodlight/outpost/bigred,
/turf/open/floor/plating/ground/mars/random/dirt,
/area/bigredv3/outside/directions/nw)
"Tt" = (
/turf/open/floor/plating/ground/mars/random/sand,
/area/bigredv3/outside/medical/virology)
"Tx" = (
/obj/machinery/light,
/turf/open/floor/plating,
/area/bigredv3/outside/directions/nw)
"TR" = (
/obj/structure/cable,
/obj/machinery/atmospherics/pipe/simple/green/hidden{
	dir = 4
	},
/obj/effect/ai_node,
/obj/effect/decal/cleanable/dirt,
/turf/open/floor/plating,
/area/bigredv3/outside/directions/nw)
"TZ" = (
/obj/effect/decal/cleanable/dirt,
/turf/open/floor/marking/asteroidwarning{
	dir = 4
	},
/area/bigredv3/outside/directions/nw)
"Vx" = (
/turf/open/floor/plating/ground/mars/dirttosand/autosmooth{
	dir = 6
	},
/area/bigredv3/outside/directions/nw)
"Wn" = (
/obj/machinery/atmospherics/pipe/simple/green/hidden{
	dir = 4
	},
/obj/structure/cable,
/obj/machinery/door/airlock/multi_tile/mainship/medidoor{
	dir = 1;
	name = "\improper Medical Clinic"
	},
/turf/open/floor/tile/white,
/area/bigredv3/outside/directions/nw)
"Wq" = (
/obj/structure/cargo_container/hd,
/turf/open/floor/plating,
/area/bigredv3/outside/directions/nw)
"Wy" = (
/obj/machinery/light{
	dir = 1
	},
/obj/structure/rack/nometal,
/obj/effect/spawner/random/engineering/tool,
/obj/effect/spawner/random/engineering/tool,
/turf/open/floor/plating,
/area/bigredv3/outside/directions/nw)
"Xo" = (
/obj/structure/cable,
/obj/machinery/atmospherics/pipe/simple/green/hidden{
	dir = 4
	},
/obj/effect/decal/cleanable/dirt,
/turf/open/floor/plating/warning{
	dir = 8
	},
/area/bigredv3/outside/directions/nw)
"Xv" = (
/obj/effect/decal/cleanable/dirt,
/turf/open/floor/marking/asteroidwarning{
	dir = 1
	},
/area/bigredv3/outside/directions/nw)
"Xz" = (
/obj/machinery/atmospherics/pipe/simple/green/hidden{
	dir = 4
	},
/obj/structure/cable,
/turf/open/floor/asteroidfloor,
/area/bigredv3/outside/directions/nw)
"YP" = (
/turf/closed/mineral/smooth/bigred,
/area/bigredv3/caves/rock)
"YQ" = (
/obj/effect/ai_node,
/turf/open/floor/marking/asteroidwarning,
/area/bigredv3/outside/directions/nw)
"YV" = (
/obj/machinery/atmospherics/pipe/simple/green/hidden{
	dir = 4
	},
/obj/structure/cable,
/obj/effect/ai_node,
/turf/open/floor/plating,
/area/bigredv3/outside/directions/nw)
"Zi" = (
/obj/machinery/light{
	dir = 8
	},
/turf/open/floor/marking/asteroidwarning{
	dir = 1
	},
/area/bigredv3/outside/directions/nw)

(1,1,1) = {"
hV
hV
hV
hV
hV
hV
hV
hV
hV
hV
hV
hV
hV
hV
hV
hV
hV
hV
hV
hV
hV
hV
"}
(2,1,1) = {"
YP
YP
YP
YP
YP
YP
YP
YP
YP
YP
YP
YP
YP
YP
YP
YP
YP
YP
YP
YP
YP
YP
"}
(3,1,1) = {"
YP
YP
YP
YP
YP
YP
YP
YP
YP
YP
YP
YP
YP
YP
YP
YP
IW
IW
IW
IW
YP
YP
"}
(4,1,1) = {"
YP
YP
YP
YP
YP
YP
YP
YP
YP
YP
YP
YP
YP
YP
YP
IW
jb
jb
jb
fB
IW
YP
"}
(5,1,1) = {"
YP
YP
YP
YP
YP
YP
YP
YP
YP
YP
YP
YP
YP
YP
KD
jb
jb
jb
jb
jb
fB
IW
"}
(6,1,1) = {"
YP
YP
YP
YP
YP
YP
YP
YP
YP
YP
YP
YP
YP
YP
jb
jb
jb
jb
jb
jb
jb
jb
"}
(7,1,1) = {"
YP
YP
YP
YP
YP
YP
YP
YP
YP
YP
YP
YP
YP
zv
jb
jb
jb
jb
jb
jb
IW
jb
"}
(8,1,1) = {"
YP
YP
YP
YP
YP
YP
YP
YP
IP
IP
IP
IP
IP
IP
jb
jb
jb
jb
jb
jb
IW
fB
"}
(9,1,1) = {"
YP
om
IP
om
IP
IP
IP
IP
om
IP
IP
IP
IP
IP
fB
jb
jb
jb
jb
jb
KD
jb
"}
(10,1,1) = {"
om
IP
IP
IP
IP
IP
IP
IP
IP
IP
IP
IP
zv
IP
jb
jb
jb
jb
jb
jb
IW
jb
"}
(11,1,1) = {"
IP
IP
IP
IP
IP
zv
IP
IP
IP
IP
IP
IP
IP
IP
jb
jb
jb
jb
jb
jb
IW
YP
"}
(12,1,1) = {"
om
IP
zv
Sh
IP
om
IP
IP
om
IP
IP
IP
IP
IP
fB
jb
jb
jb
jb
jb
KD
YP
"}
(13,1,1) = {"
zv
IP
IP
IP
IP
IP
IP
IP
IP
IP
IP
zv
IP
IP
jb
jb
jb
jb
jb
jb
jb
KD
"}
(14,1,1) = {"
IP
IP
IP
IP
IP
IP
IP
IP
IP
IP
YP
YP
YP
YP
YP
YP
YP
jb
jb
jb
jb
IW
"}
(15,1,1) = {"
om
IP
IP
IP
IP
IP
IP
IP
IP
YP
YP
YP
YP
YP
YP
YP
YP
jb
YP
YP
cd
QO
"}
(16,1,1) = {"
IP
IP
IP
IP
IP
IP
IP
IP
YP
YP
YP
YP
YP
YP
YP
YP
YP
YP
YP
YP
uu
yb
"}
(17,1,1) = {"
IP
IP
YP
qK
qK
qK
qK
qK
YP
YP
YP
YP
YP
YP
YP
YP
YP
YP
sq
sq
sq
sq
"}
(18,1,1) = {"
YP
YP
YP
qi
qi
kO
qi
qi
YP
YP
YP
YP
YP
YP
YP
YP
YP
YP
sq
HO
HO
Lh
"}
(19,1,1) = {"
YP
YP
YP
YP
sq
sq
sq
sq
YP
YP
YP
YP
YP
YP
YP
YP
YP
YP
sq
HO
HO
HO
"}
(20,1,1) = {"
YP
YP
YP
YP
qi
qi
qi
qi
YP
YP
YP
YP
YP
YP
YP
YP
YP
YP
sq
HO
HO
qy
"}
(21,1,1) = {"
YP
YP
YP
YP
qi
qi
qi
YP
YP
YP
YP
YP
YP
YP
YP
YP
YP
YP
sq
EI
HO
eQ
"}
(22,1,1) = {"
YP
YP
YP
qi
qi
kO
YP
YP
YP
YP
YP
YP
YP
YP
YP
YP
YP
EM
sq
Tt
EI
Kv
"}
(23,1,1) = {"
YP
YP
YP
fN
kO
qi
YP
YP
YP
YP
YP
YP
YP
YP
YP
YP
YP
EM
sq
pJ
Tt
Kv
"}
(24,1,1) = {"
YP
YP
YP
EM
Fs
qi
qi
YP
YP
YP
YP
YP
YP
EM
EM
EM
EM
EM
sq
Tt
Ro
Kv
"}
(25,1,1) = {"
YP
YP
YP
EM
EM
CO
qi
YP
YP
yw
EM
EM
EM
EM
EM
yw
EM
EM
sq
Ro
HO
eQ
"}
(26,1,1) = {"
YP
YP
YP
YP
FH
qi
qi
YP
YP
EM
EM
dx
FH
Hb
EM
EM
EM
EM
sq
HO
HO
Kv
"}
(27,1,1) = {"
YP
YP
YP
YP
qi
kO
qi
kO
YP
EM
EM
CO
qi
sz
EM
EM
EM
EM
sq
HO
HO
Kv
"}
(28,1,1) = {"
mz
QW
YP
YP
YP
qi
qi
qi
Hb
EM
EM
Fs
Pq
Vx
EM
EM
EM
EM
sq
HO
HO
Kv
"}
(29,1,1) = {"
mz
QW
QW
yw
CO
kO
qi
qi
sz
yw
EM
EM
EM
EM
EM
yw
EM
EM
sq
oZ
HO
eQ
"}
(30,1,1) = {"
mz
QW
EM
Ps
CO
qi
qi
qi
sz
Ps
EM
EM
EM
EM
EM
Ps
EM
EM
sq
HO
HO
Kv
"}
(31,1,1) = {"
zg
EM
EM
EM
CO
qi
qi
qi
qi
Hb
EM
EM
EM
dx
FH
Hb
EM
EM
sq
HO
qy
Av
"}
(32,1,1) = {"
EM
EM
dx
FH
qi
qi
qi
qi
qi
qi
FH
FH
FH
qi
qi
qi
FH
FH
sq
HO
zb
pj
"}
(33,1,1) = {"
EM
dx
qi
cN
lG
lG
hn
lG
lG
hn
at
hn
hn
hn
lG
hn
lG
pc
sq
sq
sq
pj
"}
(34,1,1) = {"
EM
CO
eF
Pp
Pp
Pp
TZ
Rg
TZ
jP
JB
Ll
Ll
Ll
Ll
KL
Ll
Ms
pc
qi
Zi
MZ
"}
(35,1,1) = {"
dx
fw
oh
oh
oh
gc
qi
qi
PZ
oh
Xz
oh
Ae
qi
qi
qi
kO
LU
Ln
qi
xh
Rg
"}
(36,1,1) = {"
CO
PZ
Pp
Pp
gc
qi
qi
qi
PZ
Pp
Xz
Pp
Ae
qi
qi
qi
qi
yN
Ln
qi
qi
PZ
"}
(37,1,1) = {"
CO
Xv
oh
Ln
qi
Pq
sq
sq
sq
aQ
Xo
pZ
sq
sq
sq
sq
qi
LU
Ln
qi
Tr
PZ
"}
(38,1,1) = {"
CO
PZ
oh
Ln
sz
EM
sq
ME
Aa
Aa
qg
eM
OA
Aa
Aa
sq
qi
LU
Ae
qi
qi
PZ
"}
(39,1,1) = {"
CO
PZ
oh
Ae
sz
EM
sq
Wy
Aa
Aa
qg
Ml
OV
DM
Aa
sq
hn
ah
hn
lG
pc
oh
"}
(40,1,1) = {"
qE
oh
MZ
Ln
sz
Ps
sq
Pa
Je
Je
TR
Aa
Aa
Aa
Aa
sq
MZ
hQ
pY
vj
xp
KL
"}
(41,1,1) = {"
Pp
oh
Pp
Ae
sz
EM
sq
Aa
gr
Aa
qg
eM
Aa
Aa
eM
sq
sq
sq
sq
sq
Ln
qi
"}
(42,1,1) = {"
Rg
Rg
TZ
gc
sz
EM
sq
Aa
KC
Aa
CQ
Aa
Ml
OV
DM
Bu
eS
eS
eS
sq
Ae
Pq
"}
(43,1,1) = {"
qi
qi
qi
qi
qi
EM
sq
eM
fQ
Aa
qg
Aa
Aa
Aa
Aa
eM
Aa
Aa
Tx
sq
Ln
EM
"}
(44,1,1) = {"
qi
qi
qi
qi
qi
fw
sq
IK
Aa
eM
qg
Aa
Aa
Aa
Aa
Bu
Aa
Aa
Bu
sq
Ln
ne
"}
(45,1,1) = {"
hn
hn
hn
hn
hn
PZ
ll
Aa
eM
Aa
qg
Bu
eM
eM
Bu
eM
Aq
Aa
Aa
Aa
Ae
Ae
"}
(46,1,1) = {"
oh
oh
MZ
oh
oh
PZ
HW
eM
eM
Aa
TR
Aa
Aa
Wq
Aa
Aa
Dp
Aa
vF
eM
Ln
YQ
"}
(47,1,1) = {"
hI
hI
hI
hI
hI
wN
hy
PK
PK
PK
qO
eM
Aa
SD
Aa
eM
Rp
eM
Aa
Aa
Ln
Ln
"}
(48,1,1) = {"
Pq
Pq
qi
qi
qi
xh
sq
eM
eM
Aa
cJ
Aa
eM
mQ
Aa
Aa
Aa
Aa
Aa
sq
Ae
Jx
"}
(49,1,1) = {"
EM
EM
Fs
Pq
Pq
Pq
sq
IK
zP
Aa
OY
Aa
Aa
Aa
Bu
Aa
Aa
Aa
yj
sq
Ae
EM
"}
(50,1,1) = {"
EM
EM
Ps
EM
EM
EM
sq
Aa
sT
Aa
YV
Aa
Ml
OV
DM
sq
sq
sq
sq
sq
Ae
EM
"}
(51,1,1) = {"
EM
EM
EM
EM
EM
EM
sq
Aa
sI
eM
cJ
Aa
Aa
Aa
Aa
sq
TZ
Rg
TZ
Rg
gc
yw
"}
(52,1,1) = {"
EM
EM
yw
EM
EM
yw
sq
Aa
Aa
Aa
EG
eM
Aa
Aa
Aa
sq
EM
EM
EM
EM
EM
MD
"}
(53,1,1) = {"
EM
EM
EM
EM
yw
EM
sq
sq
sq
zA
Wn
sq
sq
sq
sq
sq
EM
EM
Ps
EM
EM
EM
"}
(54,1,1) = {"
EM
EM
EM
EM
EM
EM
EM
EM
Ks
zA
Dw
Ks
yw
EM
EM
EM
yw
EM
EM
EM
EM
yw
"}
