//MAP CONVERTED BY dmm2tgm.py THIS HEADER COMMENT PREVENTS RECONVERSION, DO NOT REMOVE
"ab" = (
/turf/open/floor/plating/ground/mars/random/cave,
/area/bigredv2/caves/east/garbledradio)
"ae" = (
/turf/closed/mineral/smooth/bigred/indestructible,
/area/space)
"af" = (
/obj/machinery/miner/damaged/platinum,
/turf/open/floor/plating/ground/mars/random/cave,
/area/bigredv2/caves/east/garbledradio)
"ag" = (
/obj/machinery/miner/damaged/platinum,
/turf/open/floor/plating/ground/mars/random/cave,
/area/bigredv2/caves/east)
"ah" = (
/turf/open/floor/plating/ground/mars/random/cave/rock,
/area/bigredv2/caves/east/garbledradio)
"aj" = (
/obj/effect/landmark/lv624/fog_blocker,
/turf/closed/mineral/smooth/bigred,
/area/bigredv2/caves/rock)
"ak" = (
/obj/structure/fence/standard/xenoproof,
/obj/effect/landmark/lv624/fog_blocker,
/turf/open/floor/plating/ground/mars/random/cave,
/area/bigredv2/caves/east/garbledradio)
"am" = (
/obj/docking_port/stationary/crashmode,
/turf/open/floor/plating/ground/mars/random/cave,
/area/bigredv2/caves/east/garbledradio)
"ao" = (
/turf/open/floor/plating/ground/mars/random/sand,
/area/bigredv2/outside/se)
"aq" = (
/obj/effect/landmark/lv624/fog_blocker/xeno_spawn,
/obj/effect/landmark/lv624/fog_blocker/xeno_spawn,
/turf/closed/mineral/smooth/bigred,
/area/bigredv2/caves/rock)
"at" = (
/obj/effect/landmark/lv624/fog_blocker/xeno_spawn,
/turf/closed/mineral/smooth/bigred,
/area/bigredv2/caves/rock)
"az" = (
/obj/effect/landmark/lv624/fog_blocker/xeno_spawn,
/turf/open/floor/plating/ground/mars/random/cave/rock,
/area/bigredv2/caves/east/garbledradio)
"aF" = (
/obj/docking_port/stationary/crashmode,
/turf/closed/mineral/smooth/bigred,
/area/bigredv2/caves/rock)
"aG" = (
/obj/effect/ai_node,
/turf/open/floor/plating/ground/mars/random/cave,
/area/bigredv2/caves/east)
"aH" = (
/turf/open/floor/plating/ground/mars/random/cave,
/area/bigredv2/caves/east)
"aK" = (
/obj/effect/landmark/lv624/fog_blocker/xeno_spawn,
/obj/effect/ai_node,
/turf/open/floor/plating/ground/mars/random/cave,
/area/bigredv2/caves/east/garbledradio)
"aM" = (
/obj/effect/landmark/xeno_silo_spawn,
/turf/open/floor/plating/ground/mars/random/cave,
/area/bigredv2/caves/east/garbledradio)
"aN" = (
/turf/closed/mineral/smooth/bigred,
/area/bigredv2/caves/rock)
"aP" = (
/turf/open/floor/plating/ground/mars/random/cave/rock,
/area/bigredv2/caves/east)
"aR" = (
/obj/effect/landmark/excavation_site_spawner,
/turf/open/floor/plating/ground/mars/random/cave,
/area/bigredv2/caves/east)
"aV" = (
/obj/effect/ai_node,
/turf/open/floor/plating/ground/mars/random/cave,
/area/bigredv2/caves/east/garbledradio)
"aX" = (
/obj/effect/landmark/lv624/fog_blocker/xeno_spawn,
/turf/open/floor/plating/ground/mars/random/cave,
/area/bigredv2/caves/east/garbledradio)
"aY" = (
/obj/effect/landmark/lv624/fog_blocker/xeno_spawn,
/obj/effect/landmark/lv624/fog_blocker/xeno_spawn,
/turf/open/floor/plating/ground/mars/random/cave,
/area/bigredv2/caves/east/garbledradio)
"aZ" = (
/obj/effect/ai_node,
/turf/open/floor/plating/ground/mars/random/cave/rock,
/area/bigredv2/caves/east/garbledradio)
"hE" = (
/obj/effect/ai_node,
/turf/open/floor/plating/ground/mars/random/sand,
/area/bigredv2/outside/se)
"GC" = (
/obj/effect/landmark/xeno_tunnel_spawn,
/turf/open/floor/plating/ground/mars/random/cave/rock,
/area/bigredv2/caves/east/garbledradio)
"Hg" = (
/obj/effect/landmark/xeno_tunnel_spawn,
/turf/open/floor/plating/ground/mars/random/cave,
/area/bigredv2/caves/east/garbledradio)

(1,1,1) = {"
ao
ao
ao
ao
ao
ao
ao
ao
ao
ao
ao
aN
aN
aN
ak
ab
ab
ab
ab
ab
ab
ab
ab
ab
ab
ab
ab
ab
aN
aN
aN
aN
aN
aN
aN
aN
aN
ab
ab
ab
ab
ab
"}
(2,1,1) = {"
ao
ao
ao
ao
ao
ao
ao
ao
ao
ao
ao
aN
aN
aN
aj
ab
ab
ab
ab
ab
ab
ab
ab
ab
ab
ab
ab
ab
aN
aN
aN
aN
aN
aN
aN
aN
aN
aN
ab
ab
aV
ab
"}
(3,1,1) = {"
ao
ao
ao
ao
ao
ao
ao
ao
ao
ao
ao
aN
aN
aN
aj
ab
ab
ab
ab
ab
ab
aN
aN
aN
aN
aN
ab
ab
ab
aN
aN
aN
aN
aN
aN
aN
aN
aN
ab
ab
ab
ab
"}
(4,1,1) = {"
ao
aN
aN
aN
aN
ao
ao
ao
ao
ao
ao
ao
aN
aN
aj
ab
ab
ab
ab
ab
ab
aN
aN
aN
aN
aN
ah
ab
ab
ab
ab
ab
ab
ab
ab
aN
ah
ah
ab
ab
ab
ab
"}
(5,1,1) = {"
ao
aN
aN
aN
aN
aN
aN
ao
ao
ao
ao
ao
ao
aN
aj
aN
ab
aY
aX
aX
at
at
at
at
at
at
aX
az
aY
ab
ab
ab
ab
ab
ab
ah
ab
ab
ab
ab
ab
ab
"}
(6,1,1) = {"
ao
ao
aN
aN
aN
aN
aN
aN
ao
ao
ao
ao
ao
aN
aj
aN
aN
aX
ab
aN
aN
aN
aN
aN
aN
ab
ab
ab
az
ah
aV
ab
ab
ab
ab
ab
ab
ab
ab
ab
aV
ah
"}
(7,1,1) = {"
ao
ao
ao
ao
ao
ao
ao
ao
ao
ao
ao
ao
ao
aN
aj
aN
aN
aX
ab
ab
ab
aN
ab
aN
aN
ab
aV
ab
aX
aV
ab
ab
ab
ab
ab
ab
ab
ab
ab
af
ab
ah
"}
(8,1,1) = {"
ao
ao
ao
ao
ao
ao
ao
ao
ao
ao
ao
ao
ao
aN
aj
aN
aN
at
ab
ab
ab
aV
ab
ab
aV
aV
ab
ab
aX
ab
ab
ab
ab
ab
ab
ab
ah
ab
ab
ab
ah
aN
"}
(9,1,1) = {"
ao
ao
ao
ao
ao
hE
ao
ao
ao
hE
ao
ao
ao
aN
aj
aN
aN
at
ab
ab
ab
ab
ab
ab
ab
ab
ab
aN
at
aN
aN
aN
ab
ab
ab
ab
ab
ah
ab
ab
ab
ah
"}
(10,1,1) = {"
ao
ao
ao
ao
ao
ao
ao
ao
ao
ao
ao
ao
aN
aN
aj
aN
aN
at
aN
aN
ab
ab
ab
ab
ab
aN
aN
aN
at
aN
aN
aN
aN
aN
aN
aN
ab
ab
ab
ab
ab
ah
"}
(11,1,1) = {"
ao
ao
aN
ao
ao
ao
ao
ao
ao
ao
ao
aN
aN
aN
aj
aN
aN
at
aN
ab
ab
ab
ab
ab
ab
ab
aN
aN
at
aN
aN
aN
aN
aN
aN
aN
ab
ab
ab
ab
ab
ah
"}
(12,1,1) = {"
ao
aN
aN
ao
ao
ao
ao
ao
ao
aN
aN
aN
aN
aN
aj
aN
aN
at
ab
ah
ab
ab
ah
ab
ab
ab
aN
aN
at
aN
aN
aN
aN
aN
aN
aN
ab
ab
ab
ab
ab
ah
"}
(13,1,1) = {"
aN
aN
aN
ao
ao
ao
ao
ao
ao
aN
aN
aN
aN
aN
aj
aN
aN
at
ab
ab
ab
ab
ab
ab
ab
ab
aN
aN
at
aN
aN
aN
aN
aN
aN
aN
ah
ab
ab
ab
ah
aN
"}
(14,1,1) = {"
aN
aN
ao
ao
ao
ao
ao
ao
ao
aN
aN
aN
aN
aN
aj
aN
aN
at
ab
ab
ab
aV
aM
ab
ab
ab
ab
aN
at
aN
aN
aN
aN
aN
aN
aN
ab
ab
ab
ab
aV
ah
"}
(15,1,1) = {"
aN
ao
ao
ao
ao
ao
aN
aN
aN
aN
aN
aN
aN
aN
aj
aN
aN
at
Hg
ab
ab
ab
ab
ab
ab
ab
aN
aN
at
aN
aN
aN
aN
aN
aN
aN
aN
ah
ab
ab
ab
ah
"}
(16,1,1) = {"
ao
ao
ao
ao
ao
hE
aN
aN
aN
aN
aN
aN
aN
aN
aj
aN
aN
at
aN
aN
aN
ab
ab
ab
ab
aN
aN
aN
at
aN
aN
aN
aN
aN
aN
aN
aN
aN
ab
ab
ab
ab
"}
(17,1,1) = {"
ao
ao
ao
ao
ao
ao
aN
aN
aN
aN
aN
aN
aN
aN
aj
aN
aN
at
aN
aN
aN
aN
aN
aN
aN
aN
aN
aN
at
aN
aN
aN
aN
aN
aN
aN
aN
aN
ab
ab
ab
ab
"}
(18,1,1) = {"
aN
aN
aN
aN
aN
aN
aN
aN
aN
aN
aN
aN
aN
aN
aj
aN
aN
aq
at
at
at
at
at
at
at
at
at
at
aq
aN
aN
aN
aN
aN
aN
aN
ab
ab
ab
ab
ab
ab
"}
(19,1,1) = {"
aj
aj
aj
aj
aj
aj
aj
aj
aj
aj
aj
aj
aj
aj
aj
aN
aN
aN
aN
aN
aN
aN
aN
aN
aN
aN
aN
aN
aN
aN
aN
aN
aN
aN
aN
ab
ab
ab
ab
ab
ab
ab
"}
(20,1,1) = {"
aN
aN
aN
aN
aN
aN
aN
aN
aN
aN
aN
aN
aN
aN
aN
aN
aN
aN
aN
aN
aN
aN
aN
aN
aN
aF
aN
aN
aN
aN
aN
aN
aN
aN
ab
ab
ab
ab
ab
ab
ab
ab
"}
(21,1,1) = {"
aN
aN
aN
aN
aN
aN
aN
aN
aN
aN
aN
aN
aN
aN
aN
aN
aN
aN
aN
aN
aN
aN
aN
aN
aN
aN
aN
aN
aN
aN
aN
aN
ab
ab
ab
ab
ab
ab
ab
ah
ab
ab
"}
(22,1,1) = {"
aN
ah
ah
ah
ah
ah
aN
aN
aN
aN
aN
aN
aN
aN
aN
aN
aN
aN
aN
aN
aN
aN
ah
ah
ah
ah
ah
aN
aN
aN
ab
ab
ab
aV
ab
ab
ab
ab
ab
ab
aV
ab
"}
(23,1,1) = {"
aN
aV
ab
ab
ab
ab
aZ
aN
aN
aN
aN
aN
aN
aN
aN
aN
aN
aN
aZ
ah
ah
ah
ab
ab
aV
ab
ab
ah
ah
ab
ab
ab
aV
ab
ab
ab
ah
aN
aN
ab
ab
ab
"}
(24,1,1) = {"
aN
ah
ab
ab
ab
ab
ah
aN
aN
aN
aN
aN
aN
aN
aN
aN
aN
aN
ab
ab
ab
ab
ab
ab
ab
ab
ab
ab
ab
ab
ah
ab
ab
ah
ab
ab
ah
aN
aN
ab
ab
ab
"}
(25,1,1) = {"
aN
aN
aN
ah
ab
ab
ah
ab
ab
ab
ab
aN
aN
aN
aN
aN
aN
ah
ab
ab
ab
ab
ab
ab
ab
ab
ab
ab
ab
ab
ab
ab
ah
ab
ab
ah
aN
aN
aN
ab
ab
ab
"}
(26,1,1) = {"
aN
aN
aN
aN
aN
ab
ah
ab
ab
ab
ab
aN
aN
aN
aN
ah
ah
ab
ab
ab
ab
ab
ab
ab
ab
ab
ab
ab
ab
ab
ab
ab
ab
ab
ah
aN
aN
aN
aN
ab
aV
ab
"}
(27,1,1) = {"
ah
ah
ah
ah
ah
ab
ah
ab
ab
ab
ab
ab
ab
ab
ab
ab
ab
ab
ab
ab
ab
ab
ab
ab
ab
ab
ab
ab
ab
ab
ab
ab
ab
ab
ab
ah
aN
ah
ah
ab
ab
ab
"}
(28,1,1) = {"
ab
ab
ab
ab
ab
ab
aV
ah
ah
ah
ah
ah
ah
ah
ab
ab
aZ
ab
aV
ab
ab
ab
ab
ab
ab
af
ab
ab
ab
ab
ab
ab
ab
ab
ab
ab
ah
ab
ab
ab
ab
ab
"}
(29,1,1) = {"
ab
ab
ab
ab
ab
ab
ab
ab
ab
ab
ab
ab
ab
ab
ab
ab
ah
ab
ab
ah
ab
ab
ab
ab
ab
ab
ab
ab
ab
ab
ab
ab
ab
ab
ab
ab
ab
ab
ab
ab
ab
ab
"}
(30,1,1) = {"
ab
ab
ab
ab
ab
ab
ab
ab
ab
ab
ab
ab
ab
ab
ab
ab
aZ
ab
ab
ab
ab
ab
ab
ab
aV
ah
ab
ab
ab
ab
ab
ab
ab
aV
ab
ab
ab
ab
ab
ab
aZ
aN
"}
(31,1,1) = {"
ab
ab
ab
ab
ab
ab
ab
ab
ab
ab
ab
ah
aN
aN
ab
ab
ah
aX
aX
aX
aX
aX
aX
aX
aX
aK
aX
aX
aX
ab
ab
ab
ab
ab
ab
ab
ab
ab
ab
ab
ah
aN
"}
(32,1,1) = {"
ah
ab
ab
ab
ab
ab
ab
aN
aN
aN
aN
aN
aN
aN
aN
ab
ah
aX
ab
ab
ab
ab
ab
ab
ab
ab
ab
ab
aX
ab
ab
ab
ab
ab
ab
ab
ab
ab
ab
ah
ab
aN
"}
(33,1,1) = {"
ab
ab
ab
ab
af
ab
ab
aN
aN
aN
aN
aN
aN
aN
aN
ab
ah
aX
ab
ab
aV
ab
ab
ab
ab
ab
ab
ab
at
aN
aN
aN
aN
aN
ab
ab
ab
ab
ah
ab
ab
ab
"}
(34,1,1) = {"
ah
ab
ab
ah
ab
ab
ab
aN
aN
aN
aN
aN
aN
aN
ah
ab
ab
aX
ab
ab
ab
ab
ab
ab
ab
ab
ab
aN
at
aN
aN
aN
aN
aN
ab
ab
ab
ab
ah
ab
ab
ab
"}
(35,1,1) = {"
aN
ah
ab
ab
ab
ab
ab
ab
aN
aN
aN
aN
aN
ah
ab
ab
ab
aX
ab
ab
ab
ab
aM
ab
ab
ab
ab
ah
at
aN
aN
aN
aN
aN
aN
aN
aN
aN
aN
ab
ab
ab
"}
(36,1,1) = {"
aN
aN
aN
ab
ab
ah
ab
ab
ab
aN
aN
aN
ah
ab
ab
ab
ab
aX
ab
ab
ab
ab
ab
ab
ab
ab
ab
ah
at
aN
aN
aN
aN
aN
aN
aN
aN
aN
aN
aN
aV
ab
"}
(37,1,1) = {"
aN
aN
aN
ab
ab
ah
aV
ab
am
ah
ab
ab
ab
ab
ab
ab
aZ
at
aN
ab
ab
ab
ab
ab
ab
ab
ab
ah
at
aN
aN
aN
aN
aN
aN
aN
aN
aN
aN
aN
ab
ab
"}
(38,1,1) = {"
aN
aN
aN
ab
ab
ab
ab
ab
ab
ab
ab
ab
ab
ab
ab
ah
ah
at
aN
ab
aV
ab
ab
ab
ab
aV
ah
aN
at
aN
aN
aN
aN
aN
aN
aN
aN
aN
aN
aN
aN
ab
"}
(39,1,1) = {"
aN
aN
aN
aN
ab
ab
ab
ab
ab
ab
ab
ab
ab
ab
ab
aN
aN
at
aN
aN
ah
ab
ab
ab
ab
GC
aN
aN
at
aN
aN
aN
aN
aN
aN
aN
aN
aN
aN
aN
aN
aN
"}
(40,1,1) = {"
aN
aN
aN
aN
ab
ab
ab
ab
ab
ab
ab
ab
ab
ab
ab
aN
aN
at
at
at
aN
aN
aN
aN
aN
aN
aN
at
at
aN
aN
aN
aN
aN
aN
aN
aN
aN
aN
aN
aN
aN
"}
(41,1,1) = {"
aN
aN
aN
ab
ab
ab
ab
ab
ab
ab
ab
ab
ab
ab
aN
aN
aN
aN
aN
aN
at
at
at
at
at
at
at
aN
aN
aN
aN
aN
aN
aN
aN
aN
aN
aN
aN
aN
aN
aN
"}
(42,1,1) = {"
aN
aN
aN
ab
ab
ab
ab
ab
ab
aN
aN
aN
aN
aN
aN
aN
aN
aN
aN
aN
aN
aN
aN
aN
aN
aN
aN
aN
aN
aN
aN
aN
aN
aN
aN
aN
aN
aN
aN
aN
aN
aN
"}
(43,1,1) = {"
aN
aN
ab
ab
ab
ab
ab
ab
ab
aN
aN
aN
aN
aN
aN
aN
aN
aN
aN
aN
aN
aN
aN
aN
aN
aN
aN
aN
aN
aN
aN
aN
aN
aN
aN
aN
aN
aN
aN
aN
aN
aN
"}
(44,1,1) = {"
aN
aN
aH
aH
aH
aH
aH
aH
aN
aN
aN
aN
aN
aN
aN
aN
aN
aN
aN
aN
aN
aN
aN
aN
aN
aN
aN
aN
aN
aN
aN
aN
aN
aN
aN
aN
aN
aN
aN
aN
aN
aN
"}
(45,1,1) = {"
aN
aN
aH
aH
aH
aH
aH
aH
aN
aN
aN
aN
aN
aN
aN
aN
aN
aN
aN
aN
aN
aN
aN
aN
aN
aN
aN
aN
aN
aN
aN
aN
aN
aN
aN
aN
aN
aN
aN
aN
aN
aN
"}
(46,1,1) = {"
aH
aH
aH
aH
aH
aH
aH
aH
aN
aN
aN
aN
aN
aN
aN
aN
aN
aN
aN
aN
aN
aN
aN
aN
aN
aN
aN
aN
aN
aN
aN
aN
aN
aN
aH
aH
aH
aH
aH
aH
aH
aH
"}
(47,1,1) = {"
aH
aH
aG
aH
aH
aH
aG
aN
aN
aN
aN
aN
aN
aN
aN
aN
aN
aN
aN
aN
aN
aN
aN
aN
aN
aN
aN
aN
aN
aN
aN
aN
aN
aN
aH
aH
aH
aH
aH
aH
aH
aH
"}
(48,1,1) = {"
aH
aH
aH
aH
aH
aH
aH
aN
aN
aN
aN
aN
aN
aN
aN
aN
aN
aN
aN
aN
aN
aN
aN
aN
aN
aN
aN
aN
aN
aN
aN
aN
aN
aH
aH
aH
aH
aH
aH
aG
aH
aH
"}
(49,1,1) = {"
aH
aH
aG
aH
aH
aH
aN
aN
aN
aN
aN
aN
aN
aN
aN
aN
aN
aN
aN
aN
aN
aN
aN
aN
aN
aN
aN
aN
aN
aN
aN
aN
aN
aH
aH
aH
aH
aH
aH
aH
aH
aH
"}
(50,1,1) = {"
aH
aH
aH
aH
aH
aH
aN
aN
aN
aN
aN
aN
aN
aN
aN
aN
aN
aN
aN
aN
aH
aH
aH
aH
aH
aH
aH
aH
aH
aH
aH
aH
aH
aH
aH
aH
aH
aH
aH
aH
aH
aH
"}
(51,1,1) = {"
aH
aH
aH
aH
aH
aH
aN
aN
aN
aN
aN
aN
aN
aN
aN
aN
aN
aN
aN
aN
aH
aH
aH
aH
aH
aH
aH
aH
aH
aH
aH
aH
aH
aH
aH
aH
aH
aH
aH
aH
aH
aH
"}
(52,1,1) = {"
aH
aP
aH
aH
aH
aH
aN
aN
aN
aH
aH
aH
aH
aH
aH
aH
aH
aH
aH
aH
aH
aH
aH
aH
aH
aH
aH
aH
aH
aH
aG
aH
aH
aH
aH
aH
aR
aH
aH
aG
aH
aH
"}
(53,1,1) = {"
aH
aH
aH
aH
aH
aH
aN
aN
aN
aH
aH
aH
aH
aH
aH
aH
aH
aH
aH
aH
aH
aH
aH
aP
aH
aH
aH
aH
aH
aH
aH
aH
aH
aH
aP
aH
aH
aH
aH
aH
aH
aH
"}
(54,1,1) = {"
aH
aH
aH
aH
aH
aH
aH
aH
aH
aH
aH
aH
aH
aH
aH
aH
aH
aH
aH
aR
aH
aH
aH
aH
aH
aH
aH
ag
aH
aH
aH
aH
aH
aH
aH
aH
aH
aH
aH
aH
aH
aH
"}
(55,1,1) = {"
aH
aH
aG
aH
aH
aH
aH
aH
aH
aH
aH
aH
aG
aH
aH
aH
aH
aH
aH
aH
aG
aH
aH
aH
aH
aH
aH
aH
aH
aH
aG
aH
aH
aH
aH
aH
aH
aH
aH
aH
aH
aH
"}
(56,1,1) = {"
aH
aH
aH
aH
aH
aH
aH
aH
aH
aH
aH
aP
aH
aH
aH
aH
aH
aH
aH
aH
aH
aH
aH
aH
aH
aH
aH
aH
aH
aH
aH
aH
aH
aH
aN
aN
aN
aN
aN
aN
aN
aN
"}
(57,1,1) = {"
aH
aH
aH
aN
aH
aH
aH
aH
aH
aH
aH
aH
aH
aH
aH
aH
aH
aP
aH
aH
aH
aH
aH
aH
aH
aH
aH
aH
aH
aH
aH
aH
aH
aH
aN
aN
aN
aN
aN
aN
aN
aN
"}
(58,1,1) = {"
aH
aH
aH
aN
aN
aN
aN
aN
aN
aH
aH
aH
aH
aH
aH
aH
aH
aH
aH
aH
aH
aH
aH
aH
aH
aH
aN
aN
aN
aN
aN
aN
aN
aN
aN
aN
aN
aN
aN
aN
aN
aN
"}
(59,1,1) = {"
aH
aH
aN
aN
aN
aN
aN
aN
aN
aH
aH
aH
aH
aH
aH
aH
aH
aH
aH
aH
aH
aH
aH
aH
aH
aH
aN
aN
aN
aN
aN
aN
aN
aN
aN
aN
aN
aN
aN
aN
aN
aN
"}
(60,1,1) = {"
aN
aN
aN
aN
aN
aN
aN
aN
aN
aN
aN
aN
aN
aH
aH
aH
aH
aH
aN
aN
aN
aN
aN
aN
aN
aN
aN
aN
aN
aN
aN
aN
aN
aN
aN
aN
aN
aN
aN
aN
aN
aN
"}
(61,1,1) = {"
aN
aN
aN
aN
aN
aN
aN
aN
aN
aN
aN
aN
aN
aN
aN
aN
aN
aN
aN
aN
aN
aN
aN
aN
aN
aN
aN
aN
aN
aN
aN
aN
aN
aN
aN
aN
aN
aN
aN
aN
aN
aN
"}
(62,1,1) = {"
at
at
aN
aN
aN
aN
aN
aN
aN
aN
aN
aN
aN
aN
aN
aN
aN
aN
aN
aN
aN
aN
aN
aN
aN
aN
aN
aN
aN
aN
aN
aN
aN
aN
aN
aN
aN
aN
aN
aN
aN
aN
"}
(63,1,1) = {"
aN
at
at
aN
aN
aN
aN
aN
aN
aN
aN
aN
aN
aN
aN
aN
aN
aN
aN
aN
aN
aN
aN
aN
aN
aN
aN
aN
aN
aN
aN
aN
aN
aN
aN
aN
aN
aN
aN
aN
aN
aN
"}
(64,1,1) = {"
aN
aN
at
aN
aN
aN
aN
aN
aN
aN
aN
aN
aN
aN
aN
aN
aN
aN
aN
aN
aN
aN
aN
aN
aN
aN
aN
aN
aN
aN
aN
aN
aN
aN
aN
aN
aN
aN
aN
aN
aN
aN
"}
(65,1,1) = {"
aN
aN
at
aN
aN
aN
aN
aN
aN
aN
aN
aN
aN
aN
aN
aN
aN
aN
aN
aN
aN
aN
aN
aN
aN
aN
aN
aN
aN
aN
aN
aN
aN
aN
aN
aN
aN
aN
aN
aN
aN
aN
"}
(66,1,1) = {"
aH
aN
ae
ae
ae
ae
ae
ae
ae
ae
ae
ae
ae
ae
ae
ae
ae
ae
ae
ae
ae
ae
ae
ae
ae
ae
ae
ae
ae
ae
ae
ae
ae
ae
ae
ae
ae
ae
ae
ae
ae
ae
"}
