//MAP CONVERTED BY dmm2tgm.py THIS HEADER COMMENT PREVENTS RECONVERSION, DO NOT REMOVE
"al" = (
/obj/effect/decal/cleanable/dirt,
/obj/machinery/atmospherics/pipe/simple/green/hidden,
/obj/structure/cable,
/turf/open/floor/tile/dark,
/area/bigredv3/inside/colony/dorm/eva)
"ap" = (
/obj/machinery/suit_storage_unit/carbon_unit,
/turf/open/floor/tile/dark,
/area/bigredv3/inside/colony/dorm/eva)
"at" = (
/obj/machinery/vending/hydronutrients,
/turf/open/floor,
/area/bigredv3/inside/colony/hydroponics)
"az" = (
/turf/open/floor/plating/ground/mars/random/sand,
/area/bigredv3/outside/directions/ne)
"bk" = (
/obj/machinery/atmospherics/pipe/simple/green/hidden,
/obj/structure/cable,
/turf/open/floor/tile/dark,
/area/bigredv3/inside/colony/dorm/eva)
"bS" = (
/obj/structure/rack,
/obj/effect/spawner/random/engineering/cable,
/obj/effect/spawner/random/engineering/toolbox,
/turf/open/floor/plating,
/area/bigredv3/inside/secondary/maintence)
"bW" = (
/obj/machinery/light{
	dir = 1
	},
/turf/open/floor/plating,
/area/bigredv3/inside/secondary/maintence)
"ck" = (
/obj/structure/table,
/obj/effect/spawner/random/engineering/toolbox,
/obj/machinery/atmospherics/components/unary/vent_pump,
/turf/open/floor,
/area/bigredv3/inside/colony/dorm)
"co" = (
/obj/machinery/atmospherics/pipe/simple/green/hidden{
	dir = 9
	},
/obj/structure/cable,
/obj/effect/ai_node,
/turf/open/floor,
/area/bigredv3/inside/colony/dorm)
"ct" = (
/obj/effect/decal/cleanable/dirt,
/obj/effect/decal/cleanable/dirt,
/obj/machinery/atmospherics/pipe/simple/green/hidden,
/obj/structure/cable,
/turf/open/floor/tile/dark,
/area/bigredv3/inside/colony/dorm/eva)
"cJ" = (
/turf/closed/wall,
/area/bigredv3/inside/wall)
"dh" = (
/obj/effect/decal/cleanable/dirt,
/turf/open/floor/tile/dark,
/area/bigredv3/inside/colony/dorm/eva)
"dy" = (
/obj/structure/rack,
/obj/item/stack/sheet/mineral/diamond,
/obj/item/stack/sheet/plasteel{
	amount = 30;
	pixel_x = 4;
	pixel_y = 4
	},
/turf/open/floor/tile/dark,
/area/bigredv3/inside/colony/dorm/eva)
"dA" = (
/turf/open/floor/marking/asteroidwarning{
	dir = 4
	},
/area/bigredv3/outside/directions/ne)
"dD" = (
/obj/machinery/light{
	dir = 1
	},
/obj/effect/decal/cleanable/dirt,
/turf/open/floor,
/area/bigredv3/inside/colony/dorm)
"dO" = (
/obj/structure/table,
/turf/open/floor/wood,
/area/bigredv3/inside/colony/dorm)
"eL" = (
/turf/open/floor/plating/ground/mars/random/dirt,
/area/bigredv3/caves/northeast/garbledradio)
"fz" = (
/obj/machinery/atmospherics/pipe/simple/green/hidden{
	dir = 4
	},
/turf/open/floor,
/area/bigredv3/inside/colony/dorm/recreation)
"fJ" = (
/obj/structure/rack,
/obj/effect/spawner/random/engineering/tool,
/obj/effect/spawner/random/engineering/tool,
/obj/effect/decal/cleanable/dirt,
/turf/open/floor/tile/dark,
/area/bigredv3/inside/colony/dorm/e_power)
"fN" = (
/obj/machinery/door/airlock/mainship/maint/free_access{
	name = "\improper Dormitories EVA Maintenance"
	},
/obj/structure/cable,
/turf/open/floor/plating,
/area/bigredv3/inside/colony/dorm/eva)
"gH" = (
/obj/machinery/door/airlock/multi_tile/mainship/generic{
	name = "\improper Dormitories Tool Storage"
	},
/turf/open/floor,
/area/bigredv3/inside/colony/dorm)
"hj" = (
/obj/structure/table,
/obj/effect/spawner/random/engineering/toolbox,
/turf/open/floor/plating,
/area/bigredv3/inside/colony/dorm/e_power)
"hU" = (
/obj/machinery/light,
/turf/open/floor/tile/dark,
/area/bigredv3/inside/colony/dorm/eva)
"hV" = (
/turf/open/floor,
/area/bigredv3/inside/colony/dorm/recreation)
"in" = (
/obj/effect/decal/cleanable/dirt,
/turf/open/floor/plating/warning{
	dir = 1
	},
/area/bigredv3/inside/colony/dorm/e_power)
"iL" = (
/obj/machinery/atmospherics/pipe/manifold/green/hidden{
	dir = 1
	},
/obj/structure/cable,
/obj/effect/ai_node,
/turf/open/floor/tile/dark,
/area/bigredv3/inside/colony/dorm/eva)
"ja" = (
/obj/machinery/atmospherics/pipe/simple/green/hidden,
/turf/open/floor,
/area/bigredv3/inside/colony/dorm/recreation)
"jf" = (
/obj/structure/rack,
/obj/item/stack/sheet/mineral/gold,
/turf/open/floor/tile/dark,
/area/bigredv3/inside/colony/dorm/eva)
"jE" = (
/obj/structure/sign/safety/EVA{
	dir = 1
	},
/turf/open/floor/tile/dark,
/area/bigredv3/inside/colony/dorm/eva)
"jG" = (
/obj/machinery/atmospherics/pipe/simple/green/hidden{
	dir = 4
	},
/obj/structure/cable,
/turf/open/floor,
/area/bigredv3/inside/colony/dorm)
"jS" = (
/obj/machinery/light{
	dir = 4
	},
/obj/structure/rack,
/obj/item/stack/sheet/mineral/silver,
/obj/item/stack/sheet/mineral/silver{
	amount = 20
	},
/obj/item/stack/sheet/mineral/phoron{
	amount = 25
	},
/turf/open/floor/tile/dark,
/area/bigredv3/inside/colony/dorm/eva)
"kc" = (
/obj/machinery/atmospherics/pipe/manifold/green/hidden{
	dir = 4
	},
/obj/structure/cable,
/obj/effect/ai_node,
/turf/open/floor/asteroidfloor,
/area/bigredv3/outside/directions/ne)
"ke" = (
/obj/structure/window/framed/colony,
/obj/machinery/door/poddoor/shutters/mainship{
	dir = 2;
	id = "Greenhouse";
	name = "\improper Greenhouse Shutters"
	},
/turf/open/floor/plating,
/area/bigredv3/inside/wall)
"kj" = (
/obj/effect/landmark/lv624/fog_blocker,
/turf/open/floor/plating/ground/mars/random/sand,
/area/bigredv3/caves/northeast/garbledradio)
"kv" = (
/obj/machinery/atmospherics/pipe/manifold/green/hidden{
	dir = 4
	},
/obj/structure/cable,
/obj/effect/ai_node,
/turf/open/floor/tile/dark,
/area/bigredv3/inside/colony/dorm/eva)
"ln" = (
/turf/open/floor/plating,
/area/bigredv3/inside/secondary/maintence)
"ly" = (
/obj/structure/table,
/turf/open/floor,
/area/bigredv3/inside/colony/hydroponics)
"lz" = (
/obj/effect/decal/cleanable/dirt,
/turf/open/floor,
/area/bigredv3/inside/colony/dorm)
"nd" = (
/obj/machinery/atmospherics/components/unary/vent_pump{
	dir = 8
	},
/turf/open/floor/plating,
/area/bigredv3/inside/colony/dorm/e_power)
"nv" = (
/obj/machinery/door/airlock/mainship/maint/free_access{
	name = "\improper Dormitories EVA Maintenance"
	},
/turf/open/floor/plating,
/area/bigredv3/inside/colony/dorm/e_power)
"nH" = (
/obj/machinery/floodlight/outpost/bigred,
/turf/open/floor/plating/ground/mars/random/sand,
/area/bigredv3/outside/directions/ne)
"nY" = (
/turf/open/floor/wood,
/area/bigredv3/inside/colony/dorm)
"oa" = (
/obj/machinery/vending/cigarette/colony,
/turf/open/floor,
/area/bigredv3/inside/colony/dorm)
"op" = (
/obj/structure/rack,
/obj/effect/spawner/random/engineering/tool,
/obj/effect/spawner/random/engineering/tool,
/turf/open/floor/tile/dark,
/area/bigredv3/inside/colony/dorm/e_power)
"or" = (
/turf/open/floor/plating/ground/mars/random/sand,
/area/bigredv3/caves/northeast/garbledradio)
"oy" = (
/turf/open/floor/plating/ground/mars/dirttosand/autosmooth{
	dir = 10
	},
/area/bigredv3/outside/directions/ne)
"oD" = (
/obj/structure/cable,
/obj/machinery/atmospherics/pipe/simple/green/hidden{
	dir = 4
	},
/obj/effect/decal/cleanable/dirt,
/turf/open/floor/asteroidfloor,
/area/bigredv3/outside/directions/ne)
"pJ" = (
/obj/structure/window/framed/colony,
/obj/machinery/door/poddoor/shutters/mainship{
	dir = 2;
	id = "Dormitories";
	name = "\improper Dormitories Shutters"
	},
/turf/open/floor/plating,
/area/bigredv3/inside/wall)
"qf" = (
/obj/machinery/light{
	dir = 1
	},
/turf/open/floor,
/area/bigredv3/inside/colony/dorm)
"qi" = (
/obj/structure/rack,
/turf/open/floor/tile/dark,
/area/bigredv3/inside/colony/dorm/eva)
"qG" = (
/obj/structure/rack,
/obj/effect/spawner/random/weaponry/melee,
/turf/open/floor/plating,
/area/bigredv3/inside/secondary/maintence)
"qP" = (
/obj/structure/table,
/obj/effect/spawner/random/misc/paperbin,
/obj/machinery/atmospherics/pipe/simple/green/hidden{
	dir = 4
	},
/turf/open/floor/tile/dark,
/area/bigredv3/inside/colony/dorm/eva)
"rc" = (
/obj/machinery/atmospherics/pipe/manifold/green/hidden,
/obj/effect/ai_node,
/turf/open/floor,
/area/bigredv3/inside/colony/dorm)
"rn" = (
/obj/machinery/door/airlock/mainship/engineering/free_access{
	dir = 1;
	name = "\improper Dormitories EVA"
	},
/obj/machinery/atmospherics/pipe/simple/green/hidden,
/obj/structure/cable,
/turf/open/floor/tile/dark,
/area/bigredv3/inside/colony/dorm/eva)
"rA" = (
/obj/machinery/vending/engivend,
/turf/open/floor/plating,
/area/bigredv3/inside/colony/dorm/e_power)
"rL" = (
/obj/structure/cable,
/obj/machinery/atmospherics/pipe/simple/green/hidden{
	dir = 4
	},
/obj/effect/ai_node,
/turf/open/floor/asteroidfloor,
/area/bigredv3/outside/directions/ne)
"si" = (
/obj/structure/window/framed/colony,
/obj/machinery/door/poddoor/shutters/mainship{
	id = "Greenhouse";
	name = "\improper Greenhouse Shutters"
	},
/turf/open/floor/plating,
/area/bigredv3/inside/wall)
"sk" = (
/obj/structure/bed/chair{
	dir = 8
	},
/turf/open/floor,
/area/bigredv3/inside/colony/dorm/recreation)
"sz" = (
/obj/effect/decal/cleanable/dirt,
/turf/open/floor/asteroidfloor,
/area/bigredv3/outside/directions/ne)
"tf" = (
/obj/machinery/light{
	dir = 1
	},
/obj/machinery/vending/cola,
/turf/open/floor,
/area/bigredv3/inside/colony/dorm)
"tw" = (
/obj/machinery/door/airlock/mainship/maint/free_access{
	dir = 1;
	name = "\improper Dormitories Tool Storage Maintenance"
	},
/turf/open/floor/plating,
/area/bigredv3/inside/secondary/maintence)
"ty" = (
/obj/structure/table,
/obj/machinery/atmospherics/components/unary/vent_pump{
	dir = 8;
	on = 1
	},
/turf/open/floor/tile/dark,
/area/bigredv3/inside/colony/dorm/eva)
"tI" = (
/obj/machinery/atmospherics/pipe/simple/green/hidden,
/obj/structure/cable,
/obj/machinery/door/airlock/mainship/medical/glass/free_access{
	dir = 1;
	name = "\improper Greenhouse"
	},
/turf/open/floor,
/area/bigredv3/inside/colony/hydroponics)
"vm" = (
/obj/machinery/atmospherics/components/unary/vent_pump{
	dir = 4;
	on = 1
	},
/obj/structure/cable,
/turf/open/floor/tile/dark,
/area/bigredv3/inside/colony/dorm/eva)
"vp" = (
/obj/structure/rack,
/obj/item/stack/sheet/mineral/uranium{
	amount = 50
	},
/turf/open/floor/tile/dark,
/area/bigredv3/inside/colony/dorm/eva)
"vy" = (
/obj/structure/table,
/obj/item/tool/shovel/spade,
/turf/open/floor,
/area/bigredv3/inside/colony/hydroponics)
"vz" = (
/obj/effect/decal/cleanable/dirt,
/obj/machinery/atmospherics/pipe/simple/green/hidden,
/turf/open/floor,
/area/bigredv3/inside/colony/dorm)
"vO" = (
/obj/structure/rack,
/obj/item/stack/sheet/mineral/plastic,
/obj/item/stack/sheet/mineral/plastic,
/obj/item/stack/sheet/mineral/plastic,
/obj/effect/decal/cleanable/cobweb,
/turf/open/floor/tile/dark,
/area/bigredv3/inside/colony/dorm/eva)
"wa" = (
/obj/structure/table,
/obj/item/paper/hydroponics,
/turf/open/floor,
/area/bigredv3/inside/colony/hydroponics)
"wF" = (
/obj/structure/window/framed/colony/reinforced,
/turf/open/floor/plating,
/area/bigredv3/inside/wall)
"wK" = (
/obj/structure/rack,
/obj/effect/spawner/random/engineering/tool,
/obj/effect/spawner/random/engineering/tool,
/obj/effect/spawner/random/engineering/tool,
/turf/open/floor,
/area/bigredv3/inside/colony/dorm)
"xm" = (
/obj/effect/decal/cleanable/dirt,
/obj/machinery/atmospherics/components/unary/vent_pump{
	dir = 4;
	on = 1
	},
/turf/open/floor/tile/dark,
/area/bigredv3/inside/colony/dorm/eva)
"xV" = (
/obj/structure/sign/safety/EVA{
	dir = 1
	},
/turf/open/floor,
/area/bigredv3/inside/colony/dorm)
"yb" = (
/turf/open/floor/plating/ground/mars/random/sand,
/area/bigredv3/outside/directions/n)
"yj" = (
/obj/effect/decal/cleanable/dirt,
/obj/machinery/atmospherics/pipe/simple/green/hidden{
	dir = 6
	},
/obj/effect/ai_node,
/turf/open/floor,
/area/bigredv3/inside/colony/dorm)
"yB" = (
/turf/open/floor/plating/ground/mars/random/dirt,
/area/bigredv3/outside/directions/ne)
"zh" = (
/obj/structure/cable,
/obj/effect/ai_node,
/turf/open/floor/plating,
/area/bigredv3/inside/secondary/maintence)
"zV" = (
/obj/machinery/atmospherics/pipe/simple/green/hidden,
/obj/structure/cable,
/turf/open/floor,
/area/bigredv3/inside/colony/dorm)
"Al" = (
/obj/structure/rack,
/obj/item/stack/sheet/mineral/phoron{
	amount = 25
	},
/turf/open/floor/tile/dark,
/area/bigredv3/inside/colony/dorm/eva)
"Ax" = (
/turf/open/floor/plating/warning{
	dir = 4
	},
/area/bigredv3/inside/colony/dorm/e_power)
"AD" = (
/obj/machinery/atmospherics/pipe/simple/green/hidden{
	dir = 4
	},
/turf/open/floor,
/area/bigredv3/inside/colony/dorm)
"AP" = (
/obj/machinery/light{
	dir = 8
	},
/turf/open/floor/wood,
/area/bigredv3/inside/colony/dorm)
"Bq" = (
/obj/machinery/vending/hydroseeds,
/turf/open/floor,
/area/bigredv3/inside/colony/hydroponics)
"Bu" = (
/turf/open/floor/plating/warning,
/area/bigredv3/inside/colony/dorm/e_power)
"BA" = (
/obj/structure/rack,
/obj/item/stack/sheet/mineral/diamond,
/turf/open/floor/tile/dark,
/area/bigredv3/inside/colony/dorm/eva)
"BF" = (
/obj/effect/decal/cleanable/dirt,
/turf/open/floor/tile/dark,
/area/bigredv3/inside/colony/dorm/e_power)
"BO" = (
/obj/effect/ai_node,
/turf/open/floor/plating/ground/mars/random/sand,
/area/bigredv3/caves/northeast/garbledradio)
"BZ" = (
/obj/structure/cable,
/obj/machinery/atmospherics/pipe/simple/green/hidden,
/turf/open/floor/asteroidfloor,
/area/bigredv3/outside/directions/ne)
"CE" = (
/obj/structure/cable,
/obj/machinery/atmospherics/pipe/simple/green/hidden{
	dir = 4
	},
/turf/open/floor/asteroidfloor,
/area/bigredv3/outside/directions/ne)
"CH" = (
/obj/effect/decal/cleanable/dirt,
/obj/effect/spawner/random/misc/trash,
/turf/open/floor/plating/warning{
	dir = 4
	},
/area/bigredv3/inside/colony/dorm/e_power)
"CK" = (
/obj/machinery/atmospherics/pipe/simple/green/hidden{
	dir = 4
	},
/turf/open/floor/tile/dark,
/area/bigredv3/inside/colony/dorm/eva)
"CV" = (
/obj/machinery/light{
	dir = 1
	},
/turf/open/floor,
/area/bigredv3/inside/colony/dorm/recreation)
"Du" = (
/obj/effect/decal/cleanable/dirt,
/obj/effect/spawner/random/engineering/cable,
/turf/open/floor/plating,
/area/bigredv3/inside/colony/dorm/e_power)
"DM" = (
/obj/machinery/light,
/turf/open/floor,
/area/bigredv3/inside/colony/dorm)
"DP" = (
/turf/closed/mineral/smooth/bigred,
/area/bigredv3/caves/rock)
"DT" = (
/obj/machinery/light,
/obj/effect/decal/cleanable/dirt,
/turf/open/floor,
/area/bigredv3/inside/colony/dorm)
"Eg" = (
/obj/machinery/atmospherics/pipe/simple/green/hidden,
/turf/open/floor,
/area/bigredv3/inside/colony/dorm)
"Ek" = (
/obj/structure/cable,
/turf/open/floor/tile/dark,
/area/bigredv3/inside/colony/dorm/eva)
"Ey" = (
/obj/machinery/vending/tool,
/turf/open/floor/plating,
/area/bigredv3/inside/colony/dorm/e_power)
"EU" = (
/turf/open/floor/tile/dark,
/area/bigredv3/inside/colony/dorm/eva)
"Fc" = (
/obj/machinery/door/airlock/mainship/engineering/free_access{
	name = "\improper Dormitories EVA"
	},
/obj/machinery/atmospherics/pipe/simple/green/hidden{
	dir = 4
	},
/turf/open/floor/tile/dark,
/area/bigredv3/inside/colony/dorm/eva)
"FT" = (
/turf/open/floor,
/area/bigredv3/inside/colony/hydroponics)
"Go" = (
/obj/effect/spawner/random/engineering/structure/tank_dispenser/oxygenweighted,
/turf/open/floor/tile/dark,
/area/bigredv3/inside/colony/dorm/eva)
"Gv" = (
/turf/open/floor/asteroidfloor,
/area/bigredv3/outside/directions/ne)
"GM" = (
/obj/machinery/atmospherics/pipe/manifold/green/hidden,
/turf/open/floor,
/area/bigredv3/inside/colony/dorm/recreation)
"HH" = (
/turf/open/floor/plating/ground/mars/dirttosand/autosmooth,
/area/bigredv3/outside/directions/ne)
"Im" = (
/obj/machinery/atmospherics/pipe/manifold/green/hidden{
	dir = 1
	},
/obj/structure/cable,
/obj/effect/ai_node,
/turf/open/floor,
/area/bigredv3/inside/colony/dorm)
"IH" = (
/obj/structure/closet/toolcloset,
/turf/open/floor,
/area/bigredv3/inside/colony/dorm)
"IQ" = (
/obj/machinery/door/airlock/mainship/generic{
	dir = 1;
	name = "\improper Dormitories Bedroom"
	},
/turf/open/floor/wood,
/area/bigredv3/inside/colony/dorm)
"IS" = (
/obj/effect/decal/cleanable/dirt,
/obj/machinery/atmospherics/pipe/simple/green/hidden{
	dir = 9
	},
/turf/open/floor,
/area/bigredv3/inside/colony/dorm)
"IT" = (
/obj/machinery/atmospherics/components/unary/vent_pump{
	dir = 8;
	on = 1
	},
/obj/effect/ai_node,
/turf/open/floor/tile/dark,
/area/bigredv3/inside/colony/dorm/eva)
"Jh" = (
/turf/closed/wall/r_wall,
/area/bigredv3/inside/wall)
"JP" = (
/obj/structure/cable,
/obj/machinery/atmospherics/pipe/manifold/green/hidden{
	dir = 8
	},
/turf/open/floor/tile/dark,
/area/bigredv3/inside/colony/dorm/eva)
"JR" = (
/obj/effect/decal/cleanable/dirt,
/obj/effect/decal/cleanable/dirt,
/turf/open/floor/plating/warning{
	dir = 4
	},
/area/bigredv3/inside/colony/dorm/e_power)
"Kn" = (
/obj/structure/table,
/obj/effect/spawner/random/engineering/toolbox,
/obj/item/stack/cable_coil,
/turf/open/floor,
/area/bigredv3/inside/colony/dorm)
"KD" = (
/obj/structure/prop/mainship/brokengen,
/obj/machinery/atmospherics/pipe/simple/green/hidden{
	dir = 4
	},
/turf/open/floor/plating,
/area/bigredv3/inside/colony/dorm/e_power)
"KK" = (
/obj/machinery/suit_storage_unit/carbon_unit,
/obj/effect/decal/cleanable/cobweb2,
/turf/open/floor/tile/dark,
/area/bigredv3/inside/colony/dorm/eva)
"KQ" = (
/obj/effect/decal/cleanable/dirt,
/obj/structure/rack,
/obj/item/stack/sheet/mineral/uranium{
	amount = 50
	},
/turf/open/floor/tile/dark,
/area/bigredv3/inside/colony/dorm/eva)
"KW" = (
/obj/machinery/atmospherics/pipe/simple/green/hidden,
/obj/structure/cable,
/turf/open/floor/tile/green/whitegreenfull,
/area/bigredv3/inside/colony/hydroponics)
"Lb" = (
/obj/effect/decal/cleanable/dirt,
/turf/open/floor/plating,
/area/bigredv3/inside/colony/dorm/e_power)
"LA" = (
/obj/structure/bed,
/turf/open/floor/wood,
/area/bigredv3/inside/colony/dorm)
"Mk" = (
/obj/effect/ai_node,
/turf/open/floor/marking/asteroidwarning{
	dir = 6
	},
/area/bigredv3/outside/directions/ne)
"Mr" = (
/obj/structure/bed/chair{
	dir = 1
	},
/turf/open/floor,
/area/bigredv3/inside/colony/dorm/recreation)
"ML" = (
/obj/effect/ai_node,
/turf/open/floor,
/area/bigredv3/inside/colony/dorm)
"Ng" = (
/obj/structure/cable,
/obj/machinery/atmospherics/pipe/simple/green/hidden,
/obj/machinery/door/airlock/multi_tile/mainship/generic{
	name = "\improper Dormitories"
	},
/turf/open/floor,
/area/bigredv3/inside/colony/dorm)
"NV" = (
/turf/open/floor,
/area/bigredv3/inside/colony/dorm)
"Oa" = (
/turf/open/floor/marking/asteroidwarning,
/area/bigredv3/outside/directions/ne)
"Ov" = (
/obj/structure/cable,
/obj/machinery/atmospherics/pipe/simple/green/hidden{
	dir = 4
	},
/obj/machinery/door/airlock/mainship/maint/free_access{
	name = "\improper Bar Maintenance"
	},
/turf/open/floor/plating,
/area/bigredv3/inside/secondary/maintence)
"OK" = (
/obj/machinery/door/airlock/mainship/medical/glass/free_access{
	name = "\improper Dormitories Lavatory"
	},
/obj/machinery/atmospherics/pipe/simple/green/hidden{
	dir = 4
	},
/turf/open/floor/freezer,
/area/bigredv3/inside/colony/dorm/e_power)
"OP" = (
/obj/machinery/vending/snack,
/turf/open/floor,
/area/bigredv3/inside/colony/dorm)
"OR" = (
/obj/effect/decal/cleanable/dirt,
/obj/machinery/atmospherics/pipe/simple/green/hidden{
	dir = 4
	},
/turf/open/floor/plating/warning{
	dir = 4
	},
/area/bigredv3/inside/colony/dorm/e_power)
"OT" = (
/obj/machinery/atmospherics/pipe/simple/green/hidden{
	dir = 6
	},
/turf/open/floor,
/area/bigredv3/inside/colony/dorm/recreation)
"Pb" = (
/obj/effect/decal/cleanable/dirt,
/obj/machinery/air_alarm{
	dir = 4
	},
/turf/open/floor/tile/dark,
/area/bigredv3/inside/colony/dorm/eva)
"Pe" = (
/obj/machinery/light{
	dir = 8
	},
/obj/effect/spawner/random/misc/trash,
/obj/machinery/power/apc/weak/ntf{
	dir = 4
	},
/obj/structure/cable,
/turf/open/floor/plating,
/area/bigredv3/inside/secondary/maintence)
"Pi" = (
/obj/effect/spawner/random/engineering/cable,
/turf/open/floor/plating/warning{
	dir = 1
	},
/area/bigredv3/inside/colony/dorm/e_power)
"PE" = (
/obj/machinery/hydroponics,
/turf/open/floor/tile/green/whitegreenfull,
/area/bigredv3/inside/colony/hydroponics)
"PV" = (
/obj/effect/spawner/random/misc/trash,
/turf/open/floor/plating/warning{
	dir = 1
	},
/area/bigredv3/inside/colony/dorm/e_power)
"Qr" = (
/obj/effect/ai_node,
/turf/open/floor/plating/ground/mars/random/dirt,
/area/bigredv3/caves/northeast/garbledradio)
"Rc" = (
/obj/structure/rack,
/obj/effect/spawner/random/engineering/tool,
/obj/effect/spawner/random/engineering/tool,
/turf/open/floor,
/area/bigredv3/inside/colony/dorm)
"Ro" = (
/obj/structure/table,
/turf/open/floor/tile/dark,
/area/bigredv3/inside/colony/dorm/eva)
"Rw" = (
/turf/open/floor/plating/ground/mars/dirttosand/autosmooth{
	dir = 8
	},
/area/bigredv3/caves/northeast/garbledradio)
"Rx" = (
/obj/structure/closet/l3closet,
/turf/open/floor/tile/vault{
	dir = 8
	},
/area/bigredv3/inside/colony/dorm/eva)
"Sd" = (
/obj/machinery/vending/tool,
/turf/open/floor,
/area/bigredv3/inside/colony/dorm)
"Sj" = (
/obj/structure/prop/mainship/brokengen,
/turf/open/floor/plating,
/area/bigredv3/inside/colony/dorm/e_power)
"Ti" = (
/obj/effect/landmark/lv624/fog_blocker,
/turf/closed/mineral/smooth/bigred,
/area/bigredv3/caves/rock)
"TU" = (
/turf/open/floor/plating/warning{
	dir = 1
	},
/area/bigredv3/inside/colony/dorm/e_power)
"UK" = (
/obj/effect/ai_node,
/turf/open/floor/plating/ground/mars/random/sand,
/area/bigredv3/outside/directions/ne)
"Vr" = (
/turf/open/floor/plating,
/area/bigredv3/inside/colony/dorm/e_power)
"Vs" = (
/turf/open/floor/tile/dark,
/area/bigredv3/inside/colony/dorm/e_power)
"We" = (
/obj/effect/ai_node,
/turf/open/floor/tile/dark,
/area/bigredv3/inside/colony/dorm/eva)
"Wt" = (
/obj/structure/window/framed/colony,
/turf/open/floor/plating,
/area/bigredv3/inside/wall)
"WM" = (
/obj/effect/spawner/random/misc/trash,
/turf/open/floor/plating,
/area/bigredv3/inside/secondary/maintence)
"WO" = (
/obj/structure/rack,
/obj/item/stack/sheet/mineral/diamond,
/obj/item/clothing/under/redcoat,
/turf/open/floor/tile/dark,
/area/bigredv3/inside/colony/dorm/eva)
"WW" = (
/obj/structure/cable,
/turf/open/floor/plating,
/area/bigredv3/inside/secondary/maintence)
"XG" = (
/obj/machinery/light{
	dir = 8
	},
/obj/structure/cable,
/obj/machinery/atmospherics/pipe/simple/green/hidden,
/turf/open/floor/asteroidfloor,
/area/bigredv3/outside/directions/ne)
"XP" = (
/obj/structure/table,
/turf/open/floor,
/area/bigredv3/inside/colony/dorm/recreation)
"Za" = (
/obj/machinery/light{
	dir = 1
	},
/obj/machinery/suit_storage_unit/carbon_unit,
/turf/open/floor/tile/dark,
/area/bigredv3/inside/colony/dorm/eva)
"Zi" = (
/obj/machinery/atmospherics/pipe/manifold/green/hidden{
	dir = 4
	},
/turf/open/floor,
/area/bigredv3/inside/colony/dorm/recreation)
"Zm" = (
/obj/machinery/vending/engivend,
/turf/open/floor,
/area/bigredv3/inside/colony/dorm)
"Zx" = (
/obj/machinery/atmospherics/pipe/simple/green/hidden{
	dir = 4
	},
/obj/structure/cable,
/turf/open/floor/plating,
/area/bigredv3/inside/secondary/maintence)
"ZM" = (
/obj/structure/closet/l3closet,
/obj/effect/decal/cleanable/dirt,
/turf/open/floor/tile/vault{
	dir = 8
	},
/area/bigredv3/inside/colony/dorm/eva)

(1,1,1) = {"
yb
yb
pJ
hV
hV
OT
ja
Zi
ja
ja
ja
ja
ja
ja
GM
hV
hV
Mr
cJ
bW
Zx
ln
ln
cJ
"}
(2,1,1) = {"
yb
yb
cJ
cJ
cJ
OK
cJ
cJ
cJ
cJ
cJ
cJ
cJ
CV
fz
hV
sk
XP
cJ
ln
Zx
ln
ln
cJ
"}
(3,1,1) = {"
yb
yb
cJ
Lb
Ax
OR
Ax
Vr
cJ
wK
Rc
Rc
cJ
NV
AD
NV
cJ
cJ
cJ
cJ
Ov
cJ
cJ
cJ
"}
(4,1,1) = {"
yb
cJ
cJ
Bu
Sj
KD
Sj
in
cJ
qf
lz
NV
cJ
lz
AD
NV
IQ
nY
AP
cJ
oD
Oa
yB
cJ
"}
(5,1,1) = {"
yb
cJ
rA
Bu
Lb
nd
Lb
Pi
cJ
NV
lz
NV
cJ
lz
AD
NV
cJ
dO
LA
cJ
oD
Oa
yB
cJ
"}
(6,1,1) = {"
yb
cJ
Ey
Bu
Sj
Sj
Sj
TU
cJ
Zm
lz
NV
cJ
lz
AD
DM
cJ
cJ
cJ
cJ
oD
Oa
yB
cJ
"}
(7,1,1) = {"
DP
cJ
hj
Bu
Vr
Du
Vr
PV
cJ
Sd
NV
NV
gH
NV
AD
NV
IQ
nY
AP
cJ
oD
Oa
yB
cJ
"}
(8,1,1) = {"
Ti
cJ
cJ
Bu
JR
CH
Ax
in
cJ
Kn
yj
vz
Eg
Eg
rc
NV
cJ
dO
LA
cJ
CE
Oa
HH
az
"}
(9,1,1) = {"
DP
Ti
cJ
op
BF
Vs
fJ
BF
cJ
ck
IS
lz
cJ
NV
AD
NV
cJ
cJ
cJ
cJ
rL
Oa
yB
oy
"}
(10,1,1) = {"
DP
Ti
cJ
cJ
nv
cJ
cJ
cJ
cJ
IH
lz
DT
cJ
lz
AD
NV
IQ
nY
AP
cJ
oD
Oa
yB
HH
"}
(11,1,1) = {"
or
kj
cJ
qG
ln
Pe
bS
bS
cJ
IH
lz
lz
cJ
lz
AD
NV
cJ
dO
LA
cJ
oD
Oa
cJ
si
"}
(12,1,1) = {"
BO
kj
tw
WM
zh
WW
ln
WM
tw
NV
ML
NV
cJ
lz
AD
DM
cJ
cJ
cJ
cJ
CE
Oa
ke
PE
"}
(13,1,1) = {"
or
kj
cJ
cJ
fN
cJ
cJ
cJ
cJ
cJ
cJ
cJ
cJ
dD
Im
zV
Ng
BZ
XG
BZ
kc
BZ
tI
KW
"}
(14,1,1) = {"
or
kj
cJ
ap
Ek
Pb
Go
Ro
cJ
ZM
ZM
Rx
cJ
NV
jG
ML
NV
Gv
Gv
sz
dA
Mk
cJ
PE
"}
(15,1,1) = {"
or
kj
cJ
ap
Ek
dh
EU
Ro
cJ
dh
dh
EU
cJ
xV
jG
NV
cJ
cJ
cJ
cJ
az
az
ke
PE
"}
(16,1,1) = {"
or
kj
cJ
Za
vm
dh
dh
Ro
Wt
dh
xm
EU
Wt
NV
jG
NV
IQ
nY
AP
cJ
az
az
ke
PE
"}
(17,1,1) = {"
Rw
Ti
cJ
ap
iL
ct
al
JP
rn
bk
kv
bk
rn
zV
co
NV
cJ
dO
LA
cJ
az
nH
cJ
PE
"}
(18,1,1) = {"
eL
Ti
cJ
ap
CK
dh
EU
qP
Wt
EU
EU
EU
Wt
lz
NV
NV
cJ
cJ
cJ
cJ
az
az
ke
PE
"}
(19,1,1) = {"
eL
Ti
cJ
ap
CK
EU
EU
ty
cJ
jE
EU
hU
cJ
lz
NV
NV
IQ
nY
AP
cJ
az
az
ke
PE
"}
(20,1,1) = {"
Qr
Ti
cJ
KK
CK
EU
Go
Ro
cJ
Rx
Rx
Rx
cJ
NV
NV
DM
cJ
dO
LA
cJ
az
az
cJ
Wt
"}
(21,1,1) = {"
eL
Ti
Jh
wF
Fc
wF
wF
Jh
Jh
Jh
Jh
Jh
Jh
lz
NV
NV
cJ
cJ
cJ
cJ
az
UK
cJ
at
"}
(22,1,1) = {"
DP
Ti
Jh
vO
CK
Al
dh
KQ
dh
dy
EU
jf
Jh
lz
NV
NV
cJ
DP
az
az
az
az
cJ
Bq
"}
(23,1,1) = {"
DP
Ti
Jh
EU
CK
EU
dh
dh
dh
EU
dh
EU
Jh
lz
NV
NV
cJ
DP
az
az
nH
az
cJ
ly
"}
(24,1,1) = {"
DP
Ti
Jh
EU
IT
EU
EU
EU
EU
EU
We
EU
Jh
lz
NV
NV
cJ
DP
DP
az
az
az
cJ
vy
"}
(25,1,1) = {"
DP
Ti
Jh
qi
EU
vp
EU
jS
EU
WO
EU
BA
Jh
NV
NV
NV
cJ
DP
DP
az
az
az
cJ
wa
"}
(26,1,1) = {"
DP
Ti
Jh
Jh
Jh
Jh
Jh
Jh
Jh
Jh
Jh
Jh
Jh
tf
oa
OP
cJ
DP
DP
az
az
az
cJ
FT
"}
