//MAP CONVERTED BY dmm2tgm.py THIS HEADER COMMENT PREVENTS RECONVERSION, DO NOT REMOVE
"av" = (
/obj/structure/rack,
/obj/item/stack/sheet/mineral/gold,
/turf/open/floor/tile/dark,
/area/bigredv3/inside/colony/bar)
"aC" = (
/obj/structure/cable,
/obj/effect/ai_node,
/turf/open/floor/plating,
/area/bigredv3/inside/secondary/maintence)
"aV" = (
/obj/structure/rack,
/obj/item/stack/sheet/mineral/diamond,
/obj/item/clothing/under/redcoat,
/turf/open/floor/tile/dark,
/area/bigredv3/inside/colony/bar)
"bh" = (
/turf/open/floor/plating/ground/mars/dirttosand/autosmooth{
	dir = 10
	},
/area/bigredv3/outside/directions/ne)
"bk" = (
/obj/machinery/washing_machine,
/obj/item/clothing/under/brown,
/turf/open/floor/freezer,
/area/bigredv3/inside/colony/dorm)
"bC" = (
/obj/machinery/suit_storage_unit/carbon_unit,
/obj/effect/decal/cleanable/cobweb2,
/turf/open/floor/tile/dark,
/area/bigredv3/inside/colony/bar)
"bQ" = (
/turf/open/floor/plating/ground/mars/dirttosand/autosmooth{
	dir = 8
	},
/area/bigredv3/caves/northeast/garbledradio)
"cg" = (
/obj/machinery/atmospherics/components/unary/vent_pump{
	dir = 8;
	on = 1
	},
/obj/structure/table,
/obj/structure/bedsheetbin,
/turf/open/floor/freezer,
/area/bigredv3/inside/colony/dorm)
"cy" = (
/obj/effect/decal/cleanable/dirt,
/obj/machinery/air_alarm{
	dir = 4
	},
/turf/open/floor/tile/dark,
/area/bigredv3/inside/colony/bar)
"cC" = (
/obj/machinery/vending/tool,
/turf/open/floor,
/area/bigredv3/inside/colony/dorm)
"cD" = (
/obj/structure/table,
/obj/machinery/atmospherics/components/unary/vent_pump{
	dir = 8;
	on = 1
	},
/turf/open/floor/tile/dark,
/area/bigredv3/inside/colony/bar)
"cK" = (
/obj/machinery/atmospherics/pipe/simple/green/hidden{
	dir = 4
	},
/obj/structure/cable,
/turf/open/floor,
/area/bigredv3/inside/colony/dorm)
"cW" = (

/turf/open/floor/freezer,
/area/bigredv3/inside/colony/dorm)
"dl" = (
/obj/effect/decal/cleanable/dirt,
/turf/open/floor/asteroidfloor,
/area/bigredv3/outside/directions/ne)
"dz" = (
/obj/machinery/atmospherics/components/unary/vent_pump{
	dir = 8;
	on = 1
	},
/obj/effect/ai_node,
/turf/open/floor/tile/dark,
/area/bigredv3/inside/colony/bar)
"dC" = (
/obj/structure/rack,
/obj/item/stack/sheet/mineral/uranium{
	amount = 50
	},
/turf/open/floor/tile/dark,
/area/bigredv3/inside/colony/bar)
"dH" = (
/obj/machinery/atmospherics/pipe/simple/green/hidden,
/obj/structure/cable,
/turf/open/floor,
/area/bigredv3/inside/colony/dorm)
"dL" = (
/obj/machinery/vending/hydroseeds,
/turf/open/floor,
/area/bigredv3/inside/colony/hydroponics)
"eK" = (
/obj/machinery/light{
	dir = 8
	},
/obj/structure/cable,
/obj/machinery/atmospherics/pipe/simple/green/hidden,
/turf/open/floor/asteroidfloor,
/area/bigredv3/outside/directions/ne)
"eP" = (

/turf/open/floor,
/area/bigredv3/inside/colony/dorm)
"fi" = (
/obj/machinery/atmospherics/pipe/simple/green/hidden,
/turf/open/floor,
/area/bigredv3/inside/colony/dorm/recreation)
"fE" = (
/turf/open/floor/tile/dark,
/area/bigredv3/inside/colony/bar)
"fJ" = (
/obj/structure/table,
/obj/item/tool/shovel/spade,
/turf/open/floor,
/area/bigredv3/inside/colony/hydroponics)
"fS" = (
/turf/open/floor/plating/ground/mars/random/sand,
/area/bigredv3/outside/directions/ne)
"fV" = (
/obj/machinery/vending/engivend,
/turf/open/floor,
/area/bigredv3/inside/colony/dorm)
"fZ" = (
/obj/effect/decal/cleanable/dirt,
/turf/open/floor/tile/dark,
/area/bigredv3/inside/colony/bar)
"gC" = (
/obj/machinery/vending/cigarette/colony,
/turf/open/floor,
/area/bigredv3/inside/colony/dorm)
"hy" = (
/obj/structure/cable,
/obj/machinery/atmospherics/pipe/simple/green/hidden{
	dir = 4
	},
/turf/open/floor/asteroidfloor,
/area/bigredv3/outside/directions/ne)
"hQ" = (
/obj/machinery/light{
	dir = 1
	},
/turf/open/floor/plating,
/area/bigredv3/inside/secondary/maintence)
"iw" = (
/turf/closed/wall/r_wall,
/area/bigredv3/inside/wall)
"iA" = (
/obj/structure/rack,
/obj/item/stack/sheet/mineral/diamond,
/turf/open/floor/tile/dark,
/area/bigredv3/inside/colony/bar)
"iP" = (
/obj/structure/cable,
/obj/machinery/atmospherics/pipe/simple/green/hidden,
/obj/machinery/door/airlock/multi_tile/mainship/generic{
	name = "\improper Dormitories"
	},
/turf/open/floor,
/area/bigredv3/inside/colony/dorm)
"iZ" = (
/turf/open/floor,
/area/bigredv3/inside/colony/dorm/recreation)
"jb" = (
/obj/machinery/atmospherics/pipe/simple/green/hidden{
	dir = 4
	},
/obj/effect/decal/cleanable/blood/oil,
/turf/open/floor,
/area/bigredv3/inside/colony/dorm)
"jn" = (
/obj/item/clothing/under/darkred,
/turf/open/floor/freezer,
/area/bigredv3/inside/colony/dorm)
"jt" = (
/obj/machinery/light{
	dir = 1
	},
/turf/open/floor,
/area/bigredv3/inside/colony/dorm/recreation)
"jz" = (
/obj/machinery/floodlight/outpost/bigred,
/turf/open/floor/plating/ground/mars/random/sand,
/area/bigredv3/outside/directions/ne)
"jO" = (
/obj/structure/closet/l3closet,
/turf/open/floor/tile/vault{
	dir = 8
	},
/area/bigredv3/inside/colony/bar)
"km" = (
/obj/structure/rack,
/obj/effect/spawner/random/engineering/tool,
/obj/effect/spawner/random/engineering/tool,
/obj/effect/spawner/random/engineering/tool,
/turf/open/floor,
/area/bigredv3/inside/colony/dorm)
"ks" = (
/obj/item/clothing/under/lightbrown,
/turf/open/floor/freezer,
/area/bigredv3/inside/colony/dorm)
"kI" = (
/obj/structure/closet/toolcloset,
/turf/open/floor,
/area/bigredv3/inside/colony/dorm)
"lJ" = (
/obj/effect/ai_node,
/turf/open/floor,
/area/bigredv3/inside/colony/dorm)
"me" = (
/obj/effect/decal/cleanable/dirt,
/obj/item/ammo_casing/bullet,
/turf/open/floor,
/area/bigredv3/inside/colony/dorm)
"mi" = (
/obj/machinery/atmospherics/pipe/simple/green/hidden{
	dir = 4
	},
/obj/structure/cable,
/turf/open/floor/plating,
/area/bigredv3/inside/secondary/maintence)
"mp" = (
/obj/structure/sign/safety/EVA{
	dir = 1
	},

/turf/open/floor/tile/dark,
/area/bigredv3/inside/colony/bar)
"nh" = (
/turf/open/floor/plating/ground/mars/dirttosand/autosmooth,
/area/bigredv3/outside/directions/ne)
"nj" = (
/obj/machinery/atmospherics/pipe/manifold/green/hidden{
	dir = 1
	},
/obj/structure/cable,
/obj/effect/ai_node,
/turf/open/floor/tile/dark,
/area/bigredv3/inside/colony/bar)
"nn" = (
/obj/effect/decal/cleanable/dirt,
/turf/open/floor,
/area/bigredv3/inside/colony/dorm)
"no" = (
/obj/machinery/atmospherics/pipe/simple/green/hidden,
/obj/structure/cable,
/obj/machinery/door/airlock/mainship/medical/glass/free_access{
	dir = 1;
	name = "\improper Greenhouse"
	},
/turf/open/floor,
/area/bigredv3/inside/colony/hydroponics)
"nD" = (
/obj/machinery/atmospherics/pipe/simple/green/hidden{
	dir = 9
	},
/obj/structure/cable,
/obj/effect/ai_node,
/turf/open/floor,
/area/bigredv3/inside/colony/dorm)
"oi" = (
/obj/machinery/washing_machine,
/obj/item/clothing/under/lightred,
/turf/open/floor/freezer,
/area/bigredv3/inside/colony/dorm)
"oF" = (
/obj/structure/rack,
/obj/effect/spawner/random/engineering/tool,
/obj/effect/spawner/random/engineering/tool,
/turf/open/floor,
/area/bigredv3/inside/colony/dorm)
"pk" = (
/obj/machinery/door/airlock/mainship/medical/glass/free_access{
	name = "\improper Dormitories Lavatory"
	},
/obj/machinery/atmospherics/pipe/simple/green/hidden{
	dir = 4
	},
/turf/open/floor/freezer,
/area/bigredv3/inside/colony/dorm)
"ps" = (
/obj/item/ammo_casing/bullet,
/turf/open/floor,
/area/bigredv3/inside/colony/dorm)
"pE" = (
/obj/machinery/light{
	dir = 1
	},
/obj/machinery/vending/cola,
/turf/open/floor,
/area/bigredv3/inside/colony/dorm)
"pF" = (
/obj/effect/ai_node,
/turf/open/floor/plating/ground/mars/random/dirt,
/area/bigredv3/caves/northeast/garbledradio)
"pL" = (
/obj/structure/table,
/turf/open/floor/wood,
/area/bigredv3/inside/colony/dorm)
"pX" = (
/obj/structure/rack,
/obj/item/stack/sheet/mineral/diamond,
/obj/item/stack/sheet/plasteel{
	amount = 30;
	pixel_x = 4;
	pixel_y = 4
	},
/turf/open/floor/tile/dark,
/area/bigredv3/inside/colony/bar)
"qc" = (
/obj/structure/table,
/obj/item/paper/hydroponics,
/turf/open/floor,
/area/bigredv3/inside/colony/hydroponics)
"qq" = (
/obj/structure/sign/safety/EVA{
	dir = 1
	},
/turf/open/floor,
/area/bigredv3/inside/colony/dorm)
"qr" = (
/obj/effect/ai_node,
/turf/open/floor/marking/asteroidwarning{
	dir = 6
	},
/area/bigredv3/outside/directions/ne)
"rf" = (
/obj/machinery/atmospherics/pipe/simple/green/hidden{
	dir = 4
	},
/obj/item/ammo_casing/bullet,
/obj/effect/decal/cleanable/blood/oil,
/turf/open/floor,
/area/bigredv3/inside/colony/dorm)
"rq" = (
/obj/machinery/atmospherics/pipe/manifold/green/hidden{
	dir = 1
	},
/obj/structure/cable,
/obj/effect/ai_node,
/turf/open/floor,
/area/bigredv3/inside/colony/dorm)
"ru" = (
/turf/open/floor/plating,
/area/bigredv3/inside/secondary/maintence)
"rG" = (
/obj/machinery/atmospherics/pipe/simple/green/hidden{
	dir = 4
	},
/turf/open/floor,
/area/bigredv3/inside/colony/dorm)
"rH" = (
/obj/machinery/hydroponics,
/turf/open/floor/tile/green/whitegreenfull,
/area/bigredv3/inside/colony/hydroponics)
"rN" = (
/obj/structure/window/framed/colony/reinforced,
/turf/open/floor/plating,
/area/bigredv3/inside/wall)
"rW" = (
/obj/effect/decal/cleanable/dirt,

/turf/open/floor,
/area/bigredv3/inside/colony/dorm)
"st" = (
/obj/machinery/light{
	dir = 1
	},
/obj/effect/decal/cleanable/dirt,
/turf/open/floor,
/area/bigredv3/inside/colony/dorm)
"sT" = (
/obj/item/ammo_casing/bullet,
/obj/effect/decal/cleanable/blood/oil,
/turf/open/floor,
/area/bigredv3/inside/colony/dorm)
"tq" = (
/obj/structure/table,
/turf/open/floor,
/area/bigredv3/inside/colony/dorm/recreation)
"ux" = (
/turf/open/floor/wood,
/area/bigredv3/inside/colony/dorm)
"uG" = (
/obj/machinery/atmospherics/pipe/manifold/green/hidden,
/obj/effect/ai_node,
/turf/open/floor,
/area/bigredv3/inside/colony/dorm)
"uJ" = (
/obj/effect/decal/cleanable/dirt,
/obj/machinery/atmospherics/pipe/simple/green/hidden,
/turf/open/floor,
/area/bigredv3/inside/colony/dorm)
"uR" = (
/obj/machinery/atmospherics/pipe/manifold/green/hidden,
/turf/open/floor,
/area/bigredv3/inside/colony/dorm/recreation)
"uZ" = (
/obj/machinery/atmospherics/pipe/simple/green/hidden{
	dir = 4
	},
/obj/effect/ai_node,
/turf/open/floor/freezer,
/area/bigredv3/inside/colony/dorm)
"vi" = (
/obj/structure/cable,
/obj/machinery/atmospherics/pipe/simple/green/hidden{
	dir = 4
	},
/obj/machinery/door/airlock/mainship/maint/free_access{
	name = "\improper Bar Maintenance"
	},
/turf/open/floor/plating,
/area/bigredv3/inside/secondary/maintence)
"vG" = (
/obj/structure/window/framed/colony,
/obj/machinery/door/poddoor/shutters/mainship{
	dir = 2;
	id = "Dormitories";
	name = "\improper Dormitories Shutters"
	},
/turf/open/floor/plating,
/area/bigredv3/inside/wall)
"vI" = (
/obj/machinery/atmospherics/pipe/manifold/green/hidden{
	dir = 4
	},
/turf/open/floor,
/area/bigredv3/inside/colony/dorm/recreation)
"wo" = (
/obj/machinery/door/airlock/mainship/maint/free_access{
	dir = 1;
	name = "\improper Dormitories Tool Storage Maintenance"
	},
/turf/open/floor/plating,
/area/bigredv3/inside/secondary/maintence)
"ws" = (
/obj/item/ammo_casing/bullet,
/turf/open/floor,
/area/bigredv3/inside/colony/dorm/recreation)
"wD" = (
/obj/item/ammo_casing/bullet,
/obj/effect/spawner/gibspawner/human,
/turf/open/floor,
/area/bigredv3/inside/colony/dorm)
"wO" = (
/obj/machinery/washing_machine,
/obj/item/clothing/under/darkred,
/turf/open/floor/freezer,
/area/bigredv3/inside/colony/dorm)
"wP" = (
/obj/machinery/door/airlock/mainship/maint/free_access{
	name = "\improper Dormitories EVA Maintenance"
	},
/turf/open/floor/plating,
/area/bigredv3/inside/secondary/maintence)
"xA" = (
/turf/open/floor/freezer,
/area/bigredv3/inside/colony/dorm)
"xU" = (
/obj/item/ammo_casing/bullet,
/turf/open/floor/wood,
/area/bigredv3/inside/colony/dorm)
"xZ" = (
/obj/machinery/atmospherics/pipe/simple/green/hidden{
	dir = 4
	},
/obj/item/ammo_casing/bullet,
/turf/open/floor,
/area/bigredv3/inside/colony/dorm)
"ya" = (
/obj/machinery/door/airlock/mainship/engineering/free_access{
	dir = 1;
	name = "\improper Dormitories EVA"
	},
/obj/machinery/atmospherics/pipe/simple/green/hidden,
/obj/structure/cable,
/turf/open/floor/tile/dark,
/area/bigredv3/inside/colony/bar)
"yb" = (
/obj/effect/decal/cleanable/dirt,
/obj/structure/rack,
/obj/item/stack/sheet/mineral/uranium{
	amount = 50
	},
/turf/open/floor/tile/dark,
/area/bigredv3/inside/colony/bar)
"yc" = (
/obj/structure/table,
/obj/structure/bedsheetbin,
/turf/open/floor/freezer,
/area/bigredv3/inside/colony/dorm)
"yy" = (
/obj/effect/spawner/gibspawner/human,
/turf/open/floor,
/area/bigredv3/inside/colony/dorm)
"zn" = (
/obj/structure/rack,
/obj/item/stack/sheet/mineral/phoron{
	amount = 25
	},
/turf/open/floor/tile/dark,
/area/bigredv3/inside/colony/bar)
"zC" = (
/obj/structure/bed/chair{
	dir = 1
	},
/turf/open/floor,
/area/bigredv3/inside/colony/dorm/recreation)
"AR" = (
/obj/structure/closet/l3closet,
/obj/effect/decal/cleanable/dirt,
/turf/open/floor/tile/vault{
	dir = 8
	},
/area/bigredv3/inside/colony/bar)
"Ba" = (
/obj/machinery/atmospherics/pipe/simple/green/hidden,
/turf/open/floor,
/area/bigredv3/inside/colony/dorm)
"Bh" = (
/obj/structure/window/framed/colony,
/obj/machinery/door/poddoor/shutters/mainship{
	dir = 2;
	id = "Greenhouse";
	name = "\improper Greenhouse Shutters"
	},
/turf/open/floor/plating,
/area/bigredv3/inside/wall)
"Bl" = (
/obj/machinery/light,
/turf/open/floor/tile/dark,
/area/bigredv3/inside/colony/bar)
"By" = (
/obj/structure/table,
/obj/effect/spawner/random/misc/paperbin,
/obj/machinery/atmospherics/pipe/simple/green/hidden{
	dir = 4
	},
/turf/open/floor/tile/dark,
/area/bigredv3/inside/colony/bar)
"Cc" = (
/obj/effect/decal/cleanable/dirt,
/obj/machinery/atmospherics/pipe/simple/green/hidden,
/obj/structure/cable,
/turf/open/floor/tile/dark,
/area/bigredv3/inside/colony/bar)
"Cj" = (
/obj/machinery/power/apc/weak/ntf{
	dir = 4
	},
/obj/structure/cable,
/turf/open/floor/plating,
/area/bigredv3/inside/secondary/maintence)
"CS" = (
/turf/closed/mineral/smooth/bigred,
/area/bigredv3/caves/rock)
"Dg" = (
/turf/open/floor/marking/asteroidwarning{
	dir = 4
	},
/area/bigredv3/outside/directions/ne)
"Ds" = (
/obj/machinery/door/airlock/multi_tile/mainship/generic{
	name = "\improper Dormitories Tool Storage"
	},
/turf/open/floor,
/area/bigredv3/inside/colony/dorm)
"DD" = (
/obj/machinery/light{
	dir = 4
	},
/obj/structure/rack,
/obj/item/stack/sheet/mineral/silver,
/obj/item/stack/sheet/mineral/silver{
	amount = 20
	},
/obj/item/stack/sheet/mineral/phoron{
	amount = 25
	},
/turf/open/floor/tile/dark,
/area/bigredv3/inside/colony/bar)
"DU" = (
/obj/effect/decal/cleanable/dirt,
/obj/effect/decal/cleanable/dirt,
/obj/machinery/atmospherics/pipe/simple/green/hidden,
/obj/structure/cable,
/turf/open/floor/tile/dark,
/area/bigredv3/inside/colony/bar)
"DY" = (
/obj/effect/decal/cleanable/dirt,
/obj/item/ammo_casing/bullet,
/obj/effect/decal/cleanable/blood/oil,
/turf/open/floor,
/area/bigredv3/inside/colony/dorm)
"Ef" = (
/obj/structure/rack,
/obj/item/stack/sheet/mineral/plastic,
/obj/item/stack/sheet/mineral/plastic,
/obj/item/stack/sheet/mineral/plastic,
/obj/effect/decal/cleanable/cobweb,
/turf/open/floor/tile/dark,
/area/bigredv3/inside/colony/bar)
"Ei" = (
/obj/machinery/vending/hydronutrients,
/turf/open/floor,
/area/bigredv3/inside/colony/hydroponics)
"Ew" = (
/obj/machinery/suit_storage_unit/carbon_unit,
/turf/open/floor/tile/dark,
/area/bigredv3/inside/colony/bar)
"Ez" = (
/obj/effect/decal/cleanable/dirt,
/obj/effect/decal/cleanable/blood/oil,
/turf/open/floor,
/area/bigredv3/inside/colony/dorm)
"EG" = (
/obj/machinery/atmospherics/components/unary/vent_pump{
	dir = 4;
	on = 1
	},
/obj/structure/cable,
/turf/open/floor/tile/dark,
/area/bigredv3/inside/colony/bar)
"EL" = (
/obj/machinery/light{
	dir = 8
	},
/turf/open/floor/wood,
/area/bigredv3/inside/colony/dorm)
"EZ" = (
/obj/structure/bed/chair{
	dir = 8
	},
/turf/open/floor,
/area/bigredv3/inside/colony/dorm/recreation)
"Fd" = (
/turf/open/floor/asteroidfloor,
/area/bigredv3/outside/directions/ne)
"Fl" = (
/obj/effect/decal/cleanable/dirt,
/obj/effect/spawner/gibspawner/human,
/turf/open/floor,
/area/bigredv3/inside/colony/dorm)
"Fu" = (
/obj/machinery/atmospherics/pipe/simple/green/hidden,
/obj/structure/cable,
/turf/open/floor/tile/green/whitegreenfull,
/area/bigredv3/inside/colony/hydroponics)
"GG" = (

/turf/open/floor,
/area/bigredv3/inside/colony/dorm)
"GO" = (
/obj/machinery/light,
/turf/open/floor,
/area/bigredv3/inside/colony/dorm)
"GP" = (
/turf/open/floor/plating/ground/mars/random/dirt,
/area/bigredv3/caves/northeast/garbledradio)
"GV" = (
/obj/machinery/door/airlock/mainship/maint/free_access{
	name = "\improper Dormitories EVA Maintenance"
	},
/obj/structure/cable,
/turf/open/floor/plating,
/area/bigredv3/inside/colony/bar)
"Iz" = (
/obj/machinery/washing_machine,
/turf/open/floor/freezer,
/area/bigredv3/inside/colony/dorm)
"IP" = (
/turf/open/floor/plating/ground/mars/random/sand,
/area/bigredv3/outside/directions/n)
"Jj" = (
/obj/machinery/door/airlock/mainship/engineering/free_access{
	name = "\improper Dormitories EVA"
	},
/obj/machinery/atmospherics/pipe/simple/green/hidden{
	dir = 4
	},
/turf/open/floor/tile/dark,
/area/bigredv3/inside/colony/bar)
"JR" = (
/obj/machinery/door/airlock/mainship/generic{
	dir = 1;
	name = "\improper Dormitories Bedroom"
	},
/turf/open/floor/wood,
/area/bigredv3/inside/colony/dorm)
"JY" = (
/obj/structure/table,
/turf/open/floor,
/area/bigredv3/inside/colony/hydroponics)
"Kx" = (
/obj/effect/ai_node,
/turf/open/floor/plating/ground/mars/random/sand,
/area/bigredv3/outside/directions/ne)
"KG" = (
/obj/structure/cable,
/obj/machinery/atmospherics/pipe/simple/green/hidden{
	dir = 4
	},
/obj/effect/ai_node,
/turf/open/floor/asteroidfloor,
/area/bigredv3/outside/directions/ne)
"KL" = (
/obj/machinery/vending/snack,
/turf/open/floor,
/area/bigredv3/inside/colony/dorm)
"Lp" = (
/turf/open/floor/plating/ground/mars/random/dirt,
/area/bigredv3/outside/directions/ne)
"Lx" = (
/obj/machinery/washing_machine,
/obj/item/clothing/under/lightbrown,
/turf/open/floor/freezer,
/area/bigredv3/inside/colony/dorm)
"Mg" = (
/obj/machinery/washing_machine,
/obj/machinery/light,
/turf/open/floor/freezer,
/area/bigredv3/inside/colony/dorm)
"Mv" = (
/obj/machinery/atmospherics/pipe/simple/green/hidden{
	dir = 4
	},
/obj/structure/cable,
/obj/item/ammo_casing/bullet,
/turf/open/floor,
/area/bigredv3/inside/colony/dorm)
"Nk" = (
/turf/open/floor/marking/asteroidwarning,
/area/bigredv3/outside/directions/ne)
"Nn" = (
/obj/structure/cable,
/obj/machinery/atmospherics/pipe/simple/green/hidden{
	dir = 4
	},
/obj/effect/decal/cleanable/dirt,
/turf/open/floor/asteroidfloor,
/area/bigredv3/outside/directions/ne)
"Nu" = (
/obj/effect/landmark/lv624/fog_blocker,
/turf/closed/mineral/smooth/bigred,
/area/bigredv3/caves/rock)
"NJ" = (
/obj/structure/bed,
/turf/open/floor/wood,
/area/bigredv3/inside/colony/dorm)
"Oc" = (
/obj/structure/window/framed/colony,
/turf/open/floor/plating,
/area/bigredv3/inside/wall)
"Oq" = (
/obj/effect/landmark/lv624/fog_blocker,
/turf/open/floor/plating/ground/mars/random/sand,
/area/bigredv3/caves/northeast/garbledradio)
"Ox" = (
/obj/item/clothing/under/brown,
/turf/open/floor/freezer,
/area/bigredv3/inside/colony/dorm)
"OE" = (
/obj/machinery/light{
	dir = 1
	},
/obj/machinery/suit_storage_unit/carbon_unit,
/turf/open/floor/tile/dark,
/area/bigredv3/inside/colony/bar)
"OO" = (
/turf/open/floor,
/area/bigredv3/inside/colony/hydroponics)
"OU" = (
/obj/structure/table,
/obj/effect/spawner/random/engineering/toolbox,
/obj/machinery/atmospherics/components/unary/vent_pump,
/turf/open/floor,
/area/bigredv3/inside/colony/dorm)
"Pl" = (
/obj/effect/decal/cleanable/dirt,
/obj/machinery/atmospherics/components/unary/vent_pump{
	dir = 4;
	on = 1
	},
/turf/open/floor/tile/dark,
/area/bigredv3/inside/colony/bar)
"Pn" = (
/obj/structure/rack,
/turf/open/floor/tile/dark,
/area/bigredv3/inside/colony/bar)
"PA" = (
/obj/machinery/atmospherics/pipe/manifold/green/hidden{
	dir = 4
	},
/obj/structure/cable,
/obj/effect/ai_node,
/turf/open/floor/asteroidfloor,
/area/bigredv3/outside/directions/ne)
"PG" = (
/obj/machinery/atmospherics/pipe/simple/green/hidden{
	dir = 4
	},
/obj/effect/spawner/gibspawner/human,
/turf/open/floor,
/area/bigredv3/inside/colony/dorm)
"RL" = (
/turf/open/floor,
/area/bigredv3/inside/colony/dorm)
"Sb" = (
/obj/machinery/atmospherics/pipe/simple/green/hidden{
	dir = 6
	},
/turf/open/floor,
/area/bigredv3/inside/colony/dorm/recreation)
"Sq" = (
/obj/machinery/atmospherics/pipe/simple/green/hidden{
	dir = 4
	},
/turf/open/floor,
/area/bigredv3/inside/colony/dorm/recreation)
"St" = (
/obj/structure/cable,
/obj/machinery/atmospherics/pipe/simple/green/hidden,
/turf/open/floor/asteroidfloor,
/area/bigredv3/outside/directions/ne)
"Ty" = (
/obj/machinery/atmospherics/pipe/simple/green/hidden,
/obj/structure/cable,
/turf/open/floor/tile/dark,
/area/bigredv3/inside/colony/bar)
"TC" = (
/obj/effect/ai_node,
/turf/open/floor/plating/ground/mars/random/sand,
/area/bigredv3/caves/northeast/garbledradio)
"UJ" = (
/obj/machinery/light{
	dir = 8
	},
/turf/open/floor/plating,
/area/bigredv3/inside/secondary/maintence)
"UM" = (
/obj/machinery/atmospherics/pipe/simple/green/hidden{
	dir = 4
	},
/turf/open/floor/freezer,
/area/bigredv3/inside/colony/dorm)
"UR" = (
/obj/effect/spawner/random/engineering/structure/tank_dispenser/oxygenweighted,
/turf/open/floor/tile/dark,
/area/bigredv3/inside/colony/bar)
"UU" = (
/obj/effect/decal/cleanable/dirt,
/obj/machinery/atmospherics/pipe/simple/green/hidden{
	dir = 6
	},
/obj/effect/ai_node,
/turf/open/floor,
/area/bigredv3/inside/colony/dorm)
"Vo" = (
/obj/structure/window/framed/colony,
/obj/machinery/door/poddoor/shutters/mainship{
	id = "Greenhouse";
	name = "\improper Greenhouse Shutters"
	},
/turf/open/floor/plating,
/area/bigredv3/inside/wall)
"Vp" = (
/obj/structure/table,
/turf/open/floor/tile/dark,
/area/bigredv3/inside/colony/bar)
"Vv" = (
/obj/machinery/atmospherics/pipe/manifold/green/hidden{
	dir = 4
	},
/obj/structure/cable,
/obj/effect/ai_node,
/turf/open/floor/tile/dark,
/area/bigredv3/inside/colony/bar)
"Vy" = (
/obj/structure/table,
/obj/effect/spawner/random/engineering/toolbox,
/obj/item/stack/cable_coil,
/turf/open/floor,
/area/bigredv3/inside/colony/dorm)
"XG" = (
/turf/closed/wall,
/area/bigredv3/inside/wall)
"Ym" = (
/obj/machinery/light{
	dir = 1
	},
/turf/open/floor,
/area/bigredv3/inside/colony/dorm)
"Yq" = (
/obj/effect/ai_node,
/turf/open/floor/tile/dark,
/area/bigredv3/inside/colony/bar)
"Yy" = (
/obj/machinery/atmospherics/pipe/simple/green/hidden,
/obj/structure/cable,
/obj/effect/spawner/gibspawner/human,
/turf/open/floor,
/area/bigredv3/inside/colony/dorm)
"YR" = (
/obj/machinery/light,
/obj/effect/decal/cleanable/dirt,
/turf/open/floor,
/area/bigredv3/inside/colony/dorm)
"YW" = (
/obj/structure/cable,
/turf/open/floor/tile/dark,
/area/bigredv3/inside/colony/bar)
"Zw" = (
/obj/effect/decal/cleanable/blood/oil,
/turf/open/floor,
/area/bigredv3/inside/colony/dorm)
"ZF" = (
/obj/structure/cable,
/obj/machinery/atmospherics/pipe/manifold/green/hidden{
	dir = 8
	},
/turf/open/floor/tile/dark,
/area/bigredv3/inside/colony/bar)
"ZR" = (
/turf/open/floor/plating/ground/mars/random/sand,
/area/bigredv3/caves/northeast/garbledradio)
"ZS" = (
/obj/machinery/atmospherics/pipe/simple/green/hidden{
	dir = 4
	},
/turf/open/floor/tile/dark,
/area/bigredv3/inside/colony/bar)
"ZT" = (
/obj/effect/decal/cleanable/dirt,
/obj/machinery/atmospherics/pipe/simple/green/hidden{
	dir = 9
	},
/turf/open/floor,
/area/bigredv3/inside/colony/dorm)

(1,1,1) = {"
IP
IP
vG
iZ
iZ
Sb
fi
vI
fi
fi
fi
fi
fi
fi
uR
iZ
iZ
zC
XG
hQ
mi
ru
ru
XG
"}
(2,1,1) = {"
IP
IP
XG
XG
XG
pk
XG
XG
XG
XG
XG
XG
XG
jt
Sq
ws
EZ
tq
XG
ru
mi
ru
ru
XG
"}
(3,1,1) = {"
IP
IP
XG
wO
xA
UM
xA
Lx
XG
km
oF
oF
XG
RL
rG
RL
XG
XG
XG
XG
vi
XG
XG
XG
"}
(4,1,1) = {"
IP
IP
XG
Iz
xA
UM
xA
Iz
XG
Ym
nn
RL
XG
me
jb
ps
JR
ux
EL
XG
Nn
Nk
Lp
XG
"}
(5,1,1) = {"
IP
IP
XG
Iz
xA
uZ
xA
bk
XG
RL
nn
RL
XG
nn
rG
Zw
XG
pL
NJ
XG
Nn
Nk
Lp
XG
"}
(6,1,1) = {"
IP
IP
XG
Iz
jn
cg
xA
Mg
XG
fV
nn
RL
XG
nn
PG
GO
XG
XG
XG
XG
Nn
Nk
Lp
XG
"}
(7,1,1) = {"
CS
CS
XG
Iz
xA
cW
Ox
Iz
XG
cC
RL
ps
Ds
GG
rf
wD
JR
ux
EL
XG
Nn
Nk
Lp
XG
"}
(8,1,1) = {"
Nu
CS
XG
bk
ks
yc
xA
Iz
XG
Vy
UU
uJ
Ba
Ba
uG
RL
XG
pL
NJ
XG
hy
Nk
nh
fS
"}
(9,1,1) = {"
CS
Nu
XG
Iz
xA
xA
xA
oi
XG
OU
ZT
nn
XG
eP
rG
RL
XG
XG
XG
XG
KG
Nk
Lp
bh
"}
(10,1,1) = {"
CS
Nu
XG
XG
XG
XG
XG
XG
XG
kI
me
YR
XG
rW
rG
yy
JR
ux
EL
XG
Nn
Nk
Lp
nh
"}
(11,1,1) = {"
ZR
Oq
XG
ru
Cj
UJ
ru
ru
XG
kI
nn
nn
XG
nn
xZ
RL
XG
pL
NJ
XG
Nn
Nk
XG
Vo
"}
(12,1,1) = {"
TC
Oq
wP
ru
aC
ru
ru
ru
wo
RL
lJ
RL
XG
Ez
rG
GO
XG
XG
XG
XG
hy
Nk
Bh
rH
"}
(13,1,1) = {"
ZR
Oq
XG
XG
GV
XG
XG
XG
XG
XG
XG
XG
XG
st
rq
dH
iP
St
eK
St
PA
St
no
Fu
"}
(14,1,1) = {"
ZR
Oq
XG
Ew
YW
cy
UR
Vp
XG
AR
AR
jO
XG
RL
cK
lJ
RL
Fd
Fd
dl
Dg
qr
XG
rH
"}
(15,1,1) = {"
ZR
Oq
XG
Ew
YW
fZ
fE
Vp
XG
fZ
fZ
fE
XG
qq
cK
RL
XG
XG
XG
XG
fS
fS
Bh
rH
"}
(16,1,1) = {"
ZR
Oq
XG
OE
EG
fZ
fZ
Vp
Oc
fZ
Pl
fE
Oc
RL
Mv
Zw
JR
xU
EL
XG
fS
fS
Bh
rH
"}
(17,1,1) = {"
bQ
Nu
XG
Ew
nj
DU
Cc
ZF
ya
Ty
Vv
Ty
ya
Yy
nD
RL
XG
pL
NJ
XG
fS
jz
XG
rH
"}
(18,1,1) = {"
GP
Nu
XG
Ew
ZS
fZ
fE
By
Oc
fE
fE
fE
Oc
nn
RL
RL
XG
XG
XG
XG
fS
fS
Bh
rH
"}
(19,1,1) = {"
GP
Nu
XG
Ew
ZS
fE
fE
cD
XG
mp
fE
Bl
XG
DY
ps
yy
JR
ux
EL
XG
fS
fS
Bh
rH
"}
(20,1,1) = {"
pF
Nu
XG
bC
ZS
fE
UR
Vp
XG
jO
jO
jO
XG
RL
RL
GO
XG
pL
NJ
XG
fS
fS
XG
Oc
"}
(21,1,1) = {"
GP
Nu
iw
rN
Jj
rN
rN
iw
iw
iw
iw
iw
iw
nn
RL
RL
XG
XG
XG
XG
fS
Kx
XG
Ei
"}
(22,1,1) = {"
CS
Nu
iw
Ef
ZS
zn
fZ
yb
fZ
pX
fE
av
iw
nn
ps
RL
XG
CS
fS
fS
fS
fS
XG
dL
"}
(23,1,1) = {"
CS
Nu
iw
fE
ZS
fE
fZ
fZ
fZ
fE
fZ
fE
iw
Fl
sT
yy
XG
CS
fS
fS
jz
fS
XG
JY
"}
(24,1,1) = {"
CS
Nu
iw
fE
dz
fE
fE
fE
fE
fE
Yq
fE
iw
nn
RL
ps
XG
CS
CS
fS
fS
fS
XG
fJ
"}
(25,1,1) = {"
CS
Nu
iw
Pn
fE
dC
fE
DD
fE
aV
fE
iA
iw
ps
RL
RL
XG
CS
CS
fS
fS
fS
XG
qc
"}
(26,1,1) = {"
CS
Nu
iw
iw
iw
iw
iw
iw
iw
iw
iw
iw
iw
pE
gC
KL
XG
CS
CS
fS
fS
fS
XG
OO
"}
