//MAP CONVERTED BY dmm2tgm.py THIS HEADER COMMENT PREVENTS RECONVERSION, DO NOT REMOVE
"aa" = (
/obj/machinery/vending/snack,
/turf/open/floor,
/area/bigredv2/outside/engineering/east)
"ax" = (
/obj/machinery/door_control{
	dir = 1;
	id = "Engineering";
	name = "Storm Shutters"
	},
/turf/open/floor,
/area/bigredv2/outside/engineering/east)
"bb" = (
/obj/structure/rack,
/obj/item/camera_film,
/turf/open/floor,
/area/bigredv2/outside/engineering)
"bq" = (
/obj/machinery/light{
	dir = 4
	},
/obj/effect/decal/cleanable/dirt,
/turf/open/floor,
/area/bigredv2/outside/engineering)
"bN" = (
/obj/structure/table,
/obj/item/tool/lighter/random,
/turf/open/floor,
/area/bigredv2/outside/engineering)
"cD" = (
/obj/effect/decal/cleanable/dirt,
/obj/machinery/air_alarm{
	dir = 1
	},
/turf/open/floor,
/area/bigredv2/outside/engineering)
"cL" = (
/turf/open/floor/marking/asteroidwarning{
	dir = 4
	},
/area/bigredv2/outside/c)
"dv" = (
/obj/effect/landmark/excavation_site_spawner,
/turf/open/floor,
/area/bigredv2/outside/engineering)
"dw" = (
/obj/machinery/atmospherics/pipe/simple/green/hidden{
	dir = 5
	},
/obj/effect/ai_node,
/obj/structure/cable,
/turf/open/floor,
/area/bigredv2/outside/engineering/east)
"dY" = (
/turf/open/floor/plating/ground/mars/cavetodirt{
	dir = 10
	},
/area/bigredv2/caves/southwest)
"eh" = (
/obj/structure/bed/chair{
	dir = 8
	},
/turf/open/floor,
/area/bigredv2/outside/engineering/east)
"en" = (
/obj/effect/decal/cleanable/dirt,
/obj/machinery/atmospherics/pipe/simple/green/hidden{
	dir = 4
	},
/obj/structure/cable,
/turf/open/floor,
/area/bigredv2/outside/engineering)
"ep" = (
/obj/machinery/atmospherics/pipe/manifold/green/hidden{
	dir = 8
	},
/obj/effect/ai_node,
/obj/structure/cable,
/turf/open/floor,
/area/bigredv2/outside/engineering)
"eu" = (
/obj/machinery/atmospherics/pipe/simple/green/hidden,
/obj/machinery/door/airlock/mainship/engineering/free_access{
	dir = 1;
	name = "\improper Chief Engineer's Office"
	},
/obj/structure/cable,
/turf/open/floor,
/area/bigredv2/outside/engineering/east)
"fr" = (
/obj/structure/bed/chair{
	dir = 4
	},
/turf/open/floor,
/area/bigredv2/outside/engineering/east)
"ge" = (
/obj/effect/decal/cleanable/dirt,
/obj/structure/sign/safety/electronics{
	dir = 1
	},
/turf/open/floor,
/area/bigredv2/outside/engineering)
"gv" = (
/turf/open/floor/plating/ground/mars/dirttosand/autosmooth{
	dir = 5
	},
/area/bigredv2/caves/southwest)
"gF" = (
/obj/structure/closet/radiation,
/turf/open/floor,
/area/bigredv2/outside/engineering)
"hE" = (
/obj/machinery/atmospherics/pipe/simple/green/hidden,
/obj/machinery/door/airlock/mainship/engineering/free_access{
	dir = 1;
	name = "\improper Engineering Tool Storage"
	},
/obj/structure/cable,
/turf/open/floor,
/area/bigredv2/outside/engineering)
"hL" = (
/obj/machinery/atmospherics/pipe/simple/green/hidden{
	dir = 10
	},
/obj/structure/cable,
/turf/open/floor,
/area/bigredv2/outside/engineering/east)
"hV" = (
/obj/machinery/computer/atmos_alert,
/obj/structure/table,
/turf/open/floor,
/area/bigredv2/outside/engineering/east)
"iu" = (
/obj/effect/decal/cleanable/dirt,
/obj/structure/cable,
/turf/open/floor,
/area/bigredv2/outside/engineering)
"iz" = (
/obj/effect/ai_node,
/turf/open/floor/plating/ground/mars/dirttosand/autosmooth{
	dir = 5
	},
/area/bigredv2/caves/southwest)
"jf" = (
/obj/machinery/door/airlock/mainship/engineering/free_access{
	name = "\improper Engine Reactor Control"
	},
/turf/open/floor,
/area/bigredv2/outside/engineering/east)
"jo" = (
/obj/effect/decal/cleanable/dirt,
/obj/effect/spawner/random/machinery/machine_frame,
/turf/open/floor,
/area/bigredv2/outside/engineering)
"jG" = (
/obj/structure/table,
/obj/effect/spawner/random/engineering/tool,
/obj/effect/spawner/random/engineering/technology_scanner,
/turf/open/floor,
/area/bigredv2/outside/engineering)
"kp" = (
/obj/effect/spawner/random/machinery/machine_frame,
/turf/open/floor,
/area/bigredv2/outside/engineering)
"kq" = (
/obj/structure/table,
/obj/machinery/light,
/obj/effect/spawner/random/engineering/tool,
/turf/open/floor,
/area/bigredv2/outside/engineering)
"kF" = (
/turf/open/floor/plating/ground/mars/dirttosand/autosmooth{
	dir = 9
	},
/area/bigredv2/caves/southwest)
"kJ" = (
/obj/effect/decal/cleanable/dirt,
/obj/item/stack/sheet/metal{
	amount = 30
	},
/turf/open/floor,
/area/bigredv2/outside/engineering)
"lf" = (
/obj/structure/table,
/obj/effect/spawner/random/engineering/toolbox,
/obj/effect/decal/cleanable/dirt,
/turf/open/floor,
/area/bigredv2/outside/engineering)
"lA" = (
/obj/effect/ai_node,
/turf/open/floor/plating/ground/mars/random/dirt,
/area/bigredv2/outside/sw)
"mr" = (
/obj/structure/table,
/obj/effect/decal/cleanable/dirt,
/obj/item/tool/pen,
/turf/open/floor,
/area/bigredv2/outside/engineering)
"mV" = (
/turf/closed/wall/r_wall,
/area/bigredv2/outside/engineering/east)
"nC" = (
/obj/structure/table,
/obj/effect/decal/cleanable/dirt,
/obj/item/clothing/glasses/welding,
/turf/open/floor,
/area/bigredv2/outside/engineering/east)
"ox" = (
/obj/effect/ai_node,
/turf/open/floor/plating/ground/mars/random/sand,
/area/bigredv2/caves/southwest)
"oC" = (
/obj/effect/decal/cleanable/dirt,
/obj/machinery/atmospherics/pipe/simple/green/hidden,
/turf/open/floor,
/area/bigredv2/outside/engineering)
"oK" = (
/obj/machinery/light{
	dir = 8
	},
/obj/effect/spawner/random/misc/structure/supplycrate,
/turf/open/floor,
/area/bigredv2/outside/engineering)
"pZ" = (
/obj/effect/spawner/random/engineering/structure/tank/waterweighted,
/obj/effect/decal/cleanable/dirt,
/turf/open/floor,
/area/bigredv2/outside/engineering)
"ql" = (
/obj/effect/decal/cleanable/dirt,
/obj/effect/ai_node,
/turf/open/floor,
/area/bigredv2/outside/engineering)
"qm" = (
/turf/open/floor/plating/ground/mars/random/cave/rock,
/area/bigredv2/caves/southwest)
"qO" = (
/obj/effect/decal/cleanable/dirt,
/obj/item/lightreplacer,
/turf/open/floor,
/area/bigredv2/outside/engineering)
"rP" = (
/obj/effect/decal/cleanable/dirt,
/turf/open/floor,
/area/bigredv2/outside/engineering)
"sd" = (
/obj/effect/decal/cleanable/dirt,
/obj/item/clothing/mask/breath,
/turf/open/floor,
/area/bigredv2/outside/engineering)
"sg" = (
/obj/machinery/atmospherics/pipe/simple/green/hidden{
	dir = 4
	},
/obj/machinery/door/airlock/multi_tile/mainship/generic{
	dir = 1;
	name = "\improper Engineering Complex"
	},
/obj/structure/cable,
/turf/open/floor,
/area/bigredv2/outside/engineering/east)
"sw" = (

/turf/open/floor,
/area/bigredv2/outside/engineering/east)
"sL" = (
/obj/machinery/atmospherics/pipe/simple/green/hidden,
/turf/open/floor,
/area/bigredv2/outside/engineering/east)
"sZ" = (
/obj/machinery/atmospherics/pipe/manifold/green/hidden,
/obj/effect/ai_node,
/obj/structure/cable,
/turf/open/floor,
/area/bigredv2/outside/engineering/east)
"tt" = (
/obj/structure/table,
/obj/effect/spawner/random/misc/earmuffs,
/turf/open/floor,
/area/bigredv2/outside/engineering/east)
"tv" = (
/obj/machinery/atmospherics/pipe/simple/green/hidden{
	dir = 4
	},
/obj/structure/cable,
/turf/open/floor,
/area/bigredv2/outside/engineering/east)
"tR" = (
/obj/machinery/bot/mulebot,
/turf/open/floor,
/area/bigredv2/outside/engineering)
"tV" = (
/turf/open/floor/plating/ground/mars/random/dirt,
/area/bigredv2/outside/s)
"uk" = (
/obj/effect/decal/cleanable/dirt,

/turf/open/floor,
/area/bigredv2/outside/engineering)
"uD" = (
/obj/machinery/atmospherics/pipe/manifold/green/hidden{
	dir = 4
	},
/obj/structure/cable,
/turf/open/floor,
/area/bigredv2/outside/engineering)
"uO" = (
/turf/open/floor/plating/ground/mars/random/dirt,
/area/bigredv2/caves/southwest)
"vk" = (
/turf/open/floor/plating/ground/mars/dirttosand/autosmooth,
/area/bigredv2/caves/southwest)
"vR" = (
/obj/effect/decal/cleanable/dirt,
/obj/machinery/atmospherics/pipe/simple/green/hidden{
	dir = 4
	},
/obj/effect/ai_node,
/obj/structure/cable,
/turf/open/floor,
/area/bigredv2/outside/engineering)
"wm" = (
/turf/open/floor/plating/ground/mars/random/sand,
/area/bigredv2/outside/s)
"wo" = (
/obj/effect/decal/cleanable/dirt,
/obj/machinery/atmospherics/components/unary/vent_pump{
	dir = 1;
	on = 1
	},
/turf/open/floor,
/area/bigredv2/outside/engineering/east)
"wr" = (
/obj/machinery/atmospherics/pipe/simple/green/hidden,
/obj/effect/ai_node,
/obj/structure/cable,
/turf/open/floor,
/area/bigredv2/outside/engineering/east)
"wt" = (
/obj/structure/window/framed/colony,
/turf/open/floor/plating,
/area/bigredv2/outside/engineering)
"wW" = (
/obj/structure/table,
/obj/effect/spawner/random/engineering/tool,
/turf/open/floor,
/area/bigredv2/outside/engineering)
"xf" = (
/turf/open/floor/plating/ground/mars/cavetodirt{
	dir = 8
	},
/area/bigredv2/caves/southwest)
"xn" = (
/obj/structure/rack,
/obj/item/tool/analyzer,
/turf/open/floor,
/area/bigredv2/outside/engineering)
"xI" = (
/turf/closed/wall/r_wall,
/area/bigredv2/outside/s)
"xP" = (
/obj/machinery/atmospherics/pipe/simple/green/hidden,
/obj/structure/cable,
/turf/open/floor,
/area/bigredv2/outside/engineering/east)
"yb" = (
/obj/machinery/door/airlock/mainship/engineering/free_access{
	dir = 1;
	name = "\improper Engine Reactor Control"
	},
/obj/machinery/atmospherics/pipe/simple/green/hidden,
/turf/open/floor,
/area/bigredv2/outside/engineering/east)
"yf" = (
/turf/open/floor/plating/ground/mars/random/dirt,
/area/bigredv2/outside/sw)
"yz" = (
/obj/machinery/atmospherics/pipe/simple/green/hidden,
/obj/machinery/power/apc/high/ntf{
	dir = 8
	},
/obj/structure/cable,
/turf/open/floor,
/area/bigredv2/outside/engineering/east)
"yB" = (
/obj/machinery/computer/station_alert,
/obj/structure/table,
/turf/open/floor,
/area/bigredv2/outside/engineering/east)
"zj" = (
/obj/structure/table,
/obj/effect/spawner/random/engineering/toolbox,
/turf/open/floor,
/area/bigredv2/outside/engineering)
"Ao" = (
/turf/closed/wall,
/area/bigredv2/outside/engineering/east)
"At" = (
/obj/machinery/door_control{
	desc = "A remote control-switch for opening the engines blast doors.";
	dir = 8;
	id = "rad_door";
	name = "Reactor Radiation Shielding control"
	},
/turf/open/floor,
/area/bigredv2/outside/engineering/east)
"Ax" = (
/obj/machinery/atmospherics/pipe/simple/green/hidden,
/obj/effect/decal/cleanable/dirt,
/obj/structure/cable,
/turf/open/floor,
/area/bigredv2/outside/engineering/east)
"Az" = (
/obj/effect/decal/cleanable/dirt,
/obj/machinery/door/airlock/mainship/secure/free_access{
	name = "\improper Engineering Secure Storage"
	},
/obj/structure/cable,
/turf/open/floor,
/area/bigredv2/outside/engineering)
"AA" = (
/obj/docking_port/stationary/crashmode,
/turf/closed/wall/r_wall,
/area/bigredv2/outside/engineering)
"AQ" = (
/obj/effect/decal/cleanable/dirt,
/obj/item/clothing/head/welding,
/turf/open/floor,
/area/bigredv2/outside/engineering/east)
"AS" = (
/obj/effect/decal/cleanable/dirt,
/obj/machinery/atmospherics/components/unary/vent_pump{
	dir = 1;
	on = 1
	},
/turf/open/floor,
/area/bigredv2/outside/engineering)
"Bi" = (
/turf/open/floor/plating/ground/mars/random/cave,
/area/bigredv2/caves/southwest)
"Bn" = (
/obj/effect/ai_node,
/turf/open/floor/plating/ground/mars/random/cave,
/area/bigredv2/caves/southwest)
"Ca" = (
/turf/open/floor/plating/ground/mars/random/sand,
/area/bigredv2/outside/c)
"Cj" = (
/turf/open/floor/plating/ground/mars/dirttosand/autosmooth{
	dir = 8
	},
/area/bigredv2/outside/sw)
"CN" = (
/obj/structure/table,
/obj/item/tool/lighter/random,
/obj/item/lightreplacer,
/turf/open/floor,
/area/bigredv2/outside/engineering/east)
"CS" = (
/turf/open/floor/plating/ground/mars/cavetodirt{
	dir = 5
	},
/area/bigredv2/caves/southwest)
"Ds" = (
/obj/machinery/atmospherics/pipe/simple/green/hidden{
	dir = 4
	},
/obj/structure/cable,
/turf/open/floor,
/area/bigredv2/outside/engineering)
"Dx" = (
/obj/machinery/computer/arcade,
/turf/open/floor,
/area/bigredv2/outside/engineering/east)
"DH" = (

/turf/open/floor,
/area/bigredv2/outside/engineering)
"DQ" = (
/turf/open/floor/plating/ground/mars/cavetodirt{
	dir = 1
	},
/area/bigredv2/caves/southwest)
"EH" = (
/obj/machinery/atmospherics/pipe/simple/green/hidden{
	dir = 4
	},
/obj/machinery/door/airlock/mainship/engineering/free_access{
	name = "\improper Engineering Workshop"
	},
/obj/structure/cable,
/turf/open/floor,
/area/bigredv2/outside/engineering)
"Fi" = (
/obj/effect/ai_node,
/turf/open/floor/plating/ground/mars/cavetodirt{
	dir = 8
	},
/area/bigredv2/caves/southwest)
"Fq" = (
/obj/effect/decal/cleanable/dirt,
/obj/machinery/atmospherics/pipe/simple/green/hidden{
	dir = 4
	},
/obj/structure/cable,
/turf/open/floor,
/area/bigredv2/outside/engineering/east)
"Ge" = (
/obj/item/stack/sheet/glass/glass,
/turf/open/floor,
/area/bigredv2/outside/engineering)
"Gp" = (
/obj/effect/landmark/start/job/survivor,
/obj/effect/landmark/start/latejoinsurvivor,
/turf/open/floor,
/area/bigredv2/outside/engineering/east)
"Gw" = (
/obj/machinery/light{
	dir = 4
	},
/obj/effect/decal/cleanable/dirt,
/turf/open/floor,
/area/bigredv2/outside/engineering/east)
"GE" = (
/obj/effect/decal/cleanable/dirt,
/obj/structure/sign/safety/electronics{
	dir = 1
	},
/obj/structure/cable,
/turf/open/floor,
/area/bigredv2/outside/engineering)
"GH" = (
/turf/closed/wall/r_wall,
/area/bigredv2/outside/engineering)
"HC" = (
/obj/machinery/atmospherics/pipe/simple/green/hidden,
/obj/structure/cable,
/turf/open/floor,
/area/bigredv2/outside/engineering)
"Ie" = (
/obj/machinery/atmospherics/pipe/simple/green/hidden{
	dir = 4
	},
/obj/effect/decal/cleanable/dirt,
/obj/structure/cable,
/turf/open/floor,
/area/bigredv2/outside/engineering)
"Jb" = (
/turf/open/floor/plating/ground/mars/dirttosand/autosmooth{
	dir = 9
	},
/area/bigredv2/outside/s)
"Jc" = (
/obj/machinery/atmospherics/components/unary/vent_pump,
/turf/open/floor,
/area/bigredv2/outside/engineering)
"Jl" = (
/turf/open/floor/plating/ground/mars/cavetodirt{
	dir = 9
	},
/area/bigredv2/caves/southwest)
"Jq" = (
/turf/open/floor,
/area/bigredv2/outside/engineering)
"JU" = (
/obj/machinery/atmospherics/pipe/simple/green/hidden,
/turf/open/floor,
/area/bigredv2/outside/engineering)
"JW" = (
/obj/structure/bed/chair/office/light{
	dir = 4
	},
/turf/open/floor,
/area/bigredv2/outside/engineering)
"Kt" = (
/obj/machinery/door/airlock/mainship/engineering/free_access{
	dir = 1;
	name = "\improper Engineering SMES"
	},
/turf/open/floor/plating,
/area/bigredv2/outside/engineering)
"KS" = (
/obj/machinery/atmospherics/pipe/manifold/green/hidden{
	dir = 4
	},
/obj/effect/ai_node,
/obj/structure/cable,
/turf/open/floor,
/area/bigredv2/outside/engineering/east)
"KV" = (
/obj/structure/table,
/obj/effect/spawner/random/engineering/toolbox,
/turf/open/floor,
/area/bigredv2/outside/engineering/east)
"LF" = (
/turf/closed/mineral/smooth/bigred,
/area/bigredv2/caves/rock)
"LM" = (
/obj/effect/spawner/random/engineering/structure/tank/fuelweighted,
/turf/open/floor,
/area/bigredv2/outside/engineering)
"LR" = (
/obj/effect/ai_node,
/turf/open/floor/plating/ground/mars/random/dirt,
/area/bigredv2/outside/s)
"LU" = (
/obj/structure/table,
/obj/item/tool/lighter/random,
/turf/open/floor,
/area/bigredv2/outside/engineering/east)
"MD" = (
/obj/machinery/atmospherics/pipe/simple/green/hidden,
/obj/machinery/door/airlock/mainship/engineering/free_access{
	dir = 1;
	name = "\improper Engineering Lockers"
	},
/obj/structure/cable,
/turf/open/floor,
/area/bigredv2/outside/engineering)
"Ns" = (
/obj/effect/ai_node,
/obj/structure/cable,
/turf/open/floor,
/area/bigredv2/outside/engineering)
"NA" = (
/obj/effect/decal/cleanable/dirt,
/obj/effect/ai_node,
/turf/open/floor,
/area/bigredv2/outside/engineering/east)
"Oc" = (
/obj/effect/decal/cleanable/dirt,
/obj/effect/landmark/excavation_site_spawner,
/turf/open/floor,
/area/bigredv2/outside/engineering)
"Ow" = (
/obj/structure/bed/chair/office/light,
/turf/open/floor,
/area/bigredv2/outside/engineering/east)
"OF" = (
/obj/machinery/computer/area_atmos,
/turf/open/floor,
/area/bigredv2/outside/engineering/east)
"OH" = (
/turf/open/floor/plating/ground/mars/dirttosand/autosmooth{
	dir = 8
	},
/area/bigredv2/caves/southwest)
"OK" = (
/obj/machinery/vending/cigarette/colony,
/turf/open/floor,
/area/bigredv2/outside/engineering/east)
"ON" = (
/obj/machinery/atmospherics/components/unary/vent_pump{
	dir = 8;
	on = 1
	},
/turf/open/floor,
/area/bigredv2/outside/engineering/east)
"Pc" = (
/obj/machinery/atmospherics/pipe/manifold/green/hidden{
	dir = 8
	},
/obj/structure/cable,
/turf/open/floor,
/area/bigredv2/outside/engineering/east)
"Pp" = (
/turf/open/floor/plating/ground/mars/dirttosand/autosmooth{
	dir = 4
	},
/area/bigredv2/caves/southwest)
"Pt" = (
/turf/closed/wall,
/area/bigredv2/outside/engineering)
"Px" = (
/obj/effect/decal/cleanable/dirt,
/obj/machinery/door/airlock/multi_tile/mainship/generic{
	name = "\improper Engineering Complex"
	},
/turf/open/floor,
/area/bigredv2/outside/engineering/east)
"Qn" = (
/obj/machinery/atmospherics/pipe/manifold/green/hidden{
	dir = 1
	},
/obj/effect/ai_node,
/obj/structure/cable,
/turf/open/floor,
/area/bigredv2/outside/engineering)
"Qt" = (
/obj/effect/decal/cleanable/dirt,
/obj/machinery/atmospherics/pipe/simple/green/hidden{
	dir = 5
	},
/obj/structure/cable,
/turf/open/floor,
/area/bigredv2/outside/engineering/east)
"Qv" = (
/obj/structure/bed/chair/office/light{
	dir = 8
	},
/turf/open/floor,
/area/bigredv2/outside/engineering/east)
"QC" = (
/turf/open/floor,
/area/bigredv2/outside/engineering/east)
"Sg" = (
/obj/machinery/atmospherics/pipe/simple/green/hidden,
/obj/effect/ai_node,
/obj/structure/cable,
/turf/open/floor,
/area/bigredv2/outside/engineering)
"Sp" = (
/turf/open/floor/plating/ground/mars/random/sand,
/area/bigredv2/outside/sw)
"Sr" = (
/obj/structure/table,
/obj/effect/spawner/random/engineering/powercell,
/turf/open/floor,
/area/bigredv2/outside/engineering)
"Sv" = (
/obj/machinery/light{
	dir = 8
	},
/turf/open/floor,
/area/bigredv2/outside/engineering/east)
"SP" = (
/obj/structure/cable,
/turf/open/floor,
/area/bigredv2/outside/engineering)
"Tg" = (
/turf/open/floor/plating/ground/mars/random/sand,
/area/bigredv2/caves/southwest)
"TD" = (
/obj/structure/bed/chair{
	dir = 4
	},
/obj/effect/decal/cleanable/dirt,
/turf/open/floor,
/area/bigredv2/outside/engineering/east)
"TL" = (
/obj/machinery/power/monitor{
	name = "Main Power Grid Monitoring"
	},
/turf/open/floor,
/area/bigredv2/outside/engineering/east)
"UB" = (
/obj/structure/table,
/obj/machinery/light{
	dir = 8
	},
/obj/effect/spawner/random/engineering/technology_scanner,
/turf/open/floor,
/area/bigredv2/outside/engineering/east)
"Vj" = (
/obj/structure/table,
/obj/item/tool/analyzer,
/turf/open/floor,
/area/bigredv2/outside/engineering/east)
"Vs" = (
/obj/machinery/atmospherics/pipe/simple/green/hidden{
	dir = 9
	},
/obj/effect/ai_node,
/obj/structure/cable,
/turf/open/floor,
/area/bigredv2/outside/engineering)
"VC" = (
/obj/effect/decal/cleanable/dirt,
/obj/item/tool/weldpack,
/turf/open/floor,
/area/bigredv2/outside/engineering)
"VI" = (
/obj/effect/decal/cleanable/dirt,
/obj/effect/decal/cleanable/blood/oil,
/turf/open/floor,
/area/bigredv2/outside/engineering/east)
"VL" = (
/turf/closed/wall/r_wall,
/area/bigredv2/caves/rock)
"VN" = (
/obj/machinery/computer/intel_computer,
/turf/open/floor,
/area/bigredv2/outside/engineering/east)
"Wi" = (
/obj/effect/decal/cleanable/dirt,
/turf/open/floor,
/area/bigredv2/outside/engineering/east)
"Ww" = (
/obj/effect/landmark/excavation_site_spawner,
/turf/open/floor,
/area/bigredv2/outside/engineering/east)
"WD" = (
/obj/machinery/light{
	dir = 1
	},
/obj/machinery/atmospherics/pipe/simple/green/hidden{
	dir = 4
	},
/obj/structure/cable,
/turf/open/floor,
/area/bigredv2/outside/engineering)
"Xk" = (
/obj/effect/ai_node,
/turf/open/floor/plating/ground/mars/random/dirt,
/area/bigredv2/caves/southwest)
"XH" = (
/turf/open/floor/plating/ground/mars/dirttosand/autosmooth{
	dir = 1
	},
/area/bigredv2/caves/southwest)
"Yq" = (
/obj/machinery/vending/cola,
/turf/open/floor,
/area/bigredv2/outside/engineering/east)
"Yy" = (
/obj/structure/table,
/turf/open/floor,
/area/bigredv2/outside/engineering/east)
"YE" = (
/obj/structure/table,
/obj/effect/spawner/random/engineering/tool,
/turf/open/floor,
/area/bigredv2/outside/engineering/east)
"YG" = (
/turf/open/floor/plating/ground/mars/cavetodirt{
	dir = 4
	},
/area/bigredv2/caves/southwest)
"Zq" = (
/obj/structure/window/framed/colony,
/turf/open/floor/plating,
/area/bigredv2/outside/engineering/east)
"Zt" = (
/obj/machinery/power/apc/high/ntf{
	dir = 4
	},
/obj/structure/cable,
/turf/open/floor,
/area/bigredv2/outside/engineering)
"ZK" = (
/obj/structure/table,
/obj/effect/spawner/random/engineering/tool,
/obj/effect/spawner/random/engineering/technology_scanner,
/turf/open/floor,
/area/bigredv2/outside/engineering/east)
"ZV" = (
/obj/structure/table,
/obj/effect/spawner/random/engineering/tool,
/obj/item/stack/sheet/metal{
	amount = 30
	},
/turf/open/floor,
/area/bigredv2/outside/engineering)

(1,1,1) = {"
Jq
Jc
uD
MD
HC
ep
oC
JU
oC
AS
kp
AA
Sp
Sp
Sp
LF
LF
Bi
Bi
Bi
Bi
Bi
Bi
Bi
Bi
Bi
Bi
"}
(2,1,1) = {"
GH
GH
GH
GH
Pt
Ds
uk
Jq
kJ
Jq
jo
GH
Cj
Cj
Cj
yf
LF
YG
YG
YG
YG
YG
YG
Bi
qm
Bi
Bi
"}
(3,1,1) = {"
Pt
ge
oK
Zt
Pt
Ds
Jq
JW
Jq
Jq
kq
GH
lA
yf
yf
yf
yf
Xk
uO
uO
uO
uO
Xk
DQ
Bn
qm
Bi
"}
(4,1,1) = {"
Kt
Ns
SP
iu
Pt
Ds
lf
Sr
mr
rP
ZV
GH
yf
yf
yf
yf
yf
uO
uO
uO
uO
uO
uO
DQ
Bi
Bi
Bi
"}
(5,1,1) = {"
Pt
GE
Jq
Jq
Pt
EH
wt
wt
wt
GH
GH
GH
LF
yf
yf
yf
yf
uO
uO
uO
uO
uO
Jl
Bi
Bi
LF
LF
"}
(6,1,1) = {"
Pt
SP
pZ
LM
Pt
Ds
Jq
rP
Jq
gF
gF
GH
LF
LF
LF
LF
LF
Pp
Pp
Pp
uO
uO
DQ
Bi
LF
LF
LF
"}
(7,1,1) = {"
Pt
Az
Pt
Pt
Pt
vR
Ge
Jq
ql
Jq
Jq
GH
LF
LF
LF
LF
LF
Tg
Tg
Tg
XH
uO
CS
YG
LF
LF
LF
"}
(8,1,1) = {"
Jq
iu
Pt
xn
bb
Ds
Jq
Jq
Jq
Jq
Jq
GH
LF
LF
LF
LF
LF
Tg
Tg
Tg
XH
uO
uO
uO
CS
Bi
LF
"}
(9,1,1) = {"
Jq
iu
wt
Jq
Jq
en
tR
Jq
tR
Jq
Jq
GH
LF
LF
LF
LF
Tg
ox
kF
OH
uO
Xk
uO
uO
uO
CS
Bi
"}
(10,1,1) = {"
Jq
iu
wt
Jq
sd
en
VC
DH
Jq
Jq
DH
GH
LF
LF
LF
Tg
Tg
kF
uO
Pp
Pp
LF
Fi
dY
uO
Xk
CS
"}
(11,1,1) = {"
HC
Sg
hE
ep
HC
Vs
Jq
Jq
Jq
dv
Jq
GH
LF
LF
Tg
Tg
kF
Xk
vk
Tg
Tg
LF
LF
Bi
xf
dY
uO
"}
(12,1,1) = {"
rP
rP
wt
Ie
rP
rP
uk
bq
rP
gF
gF
GH
LF
LF
Tg
Tg
XH
uO
vk
Tg
LF
LF
LF
LF
Bi
Bi
xf
"}
(13,1,1) = {"
Oc
bN
wt
Ie
rP
Ao
Ao
Ao
jf
Ao
Ao
mV
LF
LF
Tg
Tg
XH
uO
vk
LF
LF
LF
LF
LF
qm
Bi
qm
"}
(14,1,1) = {"
Jq
wW
Pt
Ds
DH
Ao
UB
YE
QC
sw
yB
mV
LF
LF
LF
Tg
XH
uO
vk
LF
LF
LF
LF
LF
LF
Bi
Bi
"}
(15,1,1) = {"
Jq
zj
wt
Ie
qO
Ao
QC
Qv
Wi
Ow
YE
mV
LF
LF
LF
Tg
XH
uO
vk
LF
LF
LF
LF
LF
LF
Bn
Bi
"}
(16,1,1) = {"
wW
jG
wt
Qn
oC
yb
sL
sL
wo
QC
TL
mV
LF
LF
LF
Tg
XH
uO
vk
LF
LF
LF
LF
LF
LF
Bi
Bi
"}
(17,1,1) = {"
Pt
Pt
Pt
WD
cD
Ao
Wi
Wi
Wi
Ow
Vj
mV
LF
LF
LF
LF
XH
uO
vk
LF
LF
LF
LF
LF
qm
Bi
Bi
"}
(18,1,1) = {"
Yy
Zq
Sv
tv
Wi
Ao
VN
At
QC
QC
hV
mV
LF
LF
LF
Tg
XH
uO
vk
Tg
LF
LF
LF
LF
Bi
qm
Bi
"}
(19,1,1) = {"
QC
Zq
QC
tv
ax
Ao
Ao
Ao
jf
Ao
Ao
mV
LF
LF
Tg
Tg
XH
uO
vk
Tg
LF
LF
LF
Bi
Bi
Bi
Bi
"}
(20,1,1) = {"
QC
Zq
QC
tv
Wi
QC
QC
Sv
QC
Wi
QC
mV
LF
Tg
Tg
Tg
gv
uO
uO
OH
CS
Bi
qm
Bi
Bi
Bi
Bi
"}
(21,1,1) = {"
xP
eu
xP
sZ
TD
fr
fr
Wi
Ww
Wi
QC
mV
LF
ox
Tg
Tg
Tg
iz
uO
uO
Xk
CS
YG
YG
YG
Bn
Bi
"}
(22,1,1) = {"
QC
Zq
QC
tv
nC
ZK
CN
Wi
QC
QC
QC
mV
LF
Tg
Tg
Tg
Tg
Tg
gv
Pp
uO
uO
uO
uO
uO
DQ
Bi
"}
(23,1,1) = {"
Ao
Ao
Gp
tv
KV
tt
LU
QC
QC
QC
OF
mV
LF
Tg
Tg
Tg
LF
LF
Tg
Tg
XH
uO
uO
uO
uO
DQ
Bi
"}
(24,1,1) = {"
Wi
Px
QC
tv
eh
eh
eh
Wi
Wi
QC
QC
mV
LF
LF
Tg
Tg
LF
LF
LF
Tg
XH
uO
uO
uO
uO
DQ
Bi
"}
(25,1,1) = {"
Ax
Ax
xP
KS
yz
xP
Pc
Qt
NA
QC
QC
mV
VL
LF
LF
LF
LF
LF
LF
Tg
XH
uO
uO
Jl
xf
Bi
qm
"}
(26,1,1) = {"
mV
mV
mV
mV
mV
Dx
ON
Fq
Wi
QC
QC
mV
VL
VL
LF
LF
LF
LF
Tg
Tg
XH
uO
uO
DQ
Bi
Bi
Bi
"}
(27,1,1) = {"
cL
cL
cL
cL
GH
mV
OK
Fq
AQ
QC
QC
mV
mV
mV
mV
LF
LF
LF
Tg
kF
uO
uO
uO
DQ
Bi
Bi
Bi
"}
(28,1,1) = {"
Ca
Ca
Ca
Ca
Ca
mV
aa
hL
wr
xP
xP
xP
xP
dw
mV
LF
LF
wm
Tg
XH
uO
uO
uO
DQ
Bi
qm
Bi
"}
(29,1,1) = {"
Ca
Ca
Ca
Ca
Ca
mV
Yq
QC
VI
Gw
Wi
QC
QC
tv
mV
wm
wm
wm
Jb
tV
LR
uO
uO
DQ
Bi
Bn
Bi
"}
(30,1,1) = {"
Ca
Ca
Ca
Ca
Ca
mV
mV
mV
mV
mV
mV
mV
QC
sg
mV
wm
wm
Jb
tV
tV
tV
xI
xI
xI
xI
xI
xI
"}
