//MAP CONVERTED BY dmm2tgm.py THIS HEADER COMMENT PREVENTS RECONVERSION, DO NOT REMOVE
"af" = (
/turf/open/floor/plating/ground/mars/random/cave,
/area/bigredv3/caves/east)
"ai" = (
/turf/open/floor/plating/ground/mars/random/cave/rock,
/area/bigredv3/caves/east/garbledradio)
"aj" = (
/turf/open/floor/plating/ground/mars/random/cave,
/area/bigredv3/caves/east/garbledradio)
"ak" = (
/obj/effect/landmark/xeno_silo_spawn,
/turf/open/floor/plating/ground/mars/random/cave,
/area/bigredv3/caves/east)
"ao" = (
/turf/open/floor/plating/ground/mars/random/cave/rock,
/area/bigredv3/caves/east)
"ap" = (
/obj/effect/landmark/lv624/fog_blocker,
/turf/closed/mineral/smooth/bigred,
/area/bigredv3/caves/rock)
"aq" = (
/obj/effect/landmark/xeno_silo_spawn,
/turf/open/floor/plating/ground/mars/random/cave,
/area/bigredv3/caves/east/garbledradio)
"ar" = (
/turf/closed/mineral/smooth/bigred,
/area/bigredv3/caves/rock)
"az" = (
/turf/closed/mineral/smooth/bigred/indestructible,
/area/space)
"aC" = (
/obj/effect/landmark/lv624/fog_blocker/xeno_spawn,
/turf/open/floor/plating/ground/mars/random/cave,
/area/bigredv3/caves/east/garbledradio)
"aE" = (
/obj/effect/landmark/lv624/fog_blocker/xeno_spawn,
/turf/open/floor/plating/ground/mars/random/cave/rock,
/area/bigredv3/caves/east/garbledradio)
"aG" = (
/turf/open/floor/plating/ground/mars/random/sand,
/area/bigredv3/outside/directions/se)
"aJ" = (
/obj/effect/landmark/lv624/fog_blocker/xeno_spawn,
/obj/effect/landmark/lv624/fog_blocker/xeno_spawn,
/turf/closed/mineral/smooth/bigred,
/area/bigredv3/caves/rock)
"aL" = (
/obj/effect/ai_node,
/turf/open/floor/plating/ground/mars/random/cave/rock,
/area/bigredv3/caves/east/garbledradio)
"aS" = (
/obj/effect/landmark/lv624/fog_blocker,
/turf/closed/wall/r_wall,
/area/bigredv3/caves/east/garbledradio)
"aT" = (
/obj/effect/ai_node,
/turf/open/floor/plating/ground/mars/random/cave,
/area/bigredv3/caves/east/garbledradio)
"aU" = (
/obj/effect/ai_node,
/turf/open/floor/plating/ground/mars/random/cave,
/area/bigredv3/caves/east)
"aW" = (
/obj/effect/landmark/lv624/fog_blocker/xeno_spawn,
/obj/effect/landmark/lv624/fog_blocker/xeno_spawn,
/turf/open/floor/plating/ground/mars/random/cave,
/area/bigredv3/caves/east/garbledradio)
"aX" = (
/obj/effect/landmark/lv624/fog_blocker/xeno_spawn,
/turf/closed/mineral/smooth/bigred,
/area/bigredv3/caves/rock)
"aY" = (
/obj/effect/landmark/lv624/fog_blocker/xeno_spawn,
/turf/open/floor/plating/ground/mars/random/cave,
/area/bigredv3/caves/east)
"gM" = (
/obj/structure/fence/standard/xenoproof,
/turf/open/floor/plating/ground/mars/random/cave,
/area/bigredv3/caves/east/garbledradio)
"xE" = (
/obj/effect/landmark/xeno_tunnel_spawn,
/turf/open/floor/plating/ground/mars/random/cave,
/area/bigredv3/caves/east/garbledradio)
"DC" = (
/obj/effect/ai_node,
/turf/open/floor/plating/ground/mars/random/sand,
/area/bigredv3/outside/directions/se)
"JU" = (
/obj/effect/landmark/xeno_tunnel_spawn,
/turf/open/floor/plating/ground/mars/random/cave,
/area/bigredv3/caves/east)

(1,1,1) = {"
aG
aG
aG
aG
aG
aG
aG
aG
aG
aG
aG
ar
ar
ar
aS
gM
gM
aj
aj
aj
aj
aj
aj
aj
aj
aj
aj
aj
ar
ar
ar
ar
ar
ar
ar
ar
ar
aj
aj
aj
aj
aj
"}
(2,1,1) = {"
aG
aG
aG
aG
aG
aG
aG
aG
aG
aG
aG
ar
ar
ar
ap
aj
aj
aj
aj
aj
aj
aj
aj
aj
aj
aj
aj
aj
ar
ar
ar
ar
ar
ar
ar
ar
ar
ar
aj
aj
aT
aj
"}
(3,1,1) = {"
aG
aG
aG
aG
aG
aG
aG
aG
aG
aG
aG
ar
ar
ar
ap
aj
aj
aj
aj
aj
aj
ar
ar
ar
ar
ar
aj
aj
aj
ar
ar
ar
ar
ar
ar
ar
ar
ar
aj
aj
aj
aj
"}
(4,1,1) = {"
aG
ar
ar
ar
ar
aG
aG
aG
aG
aG
aG
aG
ar
ar
ap
aj
aj
aj
aj
aj
aj
ar
ar
ar
ar
ar
ai
aj
aj
aj
aj
aj
aj
aj
aj
ar
ai
ai
aj
aj
aj
aj
"}
(5,1,1) = {"
aG
ar
ar
ar
ar
ar
ar
aG
aG
aG
aG
aG
aG
ar
ap
ar
aj
aW
aC
aC
aX
aX
aX
aX
aX
aX
aC
aE
aW
aj
aj
aj
aj
aj
aj
ai
aj
aj
aj
aj
aj
aj
"}
(6,1,1) = {"
aG
aG
ar
ar
ar
ar
ar
ar
aG
aG
aG
aG
aG
ar
ap
ar
ar
aC
aj
ar
ar
ar
ar
ar
ar
aj
aj
aj
aE
ai
aT
aj
aj
aj
aj
aj
aj
aj
aj
aj
aT
ai
"}
(7,1,1) = {"
aG
aG
aG
aG
aG
aG
aG
aG
aG
aG
aG
aG
aG
ar
ap
ar
ar
aC
aj
aj
aj
ar
aj
ar
ar
aj
aT
aj
aC
aT
aj
aj
aj
aj
aj
aj
aj
aj
aj
aj
aj
ai
"}
(8,1,1) = {"
aG
aG
aG
aG
aG
aG
aG
aG
aG
aG
aG
aG
aG
ar
ap
ar
ar
aX
aj
aj
aj
aT
aj
aj
aT
aT
aj
aj
aC
aj
aj
aj
aj
aj
aj
aj
ai
aj
aj
aj
ai
ar
"}
(9,1,1) = {"
aG
aG
aG
aG
aG
DC
aG
aG
aG
DC
aG
aG
aG
ar
ap
ar
ar
aX
aj
aj
aj
aj
aj
aj
aj
aj
aj
ar
aX
ar
ar
ar
aj
aj
aj
aj
aj
ai
aj
aj
aj
ai
"}
(10,1,1) = {"
aG
aG
aG
aG
aG
aG
aG
aG
aG
aG
aG
aG
ar
ar
ap
ar
ar
aX
ar
ar
aj
aj
aj
aj
aj
ar
ar
ar
aX
ar
ar
ar
ar
ar
ar
ar
aj
aj
aj
aj
aj
ai
"}
(11,1,1) = {"
aG
aG
ar
aG
aG
aG
aG
aG
aG
aG
aG
ar
ar
ar
ap
ar
ar
aX
ar
aj
aj
aj
aj
aj
aj
aj
ar
ar
aX
ar
ar
ar
ar
ar
ar
ar
aj
aj
aj
aj
aj
ai
"}
(12,1,1) = {"
aG
ar
ar
aG
aG
aG
aG
aG
aG
ar
ar
ar
ar
ar
ap
ar
ar
aX
aj
ai
aj
aj
ai
aj
aj
aj
ar
ar
aX
ar
ar
ar
ar
ar
ar
ar
aj
aj
aj
aj
aj
ai
"}
(13,1,1) = {"
ar
ar
ar
aG
aG
aG
aG
aG
aG
ar
ar
ar
ar
ar
ap
ar
ar
aX
aj
aj
aj
aj
aj
aj
aj
aj
ar
ar
aX
ar
ar
ar
ar
ar
ar
ar
ai
aj
aj
aj
ai
ar
"}
(14,1,1) = {"
ar
ar
aG
aG
aG
aG
aG
aG
aG
ar
ar
ar
ar
ar
ap
ar
ar
aX
aj
aj
aj
aT
aq
aj
aj
aj
aj
ar
aX
ar
ar
ar
ar
ar
ar
ar
aj
aj
aj
aj
aT
ai
"}
(15,1,1) = {"
ar
aG
aG
aG
aG
aG
ar
ar
ar
ar
ar
ar
ar
ar
ap
ar
ar
aX
xE
aj
aj
aj
aj
aj
aj
aj
ar
ar
aX
ar
ar
ar
ar
ar
ar
ar
ar
ai
aj
aj
aj
ai
"}
(16,1,1) = {"
aG
aG
aG
aG
aG
DC
ar
ar
ar
ar
ar
ar
ar
ar
ap
ar
ar
aX
ar
ar
ar
aj
aj
aj
aj
ar
ar
ar
aX
ar
ar
ar
ar
ar
ar
ar
ar
ar
aj
aj
aj
aj
"}
(17,1,1) = {"
aG
aG
aG
aG
aG
aG
ar
ar
ar
ar
ar
ar
ar
ar
ap
ar
ar
aX
ar
ar
ar
ar
ar
ar
ar
ar
ar
ar
aX
ar
ar
ar
ar
ar
ar
ar
ar
ar
aj
aj
aj
aj
"}
(18,1,1) = {"
ar
ar
ar
ar
ar
ar
ar
ar
ar
ar
ar
ar
ar
ar
ap
ar
ar
aJ
aX
aX
aX
aX
aX
aX
aX
aX
aX
aX
aJ
ar
ar
ar
ar
ar
ar
ar
aj
aj
aj
aj
aj
aj
"}
(19,1,1) = {"
ap
ap
ap
ap
ap
ap
ap
ap
ap
ap
ap
ap
ap
ap
ap
ar
ar
ar
ar
ar
ar
ar
ar
ar
ar
ar
ar
ar
ar
ar
ar
ar
ar
ar
ar
aj
aj
aj
aj
aj
aj
aj
"}
(20,1,1) = {"
ar
ar
ar
ar
ar
ar
ar
ar
ar
ar
ar
ar
ar
ar
ar
ar
ar
ar
ar
ar
ar
ar
ar
ar
ar
ar
ar
ar
ar
ar
ar
ar
ar
ar
aj
aj
aj
aj
aj
aj
aj
aj
"}
(21,1,1) = {"
ar
ar
ar
ar
ar
ar
ar
ar
ar
ar
ar
ar
ar
ar
ar
ar
ar
ar
ar
ar
ar
ar
ar
ar
ar
ar
ar
ar
ar
ar
ar
ar
aj
aj
aj
aj
aj
aj
aj
ai
aj
aj
"}
(22,1,1) = {"
ar
ai
ai
ai
ai
ai
ar
ar
ar
ar
ar
ar
ar
ar
ar
ar
ar
ar
ar
ar
ar
ar
ai
ai
ai
ai
ai
ar
ar
ar
aj
aj
aj
aT
aj
aj
aj
aj
aj
aj
aT
aj
"}
(23,1,1) = {"
ar
aT
aj
aj
aj
aj
aL
ar
ar
ar
ar
ar
ar
ar
ar
ar
ar
ar
aL
ai
ai
ai
aj
aj
aT
aj
aj
ai
ai
aj
aj
aj
aT
aj
aj
aj
ai
ar
ar
aj
aj
aj
"}
(24,1,1) = {"
ar
ai
aj
aj
aj
aj
ai
ar
ar
ar
ar
ar
ar
ar
ar
ar
ar
ar
aj
aj
aj
aj
aj
aj
aj
aj
aj
aj
aj
aj
ai
aj
aj
ai
aj
aj
ai
ar
ar
aj
aj
aj
"}
(25,1,1) = {"
ar
ar
ar
ai
aj
aj
ai
aj
aj
aj
aj
ar
ar
ar
ar
ar
ar
ai
aj
aj
aj
aj
aj
aj
aj
aj
aj
aj
aj
aj
aj
aj
ai
aj
aj
ai
ar
ar
ar
aj
aj
aj
"}
(26,1,1) = {"
ar
ar
ar
ar
ar
aj
ai
aj
aj
aj
aj
ar
ar
ar
ar
ai
ai
aj
aj
aj
aj
aj
aj
aj
aj
aj
aj
aj
aj
aj
aj
aj
aj
aj
ai
ar
ar
ar
ar
aj
aT
aj
"}
(27,1,1) = {"
ai
ai
ai
ai
ai
aj
ai
aj
aj
aj
aj
aj
aj
aj
aj
aj
aj
aj
aj
aj
aj
aj
aj
aj
aj
aj
aj
aj
aj
aj
aj
aj
aj
aj
aj
ai
ar
ai
ai
aj
aj
aj
"}
(28,1,1) = {"
aj
aj
aj
aj
aj
aj
aT
ai
ai
ai
ai
ai
ai
ai
aj
aj
aL
aj
aT
aj
aj
aj
aj
aj
aj
aj
aj
aj
aj
aj
aj
aj
aj
aj
aj
aj
ai
aj
aj
aj
aj
aj
"}
(29,1,1) = {"
aj
aj
aj
aj
aj
aj
aj
aj
aj
aj
aj
aj
aj
aj
aj
aj
ai
aj
aj
ai
aj
aj
aj
aj
aj
aj
aj
aj
aj
aj
aj
aj
aj
aj
aj
aj
aj
aj
aj
aj
aj
aj
"}
(30,1,1) = {"
aj
aj
aj
aj
aj
aj
aj
aj
aj
aj
aj
aj
aj
aj
aj
aj
aL
aj
aj
aj
aj
aj
aj
aj
aT
ai
aj
aj
aj
aj
aj
aj
aj
aT
aj
aj
aj
aj
aj
aj
aL
ar
"}
(31,1,1) = {"
aj
aj
aj
aj
aj
aj
aj
aj
aj
aj
aj
ai
ar
ar
aj
aj
ai
aj
aj
aj
aj
aj
aj
aj
aj
aT
aj
aj
aj
aj
aj
aj
aj
aj
aj
aj
aj
aj
aj
aj
ai
ar
"}
(32,1,1) = {"
ai
aj
aj
aj
aj
aj
aj
ar
ar
ar
ar
ar
ar
ar
ar
aj
ai
aj
aj
aj
aj
aj
aj
aj
aj
aj
aj
aj
aj
aj
aj
aj
aj
aj
aj
aj
aj
aj
aj
ai
aj
ar
"}
(33,1,1) = {"
aj
aj
aj
aj
aj
aj
aj
ar
ar
ar
ar
ar
ar
ar
ar
aj
ai
aj
aj
aj
aT
aj
aj
aj
aj
aj
aj
aj
ar
ar
ar
ar
ar
ar
aj
aj
aj
aj
ai
aj
aj
aj
"}
(34,1,1) = {"
ai
aj
aj
ai
aj
aj
aj
ar
ar
ar
ar
ar
ar
ar
ai
aj
aj
aj
aj
aj
aj
ar
ar
ar
ar
ar
ar
ar
ar
ar
ar
ar
ar
ar
aj
aj
aj
aj
ai
aj
aj
aj
"}
(35,1,1) = {"
ar
ai
aj
aj
aj
aj
aj
aj
ar
ar
ar
ar
ar
ai
aj
aj
aj
aj
aj
aj
ar
ar
ar
ar
ar
ar
ar
ar
ar
ar
ar
ar
ar
ar
ar
ar
ar
ar
ar
aj
aj
aj
"}
(36,1,1) = {"
ar
ar
ar
aj
aj
ai
aj
aj
aj
ar
ar
ar
ai
aj
aj
aj
aj
aj
aj
ar
ar
ar
ar
ar
ar
ar
ar
ar
ar
ar
ar
ar
ar
ar
ar
ar
ar
ar
ar
ar
aU
af
"}
(37,1,1) = {"
ar
ar
ar
aj
aj
ai
aT
aj
aj
ai
aj
aj
aj
aj
aj
aj
aL
ar
ar
ar
ar
ar
ar
ar
ar
ar
ar
ar
ar
ar
ar
ar
ar
ar
ar
ar
ar
ar
ar
ar
af
af
"}
(38,1,1) = {"
ar
ar
ar
aj
aj
aj
aj
aj
aj
aj
aj
aj
aj
aj
aj
ai
ai
ar
ar
ar
ar
ar
ar
ar
ar
ar
ar
ar
ar
ar
ar
ar
ar
ar
ar
ar
ar
ar
ar
ar
ar
af
"}
(39,1,1) = {"
ar
ar
ar
ar
aj
aj
aj
aj
aj
aj
aj
aj
aj
aj
aj
ar
ar
ar
ar
ar
ar
ar
ar
ar
ar
ar
ar
ar
ar
ar
ar
ar
ar
ar
ar
ar
ar
ar
ar
ar
ar
ar
"}
(40,1,1) = {"
ar
ar
ar
ar
aj
aj
aj
aj
aj
aj
aj
aj
aj
aj
aj
ar
ar
ar
ar
ar
ar
ar
ar
ar
ar
ar
ar
ar
ar
ar
ar
ar
ar
ar
ar
ar
ar
ar
ar
ar
ar
ar
"}
(41,1,1) = {"
ar
ar
ar
aj
aj
aj
aj
aj
aj
aj
aj
aj
aj
aj
ar
ar
ar
ar
ar
ar
ar
ar
ar
ar
ar
ar
ar
ar
ar
ar
ar
ar
ar
ar
ar
ar
ar
ar
ar
ar
ar
ar
"}
(42,1,1) = {"
ar
ar
ar
aj
aj
aj
aj
aj
aj
ar
ar
ar
ar
ar
ar
ar
ar
ar
ar
ar
ar
ar
ar
ar
ar
ar
ar
ar
ar
ar
ar
ar
ar
ar
ar
ar
ar
ar
ar
ar
ar
ar
"}
(43,1,1) = {"
ar
ar
aj
aj
aj
aj
aj
aj
aj
ar
ar
ar
ar
ar
ar
ar
ar
ar
ar
aX
aX
aX
aX
aX
aX
aX
aX
aX
aX
aX
aX
ar
ar
ar
ar
ar
ar
ar
ar
ar
ar
ar
"}
(44,1,1) = {"
ar
ar
aj
aj
af
af
aj
aj
ar
ar
ar
ar
ar
ar
ar
ar
ar
ar
ar
aX
ar
ar
ar
ar
ar
ar
ar
ar
ar
ar
aX
ar
ar
ar
ar
ar
ar
ar
ar
ar
ar
ar
"}
(45,1,1) = {"
ar
ar
af
af
af
af
af
af
ar
ar
ar
ar
ar
ar
ar
ar
ar
ar
ar
aX
ar
ar
ar
JU
af
af
af
af
ar
ar
aX
ar
ar
ar
ar
ar
ar
ar
ar
ar
ar
ar
"}
(46,1,1) = {"
af
af
af
af
af
af
af
af
ar
ar
ar
ar
ar
ar
ar
ar
ar
ar
ar
aX
ar
ar
af
af
af
af
ak
af
af
ar
aX
ar
ar
ar
af
af
af
af
af
af
af
af
"}
(47,1,1) = {"
af
af
aU
af
af
af
aU
ar
ar
ar
ar
ar
ar
ar
ar
ar
ar
ar
ar
aX
ar
ar
af
af
af
af
af
af
af
af
aX
ar
ar
ar
af
af
af
af
af
af
af
af
"}
(48,1,1) = {"
af
af
af
af
af
af
af
ar
ar
ar
ar
ar
ar
ar
ar
ar
ar
ar
ar
aX
ar
ar
af
af
af
af
af
af
af
af
aX
ar
ar
af
af
af
af
af
af
aU
af
af
"}
(49,1,1) = {"
af
af
aU
af
af
af
ar
ar
ar
ar
ar
ar
ar
ar
ar
ar
ar
ar
ar
aX
ar
af
af
af
af
af
af
af
af
af
aX
ar
ar
af
af
af
af
af
af
af
af
af
"}
(50,1,1) = {"
af
af
af
af
af
af
ar
ar
ar
ar
ar
ar
ar
ar
ar
ar
ar
ar
ar
aX
aY
aY
aY
aY
aY
aY
aY
aY
aY
aY
aY
af
af
af
af
af
af
af
af
af
af
af
"}
(51,1,1) = {"
af
af
af
af
af
af
ar
ar
ar
ar
ar
ar
ar
ar
ar
ar
ar
ar
ar
ar
af
af
af
af
af
af
af
af
af
af
af
af
af
af
af
af
af
af
af
af
af
af
"}
(52,1,1) = {"
af
ao
af
af
af
af
ar
ar
ar
af
af
af
af
af
af
af
af
af
af
af
af
af
af
af
af
af
af
af
af
af
aU
af
af
af
af
af
af
af
af
aU
af
af
"}
(53,1,1) = {"
af
af
af
af
af
af
ar
ar
ar
af
af
af
af
af
af
af
af
af
af
af
af
af
af
ao
af
af
af
af
af
af
af
af
af
af
ao
af
af
af
af
af
af
af
"}
(54,1,1) = {"
af
af
af
af
af
af
af
af
af
af
af
af
af
af
af
af
af
af
af
af
af
af
af
af
af
af
af
af
af
af
af
af
af
af
af
af
af
af
af
af
af
af
"}
(55,1,1) = {"
af
af
aU
af
af
af
af
af
af
af
af
af
aU
af
af
af
af
af
af
af
aU
af
af
af
af
af
af
af
af
af
aU
af
af
af
af
af
af
af
af
af
af
af
"}
(56,1,1) = {"
af
af
af
af
af
af
af
af
af
af
af
ao
af
af
af
af
af
af
af
af
af
af
af
af
af
af
af
af
af
af
af
af
af
af
ar
ar
ar
ar
ar
ar
ar
ar
"}
(57,1,1) = {"
af
af
af
ar
af
af
af
af
af
af
af
af
af
af
af
af
af
ao
af
af
af
af
af
af
af
af
af
af
af
af
af
af
af
af
ar
ar
ar
ar
ar
ar
ar
ar
"}
(58,1,1) = {"
af
af
af
ar
ar
ar
ar
ar
ar
af
af
af
af
af
af
af
af
af
af
af
af
af
af
af
af
af
ar
ar
ar
ar
ar
ar
ar
ar
ar
ar
ar
ar
ar
ar
ar
ar
"}
(59,1,1) = {"
af
af
ar
ar
ar
ar
ar
ar
ar
af
af
af
af
af
af
af
af
af
af
af
af
af
af
af
af
af
ar
ar
ar
ar
ar
ar
ar
ar
ar
ar
ar
ar
ar
ar
ar
ar
"}
(60,1,1) = {"
ar
ar
ar
ar
ar
ar
ar
ar
ar
ar
ar
ar
ar
af
af
af
af
af
ar
ar
ar
ar
ar
ar
ar
ar
ar
ar
ar
ar
ar
ar
ar
ar
ar
ar
ar
ar
ar
ar
ar
ar
"}
(61,1,1) = {"
ar
ar
ar
ar
ar
ar
ar
ar
ar
ar
ar
ar
ar
ar
ar
ar
ar
ar
ar
ar
ar
ar
ar
ar
ar
ar
ar
ar
ar
ar
ar
ar
ar
ar
ar
ar
ar
ar
ar
ar
ar
ar
"}
(62,1,1) = {"
aX
aX
ar
ar
ar
ar
ar
ar
ar
ar
ar
ar
ar
ar
ar
ar
ar
ar
ar
ar
ar
ar
ar
ar
ar
ar
ar
ar
ar
ar
ar
ar
ar
ar
ar
ar
ar
ar
ar
ar
ar
ar
"}
(63,1,1) = {"
ar
aX
aX
ar
ar
ar
ar
ar
ar
ar
ar
ar
ar
ar
ar
ar
ar
ar
ar
ar
ar
ar
ar
ar
ar
ar
ar
ar
ar
ar
ar
ar
ar
ar
ar
ar
ar
ar
ar
ar
ar
ar
"}
(64,1,1) = {"
ar
ar
aX
ar
ar
ar
ar
ar
ar
ar
ar
ar
ar
ar
ar
ar
ar
ar
ar
ar
ar
ar
ar
ar
ar
ar
ar
ar
ar
ar
ar
ar
ar
ar
ar
ar
ar
ar
ar
ar
ar
ar
"}
(65,1,1) = {"
ar
ar
aX
ar
ar
ar
ar
ar
ar
ar
ar
ar
ar
ar
ar
ar
ar
ar
ar
ar
ar
ar
ar
ar
ar
ar
ar
ar
ar
ar
ar
ar
ar
ar
ar
ar
ar
ar
ar
ar
ar
ar
"}
(66,1,1) = {"
af
ar
az
az
az
az
az
az
az
az
az
az
az
az
az
az
az
az
az
az
az
az
az
az
az
az
az
az
az
az
az
az
az
az
az
az
az
az
az
az
az
az
"}
