//MAP CONVERTED BY dmm2tgm.py THIS HEADER COMMENT PREVENTS RECONVERSION, DO NOT REMOVE
"b" = (
/obj/machinery/chem_dispenser,
/turf/open/floor/tile/whiteyellow{
	dir = 9
	},
/area/bigredv2/caves/lambda_lab)
"c" = (
/turf/open/floor/plating/ground/mars/random/cave,
/area/bigredv3/caves/northeast)
"h" = (
/turf/closed/mineral/smooth/bigred/indestructible,
/area/bigredv3/inside/wall)
"i" = (
/obj/machinery/chem_master,
/turf/open/floor/tile/whiteyellow{
	dir = 5
	},
/area/bigredv2/caves/lambda_lab)
"j" = (
/turf/closed/mineral/smooth/bigred/indestructible,
/area/space)
"n" = (
/turf/open/floor/plating/ground/mars/random/cave,
/area/bigredv3/caves/northeast/garbledradio)
"p" = (
/obj/structure/closet/crate/freezer/rations,
/turf/open/floor/plating,
/area/bigredv2/caves/lambda_lab)
"s" = (
/turf/closed/mineral/smooth/bigred,
/area/bigredv3/caves/rock)
"u" = (
/turf/closed/wall/r_wall,
/area/bigredv3/inside/wall)
"z" = (
/obj/structure/fence/standard/xenoproof,
/turf/open/floor/plating/ground/mars/random/cave,
/area/bigredv3/caves/northeast)
"D" = (
/obj/effect/landmark/lv624/fog_blocker,
/turf/closed/mineral/smooth/bigred,
/area/bigredv3/caves/rock)
"E" = (
/turf/open/floor/plating/ground/mars/random/cave/rock,
/area/bigredv3/caves/northeast)
"G" = (
/turf/open/floor/plating/ground/mars/random/cave/rock,
/area/bigredv3/caves/northeast/garbledradio)
"I" = (
/obj/effect/ai_node,
/turf/open/floor/plating/ground/mars/random/cave,
/area/bigredv3/caves/northeast)
"J" = (
/obj/effect/landmark/lv624/fog_blocker,
/turf/open/floor/plating/ground/mars/random/cave,
/area/bigredv3/caves/northeast)
"M" = (
/obj/machinery/chem_dispenser,
/turf/open/floor/tile/whiteyellow{
	dir = 1
	},
/area/bigredv2/caves/lambda_lab)
"T" = (
/obj/effect/ai_node,
/turf/open/floor/plating/ground/mars/random/cave,
/area/bigredv3/caves/northeast/garbledradio)
"W" = (
/obj/structure/closet/crate/internals,
/turf/open/floor/plating,
/area/bigredv2/caves/lambda_lab)
"Y" = (
/turf/open/floor/plating,
/area/bigredv2/caves/lambda_lab)

(1,1,1) = {"
j
j
j
j
j
j
j
j
j
j
j
j
j
j
j
s
s
s
s
s
s
s
s
s
s
n
n
n
n
G
s
s
"}
(2,1,1) = {"
j
j
j
j
j
j
j
j
j
j
s
s
s
s
s
s
s
s
s
s
s
s
s
G
G
n
n
n
n
G
s
s
"}
(3,1,1) = {"
j
j
j
j
j
j
j
j
j
j
s
s
s
s
s
s
s
s
s
s
s
s
n
n
n
n
n
n
n
G
s
s
"}
(4,1,1) = {"
j
j
j
j
j
j
j
j
j
j
s
s
s
s
s
s
s
s
s
s
s
n
n
n
n
n
n
n
n
n
G
s
"}
(5,1,1) = {"
j
j
j
j
j
j
j
j
j
j
s
s
s
s
s
s
s
s
s
s
n
n
T
n
T
n
n
n
n
T
G
s
"}
(6,1,1) = {"
j
j
j
j
j
j
j
j
j
j
s
s
s
s
s
s
s
T
n
n
n
T
n
G
n
n
n
n
n
n
G
s
"}
(7,1,1) = {"
j
j
j
j
j
j
j
j
j
j
s
s
s
s
s
s
n
n
n
n
n
n
n
s
s
G
n
n
n
n
G
s
"}
(8,1,1) = {"
j
j
j
j
j
j
j
j
j
j
s
s
s
s
s
s
n
n
n
s
n
n
s
s
s
s
n
n
n
n
n
G
"}
(9,1,1) = {"
j
j
j
j
j
j
j
j
j
j
s
s
s
s
s
s
n
T
n
s
s
s
s
s
s
s
G
n
n
n
n
n
"}
(10,1,1) = {"
j
j
j
j
j
j
j
j
j
j
s
s
s
s
s
n
T
n
n
s
s
s
s
s
s
s
s
G
n
T
n
n
"}
(11,1,1) = {"
j
j
j
j
j
j
j
j
j
j
s
s
s
s
n
n
n
n
n
s
s
s
s
s
s
s
s
s
s
n
T
n
"}
(12,1,1) = {"
j
j
j
j
j
j
j
j
j
j
s
s
s
s
n
n
n
n
n
s
s
s
s
s
s
s
s
s
s
G
n
T
"}
(13,1,1) = {"
j
j
j
j
j
j
j
j
j
j
s
s
s
n
n
n
n
n
s
s
s
s
s
s
s
s
s
s
s
s
s
s
"}
(14,1,1) = {"
j
h
j
j
j
j
j
j
j
j
s
s
T
n
n
n
T
s
s
s
s
s
s
s
s
s
s
s
s
s
s
s
"}
(15,1,1) = {"
j
j
j
j
j
j
j
j
j
j
s
s
n
n
n
s
s
s
s
s
s
s
s
s
s
s
s
s
s
u
u
u
"}
(16,1,1) = {"
j
j
j
j
j
j
j
j
j
j
s
s
n
n
n
s
s
s
s
s
s
s
s
s
s
s
s
s
s
n
n
n
"}
(17,1,1) = {"
j
j
j
j
j
j
j
j
j
j
s
n
n
c
s
s
s
s
s
s
s
s
s
s
s
s
s
s
s
n
n
n
"}
(18,1,1) = {"
j
j
j
j
j
j
j
j
j
j
s
n
I
c
s
s
s
s
s
s
s
s
s
s
s
s
s
s
s
n
n
T
"}
(19,1,1) = {"
j
j
j
j
j
j
j
j
j
j
s
I
c
c
c
s
s
s
s
s
s
s
s
s
s
s
s
s
s
n
n
n
"}
(20,1,1) = {"
j
j
j
j
j
j
j
j
j
j
s
s
c
c
c
c
c
s
s
s
s
s
s
s
s
s
s
s
s
n
n
n
"}
(21,1,1) = {"
j
j
j
j
j
j
j
j
j
j
s
s
c
c
c
c
c
c
c
s
s
s
s
s
s
s
s
s
s
s
n
n
"}
(22,1,1) = {"
j
j
j
j
j
j
j
j
j
j
s
s
I
c
c
c
I
c
c
s
s
s
s
s
s
s
s
s
s
s
n
n
"}
(23,1,1) = {"
j
j
j
j
j
j
j
j
j
j
s
s
s
c
c
c
c
c
c
s
s
s
s
s
s
s
s
s
s
s
n
T
"}
(24,1,1) = {"
j
j
j
j
j
j
j
j
j
j
s
s
s
s
c
c
c
c
c
c
s
s
s
s
s
s
s
s
s
s
n
n
"}
(25,1,1) = {"
j
j
j
j
j
j
j
j
j
j
s
s
s
s
c
c
c
s
c
c
s
s
s
s
s
s
s
s
s
s
s
n
"}
(26,1,1) = {"
j
j
j
j
j
j
j
j
j
j
s
s
s
c
c
c
c
s
c
c
c
s
s
s
s
s
s
s
s
s
s
s
"}
(27,1,1) = {"
j
j
j
j
j
j
j
j
j
j
s
s
c
c
c
c
c
c
c
c
c
s
s
s
s
s
s
s
s
s
s
s
"}
(28,1,1) = {"
j
j
j
j
j
j
j
j
j
j
s
s
I
c
c
c
I
c
c
c
c
s
s
s
s
s
s
s
s
s
s
D
"}
(29,1,1) = {"
j
j
j
j
j
j
j
j
j
j
s
s
c
c
c
s
c
I
c
c
I
s
s
s
s
s
s
s
s
s
D
s
"}
(30,1,1) = {"
j
j
j
j
j
j
j
j
j
j
s
s
c
c
s
s
s
c
c
c
s
s
s
s
s
s
s
s
s
D
s
s
"}
(31,1,1) = {"
j
j
j
j
j
j
j
j
j
j
s
s
c
c
s
s
s
c
c
c
s
s
s
s
s
s
s
s
s
D
s
u
"}
(32,1,1) = {"
j
j
j
j
j
j
j
j
j
j
s
s
c
c
s
s
s
c
c
c
s
s
s
s
s
s
s
s
s
D
s
u
"}
(33,1,1) = {"
j
j
j
j
j
j
j
j
j
j
s
c
c
c
s
s
s
c
c
c
s
s
s
s
s
s
s
s
s
D
s
u
"}
(34,1,1) = {"
j
j
j
j
j
j
j
j
j
j
s
c
c
c
s
s
c
c
c
c
c
s
s
s
s
s
s
s
s
D
s
u
"}
(35,1,1) = {"
j
j
j
j
j
j
j
j
j
j
s
c
c
c
c
c
c
c
c
c
c
s
s
s
s
s
s
s
s
D
s
u
"}
(36,1,1) = {"
j
j
j
j
j
j
j
j
j
j
s
s
I
c
c
c
c
I
c
c
c
c
s
s
s
s
s
s
s
D
s
s
"}
(37,1,1) = {"
j
j
j
j
j
j
j
j
j
j
s
s
s
s
c
c
c
c
c
c
c
c
c
s
s
s
s
s
s
D
s
s
"}
(38,1,1) = {"
j
j
j
j
j
j
j
j
j
j
s
s
s
s
s
s
s
I
c
c
c
c
c
I
c
s
s
s
s
D
s
s
"}
(39,1,1) = {"
j
j
j
j
j
j
j
j
j
j
s
s
s
s
s
s
s
s
s
s
s
c
c
c
c
c
c
s
s
D
u
u
"}
(40,1,1) = {"
j
j
j
j
j
j
j
j
j
j
j
j
j
j
j
j
j
j
j
j
s
c
c
c
c
c
c
c
s
D
u
Y
"}
(41,1,1) = {"
j
j
j
j
j
j
j
j
j
j
j
j
j
j
j
j
j
j
j
j
s
s
c
c
c
c
c
c
s
D
u
W
"}
(42,1,1) = {"
j
j
j
j
j
j
j
j
j
j
j
j
j
j
j
j
j
j
j
j
s
s
s
c
c
c
c
c
s
D
u
p
"}
(43,1,1) = {"
j
j
j
j
j
j
j
j
j
j
j
j
j
j
j
j
j
j
j
j
s
s
s
I
c
c
I
c
z
D
u
u
"}
(44,1,1) = {"
j
j
j
j
j
j
j
j
j
j
j
j
j
j
j
j
j
j
j
j
s
s
s
c
c
c
c
c
z
J
u
b
"}
(45,1,1) = {"
j
j
j
j
j
j
j
j
j
j
j
j
j
j
j
j
j
j
j
j
s
s
s
c
c
c
c
c
z
J
u
M
"}
(46,1,1) = {"
j
j
j
j
j
j
j
j
j
j
j
j
j
j
j
j
j
j
j
j
s
s
s
c
c
c
c
c
z
J
u
M
"}
(47,1,1) = {"
j
j
j
j
j
j
j
j
j
j
j
j
j
j
j
j
j
j
j
j
s
s
s
c
c
c
c
c
s
D
u
i
"}
(48,1,1) = {"
j
j
j
j
j
j
j
j
j
j
j
j
j
j
j
j
j
j
j
j
s
s
s
s
c
c
c
c
s
D
u
u
"}
(49,1,1) = {"
j
j
j
j
j
j
j
j
j
j
j
j
j
j
j
j
j
j
j
j
s
s
s
s
c
c
c
c
s
s
D
u
"}
(50,1,1) = {"
j
j
j
j
j
j
j
j
j
j
j
j
j
j
j
j
j
j
j
j
s
s
s
s
c
c
c
c
c
c
s
D
"}
(51,1,1) = {"
j
j
j
j
j
j
j
j
j
j
j
j
j
j
j
j
j
j
j
j
s
s
s
s
s
c
c
I
c
c
c
E
"}
(52,1,1) = {"
j
j
j
j
j
j
j
j
j
j
j
j
j
j
j
j
j
j
j
j
s
s
s
s
s
c
I
c
c
c
I
c
"}
(53,1,1) = {"
j
j
j
j
j
j
j
j
j
j
j
j
j
j
j
j
j
j
j
j
s
s
s
s
s
s
c
c
c
c
c
c
"}
(54,1,1) = {"
j
j
j
j
j
j
j
j
j
j
j
j
j
j
j
j
j
j
j
j
s
s
s
s
s
s
c
c
c
c
c
c
"}
(55,1,1) = {"
j
j
j
j
j
j
j
j
j
j
j
j
j
j
j
j
j
j
j
j
s
s
s
s
s
s
s
c
c
c
c
c
"}
(56,1,1) = {"
j
j
j
j
j
j
j
j
j
j
j
j
j
j
j
j
j
j
j
j
s
s
s
s
s
s
s
c
c
c
c
c
"}
(57,1,1) = {"
j
j
j
j
j
j
j
j
j
j
j
j
j
j
j
j
j
j
j
j
s
s
s
s
s
s
s
c
c
c
c
c
"}
(58,1,1) = {"
j
j
j
j
j
j
j
j
j
j
j
j
j
j
j
j
j
j
j
j
s
s
s
s
s
s
s
c
c
c
I
c
"}
(59,1,1) = {"
j
j
j
j
j
j
j
j
j
j
j
j
j
j
j
j
j
j
j
j
s
s
s
s
s
s
s
c
c
c
c
c
"}
(60,1,1) = {"
j
j
j
j
j
j
j
j
j
j
j
j
j
j
j
j
j
j
j
j
s
s
s
s
s
s
s
s
c
c
I
c
"}
(61,1,1) = {"
j
j
j
j
j
j
j
j
j
j
j
j
j
j
j
j
j
j
j
j
s
s
s
s
s
s
s
s
s
c
c
c
"}
(62,1,1) = {"
j
j
j
j
j
j
j
j
j
j
j
j
j
j
j
j
j
j
j
j
s
s
s
s
s
s
s
s
s
c
c
c
"}
(63,1,1) = {"
j
j
j
j
j
j
j
j
j
j
j
j
j
j
j
j
j
j
j
j
s
s
s
s
s
s
s
s
s
c
c
c
"}
(64,1,1) = {"
j
j
j
j
j
j
j
j
j
j
j
j
j
j
j
j
j
j
j
j
s
s
s
s
s
s
s
s
s
c
c
c
"}
(65,1,1) = {"
j
j
j
j
j
j
j
j
j
j
j
j
j
j
j
j
j
j
j
j
s
s
s
s
s
s
s
s
s
c
c
c
"}
