//MAP CONVERTED BY dmm2tgm.py THIS HEADER COMMENT PREVENTS RECONVERSION, DO NOT REMOVE
"c" = (
/obj/effect/landmark/lv624/fog_blocker/xeno_spawn,
/turf/open/floor/plating/ground/mars/random/cave,
/area/bigredv2/caves/southwest)
"d" = (
/obj/effect/ai_node,
/turf/open/floor/plating/ground/mars/random/cave/rock,
/area/bigredv2/caves/southwest)
"h" = (
/obj/effect/landmark/excavation_site_spawner,
/obj/effect/ai_node,
/turf/open/floor/plating/ground/mars/random/cave,
/area/bigredv2/caves/southwest)
"j" = (
/turf/closed/mineral/smooth/bigred,
/area/bigredv2/caves/rock)
"k" = (
/obj/effect/landmark/excavation_site_spawner,
/turf/open/floor/plating/ground/mars/random/cave,
/area/bigredv2/caves/southwest)
"l" = (
/turf/closed/mineral/smooth/bigred/indestructible,
/area/space)
"t" = (
/obj/effect/landmark/lv624/fog_blocker/xeno_spawn,
/turf/closed/mineral/smooth/bigred,
/area/bigredv2/caves/rock)
"u" = (
/obj/effect/landmark/lv624/fog_blocker/xeno_spawn,
/turf/open/floor/plating/ground/mars/random/cave/rock,
/area/bigredv2/caves/southwest)
"v" = (
/obj/effect/landmark/xeno_tunnel_spawn,
/turf/open/floor/plating/ground/mars/random/cave,
/area/bigredv2/caves/southwest)
"x" = (
/turf/open/floor/plating/ground/mars/random/cave,
/area/bigredv2/caves/southwest)
"z" = (
/obj/effect/landmark/lv624/fog_blocker,
/turf/open/floor/plating/ground/mars/random/cave,
/area/bigredv2/caves/southwest)
"M" = (
/obj/effect/ai_node,
/turf/open/floor/plating/ground/mars/random/cave,
/area/bigredv2/caves/southwest)
"O" = (
/obj/effect/landmark/lv624/fog_blocker,
/turf/closed/mineral/smooth/bigred,
/area/bigredv2/caves/rock)
"Q" = (
/turf/open/floor/plating/ground/mars/random/cave/rock,
/area/bigredv2/caves/southwest)
"R" = (
/obj/effect/landmark/patrol_point/som/som_11,
/turf/open/floor/plating/ground/mars/random/cave,
/area/bigredv2/caves/southwest)
"Y" = (
/obj/effect/landmark/xeno_silo_spawn,
/turf/open/floor/plating/ground/mars/random/cave,
/area/bigredv2/caves/southwest)

(1,1,1) = {"
l
l
l
l
l
l
l
l
l
l
l
l
l
l
l
l
l
l
l
l
l
l
l
l
l
l
l
l
l
l
l
l
l
l
l
l
l
l
l
l
l
l
l
"}
(2,1,1) = {"
j
j
j
j
j
j
j
j
j
j
j
j
j
j
j
j
j
j
j
j
j
j
j
j
j
j
j
j
j
j
j
j
j
j
j
l
l
l
l
l
l
l
l
"}
(3,1,1) = {"
j
j
j
j
j
j
j
j
j
j
j
j
j
j
j
j
j
j
j
j
j
j
j
j
j
j
j
j
j
j
j
j
j
j
j
l
l
l
l
l
l
l
l
"}
(4,1,1) = {"
j
j
j
j
j
j
j
j
j
j
j
j
j
j
j
j
j
j
j
j
j
j
j
j
j
j
j
j
j
j
j
j
j
j
j
l
l
l
l
l
l
l
l
"}
(5,1,1) = {"
j
j
j
j
j
j
j
j
j
j
j
j
j
j
j
j
j
j
j
j
j
j
j
j
j
j
j
j
j
j
j
j
j
j
j
l
l
l
l
l
l
l
l
"}
(6,1,1) = {"
j
j
j
j
j
j
j
j
j
j
j
j
j
j
j
j
j
j
j
j
j
j
j
j
j
j
j
j
j
j
j
j
j
j
j
l
l
l
l
l
l
l
l
"}
(7,1,1) = {"
j
j
j
j
j
j
j
j
j
j
j
j
j
j
j
j
j
j
j
j
j
j
j
j
j
j
j
j
j
j
j
j
j
j
j
l
l
l
l
l
l
l
l
"}
(8,1,1) = {"
j
j
j
j
j
j
j
j
j
j
j
j
j
j
j
j
j
j
j
j
j
j
j
j
j
j
j
j
j
j
j
j
j
j
j
l
l
l
l
l
l
l
l
"}
(9,1,1) = {"
j
j
j
j
j
j
j
j
j
j
j
j
j
j
j
j
j
j
j
j
j
x
x
j
j
j
j
j
j
j
j
j
j
j
j
l
l
l
l
l
l
l
l
"}
(10,1,1) = {"
x
x
j
j
j
j
j
j
j
j
j
j
j
j
j
j
j
x
x
x
x
x
x
j
j
j
j
j
j
j
j
j
j
j
j
l
l
l
l
l
l
l
l
"}
(11,1,1) = {"
x
x
x
j
j
j
j
j
j
j
j
j
j
j
j
j
x
x
x
x
x
x
x
x
j
j
j
j
j
j
j
j
j
j
j
l
l
l
l
l
l
l
l
"}
(12,1,1) = {"
x
x
x
Q
Q
j
j
j
j
j
j
j
j
j
j
j
x
x
j
j
x
x
x
x
j
j
j
j
j
j
j
j
j
j
j
l
l
l
l
l
l
l
l
"}
(13,1,1) = {"
x
Q
d
x
Q
j
j
j
j
j
j
j
j
j
j
x
x
x
j
j
j
j
x
x
x
j
j
j
j
j
j
j
j
j
j
l
l
l
l
l
l
l
l
"}
(14,1,1) = {"
x
x
Q
x
Q
j
j
j
j
j
j
j
j
j
j
x
x
x
x
j
j
j
x
x
x
j
j
j
j
j
j
j
j
j
j
l
l
l
l
l
l
l
l
"}
(15,1,1) = {"
x
x
x
x
Q
j
j
j
j
j
j
j
j
j
j
x
x
x
x
x
j
j
j
x
x
j
j
j
j
j
j
j
j
j
j
l
l
l
l
l
l
l
l
"}
(16,1,1) = {"
x
x
x
x
d
j
j
j
j
j
j
j
j
j
j
x
x
x
x
x
x
j
j
x
x
j
j
j
j
j
j
j
j
j
j
l
l
l
l
l
l
l
l
"}
(17,1,1) = {"
x
x
x
x
x
d
j
j
j
j
j
Q
Q
Q
x
x
x
x
x
k
x
x
x
x
x
j
j
j
j
j
j
j
j
j
j
l
l
l
l
l
l
l
l
"}
(18,1,1) = {"
x
x
x
x
x
Q
j
j
j
j
j
Q
x
x
x
x
x
x
R
x
x
x
x
x
x
j
j
j
j
j
j
j
j
j
j
l
l
l
l
l
l
l
l
"}
(19,1,1) = {"
x
x
M
x
x
x
Q
x
j
j
j
x
M
x
x
x
x
x
x
x
x
x
x
Q
x
x
j
j
j
j
j
j
j
j
j
l
l
l
l
l
l
l
l
"}
(20,1,1) = {"
j
x
x
x
x
x
x
x
x
j
x
x
x
x
x
x
x
x
x
x
x
x
x
Q
x
x
x
j
j
j
j
j
j
j
j
l
l
l
l
l
l
l
l
"}
(21,1,1) = {"
j
j
j
x
x
x
x
x
x
x
x
x
x
x
x
x
x
x
x
x
x
x
Q
x
x
x
x
j
j
j
j
j
j
j
j
l
l
l
l
l
l
l
l
"}
(22,1,1) = {"
j
j
j
x
x
M
x
x
x
x
x
x
M
x
x
M
Q
j
Q
x
x
x
Q
j
j
x
x
j
j
j
j
j
j
j
j
l
l
l
l
l
l
l
l
"}
(23,1,1) = {"
j
j
j
x
x
x
x
x
x
x
x
x
x
x
x
Q
j
j
j
j
j
j
j
j
j
x
x
x
j
j
j
j
j
j
j
l
l
l
l
l
l
l
l
"}
(24,1,1) = {"
j
j
j
x
x
x
x
x
Q
x
x
Q
x
x
x
Q
j
j
j
j
j
j
j
j
x
x
x
x
j
j
j
j
j
j
j
l
l
l
l
l
l
l
l
"}
(25,1,1) = {"
j
j
j
Q
x
x
x
x
x
x
Q
x
x
x
x
j
j
j
j
j
j
j
j
j
x
M
x
x
j
j
j
j
j
j
j
l
l
l
l
l
l
l
l
"}
(26,1,1) = {"
j
j
j
j
M
x
x
x
x
x
x
x
Q
x
x
t
t
t
t
t
t
t
t
t
t
x
M
x
j
j
j
j
j
j
j
l
l
l
l
l
l
l
l
"}
(27,1,1) = {"
j
j
j
x
x
M
x
x
x
x
x
x
M
x
x
t
j
j
j
j
j
j
j
j
t
x
x
x
x
j
j
j
j
j
j
l
l
l
l
l
l
l
l
"}
(28,1,1) = {"
j
j
x
x
x
x
x
x
x
x
x
x
x
x
Q
t
j
j
j
x
x
v
j
j
t
j
x
x
x
j
j
j
j
j
j
l
l
l
l
l
l
l
l
"}
(29,1,1) = {"
j
x
x
x
x
x
x
x
x
x
x
x
x
x
x
t
j
j
x
x
x
Y
x
j
t
j
x
x
x
j
j
j
j
j
j
l
l
l
l
l
l
l
l
"}
(30,1,1) = {"
j
x
x
x
x
x
x
x
x
Q
j
Q
M
x
M
c
j
j
x
x
x
x
x
j
t
j
x
x
x
x
j
j
j
j
j
l
l
l
l
l
l
l
l
"}
(31,1,1) = {"
j
x
x
x
x
x
x
x
x
Q
j
j
Q
M
x
c
x
j
M
x
x
x
x
j
t
j
d
x
x
x
j
j
j
j
j
l
l
l
l
l
l
l
l
"}
(32,1,1) = {"
j
x
M
x
x
M
j
x
x
Q
j
j
j
x
x
c
x
M
x
x
x
x
j
j
t
j
Q
d
x
x
j
j
j
j
j
l
l
l
l
l
l
l
l
"}
(33,1,1) = {"
j
x
x
x
j
j
j
Q
Q
j
j
j
j
x
x
c
x
x
x
x
Q
x
j
j
t
j
j
Q
M
x
x
j
j
j
j
l
l
l
l
l
l
l
l
"}
(34,1,1) = {"
j
x
x
x
j
j
j
j
j
j
j
j
j
j
x
c
x
x
x
x
x
Q
j
j
t
j
j
j
x
x
x
x
j
j
j
l
l
l
l
l
l
l
l
"}
(35,1,1) = {"
j
x
x
x
j
j
j
j
j
j
j
j
j
x
x
c
c
c
c
c
u
t
t
t
t
j
j
j
x
x
x
j
j
j
j
l
l
l
l
l
l
l
l
"}
(36,1,1) = {"
j
x
x
x
j
j
j
j
j
j
j
j
j
Q
M
x
x
x
M
x
Q
j
j
j
j
j
j
j
x
x
x
j
j
j
j
l
l
l
l
l
l
l
l
"}
(37,1,1) = {"
x
x
x
x
j
j
j
j
j
j
j
j
j
j
j
j
x
h
x
M
x
d
j
j
j
j
j
j
x
k
x
j
j
j
j
l
l
l
l
l
l
l
l
"}
(38,1,1) = {"
x
x
x
x
j
j
j
j
j
j
j
j
j
j
j
j
x
x
x
x
x
Q
j
j
j
j
Q
Q
x
x
x
j
j
j
j
l
l
l
l
l
l
l
l
"}
(39,1,1) = {"
x
x
x
x
j
j
j
j
j
j
j
j
j
j
j
j
Q
x
x
x
x
Q
j
j
j
j
Q
Q
x
x
j
j
j
j
j
l
l
l
l
l
l
l
l
"}
(40,1,1) = {"
x
x
x
x
j
j
j
j
j
j
j
j
j
j
j
j
j
j
j
x
x
x
Q
Q
j
j
j
j
x
x
j
j
j
j
j
l
l
l
l
l
l
l
l
"}
(41,1,1) = {"
z
z
z
O
O
O
O
O
O
O
O
O
O
O
j
j
j
j
j
x
x
x
x
Q
j
j
j
j
x
x
j
j
j
j
j
l
l
l
l
l
l
l
l
"}
