//MAP CONVERTED BY dmm2tgm.py THIS HEADER COMMENT PREVENTS RECONVERSION, DO NOT REMOVE
"au" = (
/obj/machinery/light{
	dir = 4
	},
/obj/effect/decal/cleanable/dirt,
/obj/effect/ai_node,
/turf/open/floor/tile/dark/red2/corner,
/area/bigredv2/outside/nanotrasen_lab/inside)
"aB" = (
/obj/item/target,
/turf/open/floor/tile/dark/red2{
	dir = 1
	},
/area/bigredv2/outside/nanotrasen_lab/inside)
"aM" = (
/obj/machinery/miner/damaged/platinum,
/turf/open/floor/plating/ground/mars/random/cave/rock,
/area/bigredv2/caves/south)
"bN" = (
/obj/effect/decal/cleanable/blood/xeno,
/turf/open/floor/tile/dark/red2/corner{
	dir = 4
	},
/area/bigredv2/outside/nanotrasen_lab/inside)
"cj" = (
/obj/machinery/atmospherics/components/unary/vent_pump{
	dir = 4;
	on = 1
	},
/turf/open/floor/tile/dark,
/area/bigredv2/outside/nanotrasen_lab/inside)
"dE" = (
/obj/structure/xenoautopsy/tank/hugger,
/turf/open/floor/tile/dark/red2/corner{
	dir = 8
	},
/area/bigredv2/outside/nanotrasen_lab/inside)
"em" = (
/obj/effect/landmark/lv624/fog_blocker/xeno_spawn,
/turf/open/floor/plating/ground/mars/random/cave,
/area/bigredv2/caves/south)
"ff" = (
/obj/structure/xenoautopsy/tank/broken,
/turf/open/floor/tile/dark/red2/corner{
	dir = 8
	},
/area/bigredv2/outside/nanotrasen_lab/inside)
"gE" = (
/turf/open/floor/plating/ground/mars/random/cave,
/area/bigredv2/caves/south)
"hd" = (
/obj/structure/cable,
/obj/machinery/door/airlock/mainship/maint/free_access{
	name = "\improper Eta Lab Maintenance Storage"
	},
/turf/open/floor/tile/dark,
/area/bigredv2/outside/nanotrasen_lab/inside)
"hA" = (
/turf/open/floor/tile/dark/red2/corner{
	dir = 8
	},
/area/bigredv2/outside/nanotrasen_lab/inside)
"hL" = (
/obj/machinery/light{
	dir = 1
	},
/turf/open/floor/tile/dark/red2{
	dir = 9
	},
/area/bigredv2/outside/nanotrasen_lab/inside)
"hN" = (
/obj/effect/decal/cleanable/blood/gibs,
/turf/open/floor/plating/ground/mars/random/cave,
/area/bigredv2/caves/south)
"if" = (
/obj/effect/spawner/random/engineering/structure/tank/fuelweighted,
/turf/open/floor/plating,
/area/bigredv2/outside/nanotrasen_lab/inside)
"iC" = (
/obj/machinery/light{
	dir = 1
	},
/turf/open/floor/tile/dark/red2{
	dir = 5
	},
/area/bigredv2/outside/nanotrasen_lab/inside)
"jr" = (
/turf/open/floor/plating,
/area/bigredv2/outside/nanotrasen_lab/inside)
"jx" = (
/obj/effect/ai_node,
/turf/open/floor/tile/dark,
/area/bigredv2/outside/nanotrasen_lab/inside)
"kb" = (
/obj/structure/window/framed/colony,
/turf/open/floor/plating,
/area/bigredv2/outside/nanotrasen_lab/inside)
"kP" = (
/obj/effect/landmark/xeno_silo_spawn,
/turf/open/floor/plating/ground/mars/random/cave,
/area/bigredv2/caves/south)
"kW" = (
/turf/open/floor/tile/dark/red2{
	dir = 6
	},
/area/bigredv2/outside/nanotrasen_lab/inside)
"ln" = (
/obj/structure/fence/standard/xenoproof,
/turf/open/floor/plating/ground/mars/random/cave/rock,
/area/bigredv2/caves/south)
"lw" = (
/obj/machinery/light,
/turf/open/floor/tile/darkgreen/darkgreen2,
/area/bigredv2/outside/nanotrasen_lab/inside)
"mX" = (
/turf/open/floor/tile/darkgreen/darkgreen2{
	dir = 6
	},
/area/bigredv2/outside/nanotrasen_lab/inside)
"nk" = (
/obj/structure/cable,
/turf/open/floor/plating,
/area/bigredv2/outside/nanotrasen_lab/inside)
"oC" = (
/obj/machinery/door/airlock/mainship/research/glass/free_access{
	name = "\improper Eta Lab Cell"
	},
/turf/open/floor/tile/dark,
/area/bigredv2/outside/nanotrasen_lab/inside)
"oN" = (
/obj/effect/landmark/lv624/fog_blocker/xeno_spawn,
/turf/closed/mineral/smooth/bigred,
/area/bigredv2/caves/rock)
"pA" = (
/obj/machinery/computer/security,
/turf/open/floor/tile/dark/red2/corner{
	dir = 4
	},
/area/bigredv2/outside/nanotrasen_lab/inside)
"qi" = (
/turf/open/floor/tile/dark/red2{
	dir = 4
	},
/area/bigredv2/outside/nanotrasen_lab/inside)
"qw" = (
/obj/effect/decal/cleanable/blood/oil,
/turf/open/floor/tile/dark,
/area/bigredv2/outside/nanotrasen_lab/inside)
"rj" = (
/obj/structure/table,
/obj/machinery/light,
/obj/effect/spawner/random/engineering/technology_scanner,
/obj/item/xenos_claw,
/turf/open/floor/tile/dark/red2/corner{
	dir = 8
	},
/area/bigredv2/outside/nanotrasen_lab/inside)
"rl" = (
/turf/open/floor/tile/darkgreen/darkgreen2{
	dir = 8
	},
/area/bigredv2/outside/nanotrasen_lab/inside)
"rU" = (
/obj/effect/landmark/lv624/fog_blocker,
/turf/closed/wall/r_wall,
/turf/open/floor/plating/ground/mars/cavetodirt{
	dir = 1
	},
/area/bigredv2/outside/nanotrasen_lab/inside)
"sg" = (
/turf/open/floor/tile/dark/red2,
/area/bigredv2/outside/nanotrasen_lab/inside)
"uA" = (
/turf/closed/mineral/smooth/bigred,
/area/bigredv2/caves/rock)
"uY" = (
/obj/machinery/atmospherics/pipe/simple/green/hidden{
	dir = 4
	},
/turf/open/floor/tile/dark,
/area/bigredv2/outside/nanotrasen_lab/inside)
"vf" = (
/obj/machinery/door/airlock/mainship/research/glass/free_access{
	dir = 1;
	name = "\improper Eta Lab Cell"
	},
/turf/open/floor/tile/dark,
/area/bigredv2/outside/nanotrasen_lab/inside)
"vx" = (
/turf/open/floor/tile/dark,
/area/bigredv2/outside/nanotrasen_lab/inside)
"wi" = (
/turf/open/floor/tile/darkgreen/darkgreen2{
	dir = 10
	},
/area/bigredv2/outside/nanotrasen_lab/inside)
"wS" = (
/turf/open/floor/tile/dark/red2{
	dir = 10
	},
/area/bigredv2/outside/nanotrasen_lab/inside)
"AU" = (
/obj/machinery/atmospherics/pipe/simple/green/hidden{
	dir = 4
	},
/obj/effect/ai_node,
/turf/open/floor/tile/dark,
/area/bigredv2/outside/nanotrasen_lab/inside)
"Bh" = (
/turf/open/floor/plating/ground/mars/random/sand,
/area/bigredv2/outside/nanotrasen_lab/inside)
"BM" = (
/obj/effect/landmark/lv624/fog_blocker/xeno_spawn,
/turf/open/floor/plating/ground/mars/random/cave/rock,
/area/bigredv2/caves/south)
"CD" = (
/obj/effect/ai_node,
/turf/open/floor/plating/ground/mars/random/cave/rock,
/area/bigredv2/caves/south)
"CS" = (
/obj/structure/cable,
/obj/machinery/power/apc/high/ntf{
	dir = 1
	},
/turf/open/floor/plating,
/area/bigredv2/outside/nanotrasen_lab/inside)
"CT" = (
/obj/structure/table,
/obj/effect/spawner/random/engineering/technology_scanner,
/turf/open/floor/tile/dark/red2/corner{
	dir = 4
	},
/area/bigredv2/outside/nanotrasen_lab/inside)
"DE" = (
/turf/closed/wall/r_wall,
/area/bigredv2/outside/nanotrasen_lab/inside)
"Ex" = (
/turf/open/floor/tile/dark/red2{
	dir = 8
	},
/area/bigredv2/outside/nanotrasen_lab/inside)
"Fe" = (
/obj/effect/decal/cleanable/blood,
/turf/open/floor/tile/dark,
/area/bigredv2/outside/nanotrasen_lab/inside)
"Fk" = (
/obj/structure/closet/firecloset,
/turf/open/floor/plating,
/area/bigredv2/outside/nanotrasen_lab/inside)
"Fr" = (
/obj/machinery/light{
	dir = 8
	},
/turf/open/floor/tile/dark/red2/corner{
	dir = 8
	},
/area/bigredv2/outside/nanotrasen_lab/inside)
"FS" = (
/obj/structure/table,
/obj/effect/spawner/random/engineering/technology_scanner,
/turf/open/floor/tile/dark/red2/corner{
	dir = 8
	},
/area/bigredv2/outside/nanotrasen_lab/inside)
"Gf" = (
/obj/structure/table,
/obj/item/alienjar,
/turf/open/floor/tile/dark/red2/corner{
	dir = 4
	},
/area/bigredv2/outside/nanotrasen_lab/inside)
"Gg" = (
/obj/structure/table,
/obj/structure/xenoautopsy,
/turf/open/floor/tile/dark/red2/corner{
	dir = 4
	},
/area/bigredv2/outside/nanotrasen_lab/inside)
"He" = (
/obj/machinery/atmospherics/pipe/manifold/green/hidden{
	dir = 1
	},
/obj/effect/ai_node,
/turf/open/floor/tile/dark,
/area/bigredv2/outside/nanotrasen_lab/inside)
"HK" = (
/obj/structure/closet/l3closet/scientist,
/turf/open/floor/tile/darkgreen/darkgreen2{
	dir = 1
	},
/area/bigredv2/outside/nanotrasen_lab/inside)
"HN" = (
/obj/structure/table,
/obj/item/tool/pen,
/turf/open/floor/tile/dark/red2/corner{
	dir = 4
	},
/area/bigredv2/outside/nanotrasen_lab/inside)
"HP" = (
/turf/closed/mineral/smooth/bigred/indestructible,
/area/space)
"Is" = (
/obj/structure/fence/standard/xenoproof,
/turf/open/floor/plating/ground/mars/random/cave,
/area/bigredv2/caves/south)
"Jl" = (
/turf/open/floor/tile/darkgreen/darkgreen2{
	dir = 4
	},
/area/bigredv2/outside/nanotrasen_lab/inside)
"JC" = (
/obj/effect/decal/cleanable/dirt,
/turf/open/floor/tile/dark,
/area/bigredv2/outside/nanotrasen_lab/inside)
"JW" = (
/obj/structure/bed/chair{
	dir = 8
	},
/turf/open/floor/tile/dark/red2{
	dir = 8
	},
/area/bigredv2/outside/nanotrasen_lab/inside)
"LS" = (
/turf/open/floor/tile/dark/red2/corner,
/area/bigredv2/outside/nanotrasen_lab/inside)
"Nd" = (
/obj/structure/cable,
/obj/effect/ai_node,
/turf/open/floor/plating,
/area/bigredv2/outside/nanotrasen_lab/inside)
"Nj" = (
/obj/structure/bed/chair{
	dir = 4
	},
/obj/effect/landmark/excavation_site_spawner,
/turf/open/floor/tile/dark/red2{
	dir = 4
	},
/area/bigredv2/outside/nanotrasen_lab/inside)
"NI" = (
/turf/open/floor/plating/ground/mars/random/cave/rock,
/area/bigredv2/caves/south)
"Pn" = (
/obj/structure/table,
/obj/item/paper,
/turf/open/floor/tile/dark/red2/corner,
/area/bigredv2/outside/nanotrasen_lab/inside)
"Pr" = (
/obj/effect/landmark/lv624/fog_blocker,
/turf/closed/wall/r_wall,
/turf/open/floor/plating/ground/mars/random/cave,
/area/bigredv2/outside/nanotrasen_lab/inside)
"Qr" = (
/turf/closed/wall,
/area/bigredv2/outside/nanotrasen_lab/inside)
"Ra" = (
/obj/effect/landmark/excavation_site_spawner,
/turf/open/floor/plating/ground/mars/random/cave,
/area/bigredv2/caves/south)
"RW" = (
/obj/structure/closet/l3closet/scientist,
/turf/open/floor/tile/darkgreen/darkgreen2{
	dir = 9
	},
/area/bigredv2/outside/nanotrasen_lab/inside)
"Sk" = (
/obj/structure/window/framed/colony/reinforced,
/turf/open/floor/plating,
/area/bigredv2/outside/nanotrasen_lab/inside)
"Sp" = (
/obj/effect/decal/cleanable/dirt,
/turf/open/floor/tile/dark/red2/corner,
/area/bigredv2/outside/nanotrasen_lab/inside)
"Sv" = (
/obj/machinery/atmospherics/components/unary/vent_pump{
	dir = 1;
	on = 1
	},
/turf/open/floor/tile/dark,
/area/bigredv2/outside/nanotrasen_lab/inside)
"SS" = (
/obj/machinery/light{
	dir = 4
	},
/turf/open/ground/jungle/clear,
/area/bigredv2/outside/nanotrasen_lab/inside)
"Ti" = (
/obj/structure/bed/chair{
	dir = 4
	},
/turf/open/floor/tile/dark/red2{
	dir = 4
	},
/area/bigredv2/outside/nanotrasen_lab/inside)
"Tq" = (
/turf/open/floor/tile/dark/red2{
	dir = 1
	},
/area/bigredv2/outside/nanotrasen_lab/inside)
"Uj" = (
/obj/structure/closet/l3closet/scientist,
/turf/open/floor/tile/darkgreen/darkgreen2{
	dir = 5
	},
/area/bigredv2/outside/nanotrasen_lab/inside)
"UN" = (
/obj/structure/xenoautopsy/tank,
/turf/open/floor/tile/dark/red2/corner{
	dir = 8
	},
/area/bigredv2/outside/nanotrasen_lab/inside)
"Vk" = (
/obj/effect/landmark/lv624/fog_blocker,
/turf/closed/wall/r_wall,
/area/bigredv2/outside/nanotrasen_lab/inside)
"Vl" = (
/obj/effect/landmark/lv624/fog_blocker,
/turf/closed/mineral/smooth/bigred,
/area/bigredv2/caves/rock)
"Vx" = (
/obj/structure/closet/crate/secure,
/turf/open/floor/tile/dark/red2/corner,
/area/bigredv2/outside/nanotrasen_lab/inside)
"VX" = (
/obj/machinery/atmospherics/pipe/simple/green/hidden{
	dir = 4
	},
/obj/machinery/door/airlock/mainship/research/glass/free_access{
	name = "\improper Eta Lab Xenobiology Lab"
	},
/turf/open/floor/tile/dark,
/area/bigredv2/outside/nanotrasen_lab/inside)
"XW" = (
/turf/open/ground/jungle/clear,
/area/bigredv2/outside/nanotrasen_lab/inside)
"Yi" = (
/obj/effect/ai_node,
/turf/open/floor/plating/ground/mars/random/cave,
/area/bigredv2/caves/south)
"Ym" = (
/obj/machinery/light{
	dir = 8
	},
/turf/open/floor/plating/ground/mars/random/sand,
/area/bigredv2/outside/nanotrasen_lab/inside)
"Yt" = (
/obj/structure/closet/toolcloset,
/turf/open/floor/plating,
/area/bigredv2/outside/nanotrasen_lab/inside)

(1,1,1) = {"
HP
HP
HP
HP
HP
HP
HP
HP
HP
HP
HP
HP
HP
HP
HP
HP
HP
HP
HP
HP
HP
HP
HP
HP
HP
HP
HP
HP
HP
HP
HP
HP
HP
HP
HP
HP
HP
HP
"}
(2,1,1) = {"
HP
HP
HP
HP
HP
HP
HP
HP
HP
HP
HP
HP
HP
HP
HP
HP
HP
HP
HP
HP
HP
HP
HP
HP
HP
HP
HP
HP
HP
HP
HP
HP
HP
HP
HP
HP
HP
HP
"}
(3,1,1) = {"
HP
HP
HP
HP
HP
HP
HP
HP
HP
HP
HP
HP
HP
HP
HP
HP
HP
HP
HP
HP
HP
HP
HP
HP
HP
HP
HP
HP
HP
HP
HP
HP
HP
HP
HP
HP
HP
HP
"}
(4,1,1) = {"
HP
HP
HP
HP
HP
HP
HP
HP
HP
HP
HP
HP
HP
HP
HP
HP
HP
HP
HP
HP
HP
HP
HP
HP
HP
HP
HP
HP
HP
HP
HP
HP
HP
HP
HP
HP
HP
HP
"}
(5,1,1) = {"
HP
HP
HP
HP
HP
HP
HP
HP
HP
HP
HP
HP
HP
HP
HP
HP
HP
HP
HP
HP
HP
HP
HP
HP
HP
HP
HP
HP
HP
HP
HP
HP
HP
HP
HP
HP
HP
HP
"}
(6,1,1) = {"
HP
HP
HP
HP
HP
HP
HP
HP
HP
HP
HP
HP
HP
HP
HP
HP
HP
HP
HP
HP
HP
HP
HP
HP
HP
HP
HP
HP
HP
HP
HP
HP
HP
HP
HP
HP
HP
HP
"}
(7,1,1) = {"
HP
HP
HP
HP
HP
HP
HP
HP
HP
HP
HP
HP
HP
HP
HP
HP
HP
HP
HP
HP
HP
HP
HP
HP
HP
HP
HP
HP
HP
HP
HP
HP
HP
HP
HP
HP
HP
HP
"}
(8,1,1) = {"
HP
HP
HP
HP
HP
HP
HP
HP
HP
HP
HP
HP
HP
HP
HP
HP
HP
HP
HP
HP
HP
HP
HP
HP
HP
HP
HP
HP
HP
HP
HP
HP
HP
HP
HP
HP
HP
HP
"}
(9,1,1) = {"
HP
HP
HP
HP
HP
HP
HP
HP
HP
HP
HP
HP
HP
HP
HP
HP
HP
HP
HP
HP
HP
HP
HP
HP
HP
HP
HP
HP
HP
HP
HP
HP
HP
HP
HP
HP
HP
HP
"}
(10,1,1) = {"
HP
HP
HP
HP
HP
HP
HP
HP
HP
HP
HP
HP
HP
HP
HP
HP
HP
HP
HP
HP
HP
HP
HP
HP
HP
HP
HP
HP
HP
HP
HP
HP
HP
HP
HP
HP
HP
HP
"}
(11,1,1) = {"
HP
HP
HP
HP
HP
HP
HP
HP
HP
HP
HP
HP
HP
HP
HP
HP
HP
HP
HP
HP
HP
HP
HP
HP
HP
HP
HP
HP
HP
HP
HP
HP
HP
HP
HP
HP
HP
HP
"}
(12,1,1) = {"
HP
HP
HP
HP
HP
HP
HP
HP
HP
HP
HP
HP
HP
HP
HP
HP
HP
HP
HP
HP
HP
HP
HP
HP
HP
HP
HP
HP
HP
HP
HP
HP
HP
HP
HP
HP
HP
HP
"}
(13,1,1) = {"
HP
HP
HP
HP
HP
HP
HP
HP
HP
HP
HP
HP
HP
HP
HP
HP
HP
HP
HP
HP
HP
HP
HP
HP
HP
HP
HP
HP
HP
HP
HP
HP
HP
HP
HP
HP
HP
HP
"}
(14,1,1) = {"
HP
HP
HP
HP
HP
HP
HP
HP
HP
HP
HP
HP
HP
HP
HP
HP
HP
HP
HP
HP
HP
HP
HP
HP
HP
HP
HP
HP
HP
HP
HP
HP
HP
HP
HP
HP
HP
HP
"}
(15,1,1) = {"
HP
HP
HP
HP
HP
HP
HP
HP
HP
HP
HP
HP
HP
HP
HP
HP
HP
HP
HP
HP
HP
HP
HP
HP
HP
HP
HP
HP
HP
HP
HP
HP
HP
HP
HP
HP
HP
HP
"}
(16,1,1) = {"
HP
HP
HP
HP
HP
HP
HP
HP
HP
HP
HP
HP
HP
HP
HP
HP
HP
HP
HP
HP
HP
HP
HP
HP
HP
HP
HP
HP
HP
HP
HP
HP
HP
HP
HP
HP
HP
HP
"}
(17,1,1) = {"
HP
HP
HP
HP
HP
HP
HP
HP
HP
HP
HP
HP
HP
HP
HP
HP
HP
HP
HP
HP
HP
HP
HP
HP
HP
HP
HP
HP
HP
HP
HP
HP
HP
HP
HP
HP
HP
HP
"}
(18,1,1) = {"
HP
HP
HP
HP
HP
HP
HP
HP
HP
HP
HP
HP
HP
HP
HP
HP
HP
HP
HP
HP
HP
HP
HP
HP
HP
HP
HP
HP
HP
HP
HP
HP
HP
HP
HP
HP
HP
HP
"}
(19,1,1) = {"
HP
HP
HP
HP
HP
HP
HP
HP
HP
HP
HP
HP
HP
HP
HP
HP
HP
HP
HP
HP
HP
HP
HP
HP
HP
HP
HP
HP
HP
HP
HP
HP
HP
HP
HP
HP
HP
HP
"}
(20,1,1) = {"
HP
HP
HP
HP
HP
HP
HP
HP
HP
HP
HP
HP
HP
HP
HP
HP
HP
HP
HP
HP
HP
HP
HP
HP
HP
HP
HP
HP
HP
HP
HP
HP
HP
HP
HP
HP
HP
HP
"}
(21,1,1) = {"
HP
HP
HP
HP
HP
HP
HP
HP
HP
HP
HP
HP
HP
HP
HP
HP
HP
HP
HP
HP
HP
HP
HP
HP
HP
HP
HP
HP
HP
HP
HP
HP
HP
HP
HP
HP
HP
HP
"}
(22,1,1) = {"
HP
HP
HP
HP
HP
HP
HP
HP
HP
HP
HP
HP
HP
HP
HP
HP
HP
HP
HP
HP
HP
HP
HP
HP
HP
HP
HP
HP
HP
HP
HP
HP
HP
HP
HP
HP
HP
HP
"}
(23,1,1) = {"
HP
HP
HP
HP
HP
HP
HP
HP
HP
HP
HP
HP
HP
HP
HP
HP
HP
HP
HP
HP
HP
HP
HP
HP
HP
HP
HP
HP
HP
HP
HP
HP
HP
HP
HP
HP
HP
HP
"}
(24,1,1) = {"
HP
HP
HP
HP
HP
HP
HP
HP
HP
HP
HP
HP
HP
HP
HP
HP
HP
HP
HP
HP
HP
HP
HP
HP
HP
HP
HP
HP
HP
HP
HP
HP
HP
HP
HP
HP
HP
HP
"}
(25,1,1) = {"
HP
HP
HP
HP
HP
HP
HP
HP
HP
HP
HP
HP
HP
HP
HP
HP
HP
HP
HP
HP
HP
HP
HP
HP
HP
HP
HP
HP
HP
HP
HP
HP
HP
HP
HP
HP
HP
HP
"}
(26,1,1) = {"
HP
HP
HP
HP
HP
HP
HP
HP
HP
HP
HP
HP
HP
HP
HP
HP
HP
HP
HP
HP
HP
HP
HP
HP
HP
HP
HP
HP
HP
HP
HP
HP
HP
HP
HP
HP
HP
HP
"}
(27,1,1) = {"
HP
HP
HP
HP
HP
HP
HP
HP
HP
HP
HP
HP
HP
HP
HP
HP
HP
HP
HP
HP
HP
HP
HP
HP
HP
HP
HP
HP
HP
HP
HP
HP
HP
HP
HP
HP
HP
HP
"}
(28,1,1) = {"
HP
HP
HP
HP
HP
HP
HP
HP
HP
HP
HP
HP
HP
HP
HP
HP
HP
HP
HP
HP
HP
HP
HP
HP
HP
HP
HP
HP
HP
HP
HP
HP
HP
HP
HP
HP
HP
HP
"}
(29,1,1) = {"
HP
HP
HP
HP
HP
HP
HP
HP
HP
HP
HP
HP
HP
HP
HP
HP
HP
HP
HP
HP
HP
HP
HP
HP
HP
HP
HP
HP
HP
HP
HP
HP
HP
HP
HP
HP
HP
HP
"}
(30,1,1) = {"
uA
uA
uA
uA
uA
uA
uA
uA
uA
uA
uA
uA
uA
uA
uA
uA
uA
uA
uA
uA
uA
uA
uA
uA
uA
uA
uA
uA
uA
uA
uA
uA
uA
uA
uA
uA
uA
HP
"}
(31,1,1) = {"
uA
uA
oN
oN
oN
oN
oN
oN
oN
oN
oN
oN
oN
oN
oN
uA
uA
uA
uA
uA
uA
uA
uA
uA
uA
uA
uA
uA
uA
uA
uA
uA
uA
uA
uA
uA
uA
HP
"}
(32,1,1) = {"
uA
uA
oN
uA
uA
uA
uA
uA
uA
NI
NI
uA
uA
uA
oN
uA
uA
uA
uA
uA
uA
uA
uA
uA
uA
uA
uA
uA
uA
uA
uA
uA
uA
uA
uA
uA
uA
HP
"}
(33,1,1) = {"
uA
uA
oN
uA
uA
uA
uA
uA
NI
gE
gE
NI
uA
uA
oN
uA
uA
uA
uA
uA
uA
uA
uA
uA
uA
uA
uA
uA
uA
uA
uA
uA
uA
uA
uA
uA
uA
HP
"}
(34,1,1) = {"
uA
uA
oN
uA
uA
uA
uA
NI
gE
gE
kP
gE
NI
NI
oN
uA
uA
uA
uA
uA
uA
uA
uA
uA
uA
uA
uA
uA
uA
uA
uA
uA
uA
uA
uA
uA
uA
HP
"}
(35,1,1) = {"
uA
uA
oN
uA
uA
uA
NI
gE
gE
gE
gE
gE
gE
NI
oN
uA
uA
uA
uA
uA
uA
uA
uA
uA
uA
uA
uA
uA
uA
uA
uA
uA
uA
uA
uA
uA
uA
HP
"}
(36,1,1) = {"
uA
uA
oN
uA
uA
uA
gE
gE
gE
gE
gE
gE
gE
gE
oN
uA
uA
uA
uA
uA
uA
uA
uA
uA
uA
uA
uA
uA
uA
uA
uA
uA
uA
uA
uA
uA
uA
HP
"}
(37,1,1) = {"
uA
uA
oN
uA
gE
gE
gE
Ra
gE
gE
gE
gE
gE
gE
oN
uA
uA
uA
uA
uA
uA
uA
uA
uA
uA
uA
uA
uA
uA
uA
uA
uA
uA
uA
uA
uA
uA
HP
"}
(38,1,1) = {"
uA
uA
oN
gE
gE
gE
gE
gE
gE
gE
gE
gE
gE
gE
em
gE
uA
uA
uA
uA
uA
uA
uA
uA
uA
uA
uA
uA
uA
uA
uA
uA
uA
uA
uA
uA
uA
HP
"}
(39,1,1) = {"
gE
gE
em
gE
gE
gE
gE
gE
gE
gE
gE
gE
gE
gE
em
gE
gE
gE
gE
gE
gE
gE
uA
uA
uA
uA
uA
uA
uA
uA
uA
uA
uA
uA
uA
uA
uA
HP
"}
(40,1,1) = {"
gE
NI
em
gE
NI
NI
gE
gE
gE
gE
gE
NI
gE
gE
em
gE
gE
gE
gE
gE
gE
gE
gE
uA
uA
uA
uA
uA
uA
uA
uA
uA
uA
uA
uA
uA
uA
HP
"}
(41,1,1) = {"
gE
gE
em
gE
gE
gE
gE
gE
gE
Yi
gE
gE
NI
NI
BM
NI
NI
NI
gE
NI
CD
NI
gE
gE
gE
Yi
uA
uA
uA
uA
uA
uA
uA
uA
uA
uA
uA
HP
"}
(42,1,1) = {"
gE
gE
em
gE
gE
gE
gE
gE
gE
gE
gE
gE
gE
gE
em
gE
gE
gE
gE
gE
gE
gE
NI
gE
gE
gE
gE
uA
uA
uA
uA
uA
uA
uA
uA
uA
uA
HP
"}
(43,1,1) = {"
gE
uA
oN
uA
uA
uA
uA
NI
gE
gE
gE
gE
gE
gE
em
gE
gE
gE
gE
gE
gE
gE
gE
gE
gE
gE
gE
gE
uA
uA
uA
uA
uA
uA
uA
uA
uA
HP
"}
(44,1,1) = {"
uA
uA
oN
oN
oN
oN
oN
oN
oN
oN
oN
oN
oN
oN
oN
uA
uA
gE
uA
uA
NI
NI
uA
NI
gE
gE
gE
gE
uA
uA
uA
uA
uA
uA
uA
uA
uA
HP
"}
(45,1,1) = {"
uA
uA
uA
uA
uA
uA
uA
uA
uA
uA
uA
uA
uA
uA
uA
uA
uA
uA
uA
uA
uA
uA
uA
uA
gE
gE
gE
gE
gE
uA
uA
uA
uA
uA
uA
uA
uA
HP
"}
(46,1,1) = {"
Vl
Vl
Vl
Vl
Vl
Vl
Vl
Vl
Vl
Vl
Vl
Vl
Vl
Vl
Vl
Vl
Vl
Vl
Vl
Vl
Vl
Vl
uA
uA
NI
gE
gE
gE
gE
gE
uA
uA
uA
uA
uA
uA
uA
HP
"}
(47,1,1) = {"
DE
DE
DE
DE
DE
DE
DE
DE
DE
DE
DE
DE
DE
DE
DE
DE
DE
DE
DE
DE
DE
DE
Vk
uA
gE
gE
gE
gE
gE
gE
gE
uA
uA
uA
uA
uA
uA
HP
"}
(48,1,1) = {"
hL
Ex
Ex
wS
DE
UN
ff
dE
dE
dE
DE
Bh
Ym
Bh
DE
Bh
Ym
Bh
DE
Bh
Ym
Bh
Vk
uA
Is
Yi
gE
Ra
gE
gE
gE
uA
uA
uA
uA
uA
uA
HP
"}
(49,1,1) = {"
Tq
jx
vx
vx
vf
vx
vx
jx
vx
hA
DE
Bh
Bh
Bh
DE
Bh
Bh
Bh
DE
Bh
Bh
Bh
rU
NI
ln
gE
gE
gE
gE
gE
gE
uA
uA
uA
uA
uA
uA
HP
"}
(50,1,1) = {"
Tq
vx
vx
sg
DE
bN
JC
JC
vx
FS
DE
Bh
Bh
Bh
DE
Bh
Bh
Bh
DE
Bh
Bh
Bh
Vk
gE
Is
gE
gE
gE
gE
gE
gE
uA
uA
uA
uA
uA
uA
HP
"}
(51,1,1) = {"
aB
vx
vx
sg
Sk
pA
JC
JC
vx
rj
DE
Sk
oC
Sk
DE
Sk
oC
Sk
DE
Sk
oC
Sk
Vk
gE
Is
gE
gE
NI
gE
gE
gE
gE
uA
uA
uA
uA
uA
HP
"}
(52,1,1) = {"
Tq
vx
vx
sg
Sk
CT
JC
JC
vx
hA
Qr
JW
vx
JW
Qr
JW
vx
JW
Qr
JW
vx
JW
Vk
gE
Is
gE
gE
aM
gE
gE
gE
gE
gE
uA
uA
uA
uA
HP
"}
(53,1,1) = {"
aB
vx
vx
sg
Sk
Gf
vx
JC
JC
vx
hA
hA
vx
hA
Fr
hA
vx
hA
hA
hA
JC
hA
Vk
gE
Is
gE
gE
NI
gE
gE
gE
gE
gE
uA
uA
uA
uA
HP
"}
(54,1,1) = {"
Tq
jx
vx
sg
Sk
Gg
vx
cj
JC
JC
Fe
JC
JC
JC
vx
JC
JC
JC
vx
JC
vx
vx
Vk
gE
Is
gE
gE
NI
gE
gE
gE
gE
gE
uA
uA
uA
uA
HP
"}
(55,1,1) = {"
Tq
vx
vx
sg
Sk
HN
qw
AU
JC
JC
au
Sp
JC
Sp
Sp
Sp
JC
Sp
au
LS
vx
LS
Pr
gE
Is
Yi
gE
gE
gE
gE
gE
gE
Yi
uA
uA
uA
uA
HP
"}
(56,1,1) = {"
iC
qi
qi
kW
Sk
Pn
LS
uY
LS
Vx
Qr
Ti
vx
Nj
Qr
Ti
vx
Ti
Qr
Ti
vx
Ti
Vk
uA
ln
gE
gE
gE
gE
gE
gE
gE
gE
gE
uA
uA
uA
HP
"}
(57,1,1) = {"
DE
DE
DE
DE
DE
Qr
kb
VX
kb
Qr
DE
Sk
oC
Sk
DE
Sk
oC
Sk
DE
Sk
oC
Sk
Vk
uA
uA
uA
uA
gE
gE
gE
gE
gE
gE
gE
uA
uA
uA
HP
"}
(58,1,1) = {"
if
nk
nk
CS
Qr
RW
rl
uY
rl
wi
DE
XW
XW
XW
DE
XW
XW
XW
DE
XW
XW
XW
Vk
uA
uA
uA
uA
gE
uA
uA
gE
gE
gE
gE
gE
uA
uA
HP
"}
(59,1,1) = {"
if
Nd
jr
Fk
Qr
HK
vx
He
Sv
lw
DE
XW
XW
XW
DE
XW
XW
XW
DE
XW
XW
XW
Vk
uA
uA
uA
uA
uA
uA
uA
uA
gE
gE
gE
gE
uA
uA
HP
"}
(60,1,1) = {"
if
nk
jr
Yt
Qr
Uj
Jl
uY
Jl
mX
DE
XW
SS
XW
DE
XW
SS
XW
DE
XW
SS
XW
Vk
Vl
Vl
Vl
Vl
Vl
Vl
Vl
uA
gE
Yi
hN
gE
uA
uA
HP
"}
(61,1,1) = {"
Qr
hd
Qr
Qr
Qr
Qr
kb
VX
kb
Qr
DE
DE
DE
DE
DE
DE
DE
DE
DE
DE
DE
DE
DE
DE
DE
DE
DE
DE
DE
Vl
uA
gE
gE
gE
gE
uA
uA
HP
"}
