//MAP CONVERTED BY dmm2tgm.py THIS HEADER COMMENT PREVENTS RECONVERSION, DO NOT REMOVE
"c" = (
/obj/effect/ai_node,
/turf/open/floor/plating/ground/mars/random/cave,
/area/bigredv3/caves/northeast/garbledradio)
"d" = (
/turf/closed/mineral/smooth/bigred/indestructible,
/area/bigredv3/inside/wall)
"e" = (
/obj/effect/landmark/lv624/fog_blocker,
/turf/open/floor/plating/ground/mars/random/cave,
/area/bigredv3/caves/northeast)
"g" = (
/turf/open/floor/plating/ground/mars/random/cave,
/area/bigredv3/caves/northeast)
"h" = (
/turf/closed/wall/r_wall,
/area/bigredv3/inside/wall)
"k" = (
/turf/open/floor/plating,
/area/bigredv2/caves/lambda_lab)
"l" = (
/obj/machinery/chem_dispenser,
/turf/open/floor/tile/whiteyellow{
	dir = 9
	},
/area/bigredv2/caves/lambda_lab)
"o" = (
/turf/open/floor/plating/ground/mars/random/cave,
/area/bigredv3/caves/northeast/garbledradio)
"r" = (
/turf/closed/mineral/smooth/bigred/indestructible,
/area/space)
"w" = (
/obj/structure/fence/standard/xenoproof,
/turf/open/floor/plating/ground/mars/random/cave,
/area/bigredv3/caves/northeast)
"y" = (
/turf/open/floor/plating/ground/mars/random/cave/rock,
/area/bigredv3/caves/northeast)
"z" = (
/turf/open/floor/plating/ground/mars/random/cave/rock,
/area/bigredv3/caves/northeast/garbledradio)
"C" = (
/obj/machinery/chem_dispenser,
/turf/open/floor/tile/whiteyellow{
	dir = 1
	},
/area/bigredv2/caves/lambda_lab)
"E" = (
/obj/effect/ai_node,
/turf/open/floor/plating/ground/mars/random/cave,
/area/bigredv3/caves/northeast)
"G" = (
/obj/machinery/chem_master,
/turf/open/floor/tile/whiteyellow{
	dir = 5
	},
/area/bigredv2/caves/lambda_lab)
"I" = (
/obj/effect/landmark/lv624/fog_blocker,
/turf/closed/mineral/smooth/bigred,
/area/bigredv3/caves/rock)
"M" = (
/turf/closed/mineral/smooth/bigred,
/area/bigredv3/caves/rock)
"N" = (
/obj/structure/closet/crate/internals,
/turf/open/floor/plating,
/area/bigredv2/caves/lambda_lab)
"V" = (
/obj/effect/landmark/lv624/fog_blocker,
/obj/effect/ai_node,
/turf/open/floor/plating/ground/mars/random/cave,
/area/bigredv3/caves/northeast)
"Y" = (
/obj/structure/closet/crate/freezer/rations,
/turf/open/floor/plating,
/area/bigredv2/caves/lambda_lab)

(1,1,1) = {"
r
r
r
r
r
r
r
r
r
r
r
r
r
r
r
r
r
r
r
r
M
M
M
M
M
o
o
o
o
z
M
M
"}
(2,1,1) = {"
r
r
r
r
r
r
r
r
r
r
r
r
r
r
r
r
r
r
r
r
M
M
M
z
z
o
o
o
o
z
M
M
"}
(3,1,1) = {"
r
r
r
r
r
r
r
r
r
r
r
r
r
r
r
r
r
r
r
r
M
M
M
o
o
o
o
o
o
z
M
M
"}
(4,1,1) = {"
r
r
r
r
r
r
r
r
r
r
r
r
r
r
r
r
r
r
r
r
M
M
M
o
o
o
o
o
o
o
z
M
"}
(5,1,1) = {"
r
r
r
r
r
r
r
r
r
r
r
r
r
r
r
r
r
r
r
r
M
M
M
o
c
o
o
o
o
c
z
M
"}
(6,1,1) = {"
r
r
r
r
r
r
r
r
r
r
r
r
r
r
r
r
r
r
r
r
M
M
M
z
o
o
o
o
o
o
z
M
"}
(7,1,1) = {"
r
r
r
r
r
r
r
r
r
r
r
r
r
r
r
r
r
r
r
r
M
M
M
M
M
z
o
o
o
o
z
M
"}
(8,1,1) = {"
r
r
r
r
r
r
r
r
r
r
r
r
r
r
r
r
r
r
r
r
M
M
M
M
M
M
o
o
o
o
o
z
"}
(9,1,1) = {"
r
r
r
r
r
r
r
r
r
r
r
r
r
r
r
r
r
r
r
r
M
M
M
M
M
M
z
o
o
o
o
o
"}
(10,1,1) = {"
r
d
r
r
r
r
r
r
r
r
r
r
r
r
r
r
r
r
r
r
M
M
M
M
M
M
M
z
o
c
o
o
"}
(11,1,1) = {"
r
r
r
r
r
r
r
r
r
r
r
r
r
r
r
r
r
r
r
r
M
M
M
M
M
M
M
M
o
o
c
o
"}
(12,1,1) = {"
r
r
r
r
r
r
r
r
r
r
r
r
r
r
r
r
r
r
r
r
M
M
M
M
M
M
M
M
o
z
o
c
"}
(13,1,1) = {"
r
r
r
r
r
r
r
r
r
r
r
r
r
r
r
r
r
r
r
r
M
M
M
M
M
M
M
M
o
o
o
M
"}
(14,1,1) = {"
r
r
r
r
r
r
r
r
r
r
r
r
r
r
r
r
r
r
r
r
M
M
M
M
M
M
M
M
o
o
o
M
"}
(15,1,1) = {"
r
r
r
r
r
r
r
r
r
r
r
r
r
r
r
r
r
r
r
r
M
M
M
M
M
M
M
M
o
o
o
M
"}
(16,1,1) = {"
r
r
r
r
r
r
r
r
r
r
r
r
r
r
r
r
r
r
r
r
M
M
M
M
M
M
M
M
o
o
o
o
"}
(17,1,1) = {"
r
r
r
r
r
r
r
r
r
r
r
r
r
r
r
r
r
r
r
r
M
M
M
M
M
M
M
M
o
o
o
o
"}
(18,1,1) = {"
r
r
r
r
r
r
r
r
r
r
r
r
r
r
r
r
r
r
r
r
M
M
M
M
M
M
M
M
o
o
o
c
"}
(19,1,1) = {"
r
r
r
r
r
r
r
r
r
r
r
r
r
r
r
r
r
r
r
r
M
M
M
M
M
M
M
o
o
o
o
o
"}
(20,1,1) = {"
r
r
r
r
r
r
r
r
r
r
r
r
r
r
r
r
r
r
r
r
M
M
M
M
M
M
o
o
o
o
o
o
"}
(21,1,1) = {"
r
r
r
r
r
r
r
r
r
r
r
r
r
r
r
r
r
r
r
r
M
M
M
M
M
M
o
o
o
o
o
o
"}
(22,1,1) = {"
r
r
r
r
r
r
r
r
r
r
r
r
r
r
r
r
r
r
r
r
M
M
M
M
M
o
o
o
o
o
o
o
"}
(23,1,1) = {"
r
r
r
r
r
r
r
r
r
r
r
r
r
r
r
r
r
r
r
r
M
M
M
M
M
o
c
o
o
o
o
c
"}
(24,1,1) = {"
r
r
r
r
r
r
r
r
r
r
r
r
r
r
r
r
r
r
r
r
M
M
M
M
o
o
o
o
o
o
o
o
"}
(25,1,1) = {"
r
r
r
r
r
r
r
r
r
r
r
r
r
r
r
r
r
r
r
r
M
M
M
o
o
o
o
o
o
o
o
o
"}
(26,1,1) = {"
r
r
r
r
r
r
r
r
r
r
r
r
r
r
r
r
r
r
r
r
M
M
M
g
g
o
o
o
o
o
o
M
"}
(27,1,1) = {"
r
r
r
r
r
r
r
r
r
r
r
r
r
r
r
r
r
r
r
r
M
M
g
g
g
g
g
o
o
o
M
M
"}
(28,1,1) = {"
r
r
r
r
r
r
r
r
r
r
r
r
r
r
r
r
r
r
r
r
M
M
E
g
g
g
E
g
o
o
M
I
"}
(29,1,1) = {"
r
r
r
r
r
r
r
r
r
r
r
r
r
r
r
r
r
r
r
r
M
M
g
g
g
g
g
g
o
M
I
M
"}
(30,1,1) = {"
r
r
r
r
r
r
r
r
r
r
r
r
r
r
r
r
r
r
r
r
M
M
M
g
g
g
g
g
M
I
M
M
"}
(31,1,1) = {"
r
r
r
r
r
r
r
r
r
r
r
r
r
r
r
r
r
r
r
r
M
M
M
g
g
g
g
g
M
I
M
h
"}
(32,1,1) = {"
r
r
r
r
r
r
r
r
r
r
r
r
r
r
r
r
r
r
r
r
M
M
M
g
g
g
g
g
M
I
M
h
"}
(33,1,1) = {"
r
r
r
r
r
r
r
r
r
r
r
r
r
r
r
r
r
r
r
r
M
M
M
g
g
g
E
g
M
I
M
h
"}
(34,1,1) = {"
r
r
r
r
r
r
r
r
r
r
r
r
r
r
r
r
r
r
r
r
M
M
M
g
g
g
g
g
M
I
M
h
"}
(35,1,1) = {"
r
r
r
r
r
r
r
r
r
r
r
r
r
r
r
r
r
r
r
r
M
M
M
g
g
g
g
g
M
I
M
h
"}
(36,1,1) = {"
r
r
r
r
r
r
r
r
r
r
r
r
r
r
r
r
r
r
r
r
M
M
M
g
g
g
g
g
M
I
M
M
"}
(37,1,1) = {"
r
r
r
r
r
r
r
r
r
r
r
r
r
r
r
r
r
r
r
r
M
M
M
g
g
g
g
g
M
I
M
M
"}
(38,1,1) = {"
r
r
r
r
r
r
r
r
r
r
r
r
r
r
r
r
r
r
r
r
M
M
M
g
g
g
g
g
M
I
M
M
"}
(39,1,1) = {"
r
r
r
r
r
r
r
r
r
r
r
r
r
r
r
r
r
r
r
r
M
M
M
g
g
g
g
g
w
I
h
h
"}
(40,1,1) = {"
r
r
r
r
r
r
r
r
r
r
r
r
r
r
r
r
r
r
r
r
M
M
M
g
g
g
g
g
w
e
h
k
"}
(41,1,1) = {"
r
r
r
r
r
r
r
r
r
r
r
r
r
r
r
r
r
r
r
r
M
M
M
g
g
g
g
g
w
e
h
N
"}
(42,1,1) = {"
r
r
r
r
r
r
r
r
r
r
r
r
r
r
r
r
r
r
r
r
M
M
M
g
g
g
g
g
w
e
h
Y
"}
(43,1,1) = {"
r
r
r
r
r
r
r
r
r
r
r
r
r
r
r
r
r
r
r
r
M
M
M
g
g
g
E
g
w
V
h
h
"}
(44,1,1) = {"
r
r
r
r
r
r
r
r
r
r
r
r
r
r
r
r
r
r
r
r
M
M
M
g
g
g
g
g
w
e
h
l
"}
(45,1,1) = {"
r
r
r
r
r
r
r
r
r
r
r
r
r
r
r
r
r
r
r
r
M
M
M
g
g
g
g
g
w
e
h
C
"}
(46,1,1) = {"
r
r
r
r
r
r
r
r
r
r
r
r
r
r
r
r
r
r
r
r
M
M
M
g
g
g
g
g
w
e
h
C
"}
(47,1,1) = {"
r
r
r
r
r
r
r
r
r
r
r
r
r
r
r
r
r
r
r
r
M
M
M
g
g
g
g
g
w
e
h
G
"}
(48,1,1) = {"
r
r
r
r
r
r
r
r
r
r
r
r
r
r
r
r
r
r
r
r
M
M
M
M
g
g
g
g
w
e
h
h
"}
(49,1,1) = {"
r
r
r
r
r
r
r
r
r
r
r
r
r
r
r
r
r
r
r
r
M
M
M
M
g
g
g
g
w
w
I
h
"}
(50,1,1) = {"
r
r
r
r
r
r
r
r
r
r
r
r
r
r
r
r
r
r
r
r
M
M
M
M
g
g
g
g
g
g
M
I
"}
(51,1,1) = {"
r
r
r
r
r
r
r
r
r
r
r
r
r
r
r
r
r
r
r
r
M
M
M
M
M
g
g
E
g
g
g
y
"}
(52,1,1) = {"
r
r
r
r
r
r
r
r
r
r
r
r
r
r
r
r
r
r
r
r
M
M
M
M
M
g
E
g
g
g
E
g
"}
(53,1,1) = {"
r
r
r
r
r
r
r
r
r
r
r
r
r
r
r
r
r
r
r
r
M
M
M
M
M
M
g
g
g
g
g
g
"}
(54,1,1) = {"
r
r
r
r
r
r
r
r
r
r
r
r
r
r
r
r
r
r
r
r
M
M
M
M
M
M
g
g
g
g
g
g
"}
(55,1,1) = {"
r
r
r
r
r
r
r
r
r
r
r
r
r
r
r
r
r
r
r
r
M
M
M
M
M
M
M
g
g
g
g
g
"}
(56,1,1) = {"
r
r
r
r
r
r
r
r
r
r
r
r
r
r
r
r
r
r
r
r
M
M
M
M
M
M
M
g
g
g
g
g
"}
(57,1,1) = {"
r
r
r
r
r
r
r
r
r
r
r
r
r
r
r
r
r
r
r
r
M
M
M
M
M
M
M
g
g
g
g
g
"}
(58,1,1) = {"
r
r
r
r
r
r
r
r
r
r
r
r
r
r
r
r
r
r
r
r
M
M
M
M
M
M
M
g
g
g
E
g
"}
(59,1,1) = {"
r
r
r
r
r
r
r
r
r
r
r
r
r
r
r
r
r
r
r
r
M
M
M
M
M
M
M
g
g
g
g
g
"}
(60,1,1) = {"
r
r
r
r
r
r
r
r
r
r
r
r
r
r
r
r
r
r
r
r
M
M
M
M
M
M
M
M
g
g
E
g
"}
(61,1,1) = {"
r
r
r
r
r
r
r
r
r
r
r
r
r
r
r
r
r
r
r
r
M
M
M
M
M
M
M
M
M
g
g
g
"}
(62,1,1) = {"
r
r
r
r
r
r
r
r
r
r
r
r
r
r
r
r
r
r
r
r
M
M
M
M
M
M
M
M
M
g
g
g
"}
(63,1,1) = {"
r
r
r
r
r
r
r
r
r
r
r
r
r
r
r
r
r
r
r
r
M
M
M
M
M
M
M
M
M
g
g
g
"}
(64,1,1) = {"
r
r
r
r
r
r
r
r
r
r
r
r
r
r
r
r
r
r
r
r
M
M
M
M
M
M
M
M
M
g
g
g
"}
(65,1,1) = {"
r
r
r
r
r
r
r
r
r
r
r
r
r
r
r
r
r
r
r
r
M
M
M
M
M
M
M
M
M
g
g
g
"}
