//MAP CONVERTED BY dmm2tgm.py THIS HEADER COMMENT PREVENTS RECONVERSION, DO NOT REMOVE
"ab" = (
/obj/effect/landmark/lv624/fog_blocker,
/turf/open/floor/plating/ground/mars/random/cave/rock,
/area/bigredv3/outside/directions/s)
"br" = (
/obj/effect/forcefield/allow_bullet_travel,
/turf/closed/wall/r_wall/unmeltable,
/area/bigredv3/inside/wall)
"bJ" = (
/obj/effect/landmark/lv624/fog_blocker,
/turf/open/floor/plating/ground/mars/random/cave,
/area/bigredv3/outside/directions/s)
"cc" = (
/obj/structure/cable,
/obj/machinery/atmospherics/pipe/simple/green/hidden{
	dir = 4
	},
/obj/machinery/door/airlock/mainship/engineering/free_access{
	name = "\improper Atmospherics Condenser Storage"
	},
/turf/open/floor,
/area/bigredv3/inside/engi/east)
"cK" = (
/obj/effect/decal/cleanable/dirt,
/turf/open/floor/asteroidfloor,
/area/bigredv3/outside/directions/s)
"ed" = (
/turf/open/floor/plating/ground/mars/cavetodirt{
	dir = 5
	},
/area/bigredv3/outside/directions/s)
"ep" = (
/obj/machinery/atmospherics/pipe/simple/green/hidden{
	dir = 4
	},
/obj/structure/cable,
/turf/open/floor/marking/asteroidwarning,
/area/bigredv3/outside/directions/s)
"es" = (
/obj/machinery/atmospherics/pipe/simple/green/hidden,
/obj/effect/ai_node,
/obj/structure/cable,
/turf/open/floor/marking/asteroidwarning{
	dir = 4
	},
/area/bigredv3/outside/directions/se)
"ez" = (
/obj/effect/ai_node,
/turf/open/floor/marking/asteroidwarning{
	dir = 4
	},
/area/bigredv3/outside/directions/se)
"fa" = (
/obj/machinery/atmospherics/pipe/simple/green/hidden{
	dir = 9
	},
/obj/structure/cable,
/turf/open/floor/marking/asteroidwarning{
	dir = 6
	},
/area/bigredv3/outside/directions/se)
"fN" = (
/obj/structure/table,
/obj/item/tool/lighter/random,
/obj/effect/decal/cleanable/dirt,
/turf/open/floor,
/area/bigredv3/inside/engi/east)
"fW" = (
/turf/open/floor/plating/ground/mars/cavetodirt{
	dir = 1
	},
/area/bigredv3/outside/directions/s)
"hB" = (
/obj/item/clothing/head/warning_cone,
/turf/open/floor/plating/ground/mars/random/dirt,
/area/bigredv3/outside/directions/se)
"hG" = (
/obj/item/clothing/head/warning_cone,
/turf/open/floor/plating/ground/mars/cavetodirt{
	dir = 1
	},
/area/bigredv3/outside/directions/se)
"ii" = (
/obj/effect/landmark/lv624/fog_blocker,
/turf/closed/mineral/smooth/bigred,
/area/bigredv3/caves/rock)
"js" = (
/turf/open/floor/plating/ground/mars/random/dirt,
/area/bigredv3/outside/directions/se)
"jt" = (
/turf/open/floor/plating/ground/mars/random/cave,
/area/bigredv3/caves/east/garbledradio)
"ke" = (
/turf/open/floor/plating/ground/mars/dirttosand/autosmooth{
	dir = 9
	},
/area/bigredv3/outside/directions/s)
"ko" = (
/turf/open/floor/plating/ground/mars/random/cave/rock,
/area/bigredv3/outside/directions/s)
"kv" = (
/obj/structure/window/framed/colony/reinforced/hull,
/obj/effect/forcefield/allow_bullet_travel,
/turf/open/floor/plating,
/area/bigredv3/inside/wall)
"kX" = (
/obj/structure/fence/standard/xenoproof,
/turf/open/floor/plating/ground/mars/random/cave,
/area/bigredv3/outside/directions/se)
"lv" = (
/obj/effect/decal/cleanable/dirt,
/turf/open/floor,
/area/bigredv3/inside/engi/east)
"lG" = (
/obj/effect/decal/cleanable/dirt,
/obj/machinery/atmospherics/components/unary/vent_pump{
	dir = 8;
	on = 1
	},
/turf/open/floor,
/area/bigredv3/inside/engi/east)
"lM" = (
/obj/machinery/light,
/turf/open/floor,
/area/bigredv3/inside/engi/east)
"mw" = (
/turf/open/floor/asteroidfloor,
/area/bigredv3/outside/directions/s)
"mL" = (
/obj/effect/ai_node,
/turf/open/floor/plating/ground/mars/random/cave,
/area/bigredv3/outside/directions/s)
"nb" = (
/turf/open/floor/plating/ground/mars/cavetodirt{
	dir = 8
	},
/area/bigredv3/outside/directions/s)
"nd" = (
/obj/structure/closet/wardrobe/atmospherics_yellow,
/turf/open/floor,
/area/bigredv3/inside/engi/east)
"nf" = (
/turf/open/floor/plating/ground/mars/random/cave,
/area/bigredv3/outside/directions/s)
"ng" = (
/obj/machinery/door/poddoor/two_tile_ver,
/turf/open/floor/plating/ground/mars/random/dirt,
/area/bigredv3/outside/directions/s)
"nm" = (
/turf/open/floor/plating/ground/mars/dirttosand/autosmooth{
	dir = 9
	},
/area/bigredv3/outside/directions/se)
"no" = (
/turf/open/floor/asteroidfloor,
/area/bigredv3/outside/directions/se)
"ov" = (
/obj/structure/cable,
/obj/machinery/atmospherics/pipe/simple/green/hidden{
	dir = 4
	},
/turf/open/floor,
/area/bigredv3/inside/engi/east)
"pJ" = (
/obj/item/clothing/head/warning_cone,
/turf/open/floor/asteroidfloor,
/area/bigredv3/outside/directions/se)
"rr" = (
/turf/open/floor/marking/asteroidwarning{
	dir = 5
	},
/area/bigredv3/outside/directions/se)
"rW" = (
/obj/effect/decal/cleanable/dirt,
/obj/effect/ai_node,
/turf/open/floor/asteroidfloor,
/area/bigredv3/outside/directions/s)
"st" = (
/obj/structure/cable,
/obj/effect/decal/cleanable/dirt,
/obj/machinery/atmospherics/pipe/simple/green/hidden,
/turf/open/floor,
/area/bigredv3/inside/engi/east)
"sC" = (
/obj/structure/cable,
/obj/effect/decal/cleanable/dirt,
/obj/machinery/power/apc/weak/ntf{
	dir = 1
	},
/turf/open/floor,
/area/bigredv3/inside/engi/east)
"tk" = (
/turf/open/floor/plating/ground/mars/random/sand,
/area/bigredv3/outside/directions/s)
"tU" = (
/obj/structure/cable,
/turf/open/floor/marking/asteroidwarning,
/area/bigredv3/outside/directions/se)
"uG" = (
/obj/effect/ai_node,
/turf/open/floor/marking/asteroidwarning{
	dir = 1
	},
/area/bigredv3/outside/directions/se)
"vl" = (
/obj/machinery/floodlight/outpost/bigred,
/turf/open/floor/plating/ground/mars/random/sand,
/area/bigredv3/outside/directions/se)
"wI" = (
/turf/open/floor/plating/ground/mars/cavetodirt{
	dir = 10
	},
/area/bigredv3/outside/directions/s)
"wO" = (
/obj/machinery/power/geothermal,
/obj/structure/cable,
/turf/open/floor/plating,
/area/bigredv3/inside/engi/east)
"wQ" = (
/turf/open/floor/plating/ground/mars/dirttosand/autosmooth{
	dir = 1
	},
/area/bigredv3/outside/directions/s)
"wU" = (
/obj/machinery/door/poddoor/two_tile_hor{
	name = "\improper Eta Lab Lockdown"
	},
/turf/open/floor/plating/ground/mars/random/dirt,
/area/bigredv3/outside/directions/s)
"xc" = (
/obj/machinery/atmospherics/pipe/simple/green/hidden{
	dir = 4
	},
/obj/structure/cable,
/turf/open/floor/marking/asteroidwarning,
/area/bigredv3/outside/directions/se)
"xg" = (
/turf/open/floor,
/area/bigredv3/inside/engi/east)
"xk" = (
/obj/structure/bed/chair{
	dir = 4
	},
/obj/effect/decal/cleanable/dirt,
/turf/open/floor,
/area/bigredv3/inside/engi/east)
"xp" = (
/obj/effect/ai_node,
/turf/open/floor/asteroidfloor,
/area/bigredv3/outside/directions/s)
"yN" = (
/obj/effect/ai_node,
/turf/open/floor/plating/ground/mars/random/sand,
/area/bigredv3/outside/directions/se)
"zp" = (
/obj/structure/window/framed/colony,
/obj/machinery/door/poddoor/shutters/mainship{
	dir = 2;
	id = "Filtration Plant";
	name = "\improper Filtration Plant Shutters"
	},
/turf/open/floor/plating,
/area/bigredv3/inside/wall)
"Al" = (
/obj/machinery/door/poddoor/two_tile_hor{
	name = "\improper Eta Lab Lockdown"
	},
/turf/open/floor/plating/ground/mars/dirttosand/autosmooth{
	dir = 1
	},
/area/bigredv3/outside/directions/s)
"Bd" = (
/turf/open/floor/plating/ground/mars/cavetodirt{
	dir = 9
	},
/area/bigredv3/outside/directions/s)
"Bf" = (
/obj/structure/fence/standard/xenoproof,
/turf/open/floor/plating/ground/mars/random/cave/rock,
/area/bigredv3/outside/directions/s)
"CZ" = (
/obj/machinery/floodlight/outpost/bigred,
/turf/open/floor/plating/ground/mars/dirttosand/autosmooth{
	dir = 1
	},
/area/bigredv3/outside/directions/s)
"EZ" = (
/obj/effect/landmark/lv624/fog_blocker,
/turf/open/floor/plating/ground/mars/cavetodirt{
	dir = 1
	},
/area/bigredv3/outside/directions/se)
"Gp" = (
/obj/machinery/atmospherics/pipe/simple/green/hidden,
/obj/structure/cable,
/turf/open/floor/marking/asteroidwarning{
	dir = 4
	},
/area/bigredv3/outside/directions/se)
"HO" = (
/obj/item/clothing/head/warning_cone,
/turf/open/floor/plating/ground/mars/random/cave,
/area/bigredv3/outside/directions/s)
"IH" = (
/obj/machinery/power/geothermal,
/obj/structure/cable,
/obj/machinery/light{
	dir = 4
	},
/turf/open/floor/plating,
/area/bigredv3/inside/engi/east)
"Jg" = (
/obj/machinery/computer/atmos_alert,
/obj/structure/table,
/turf/open/floor,
/area/bigredv3/inside/engi/east)
"Ji" = (
/obj/effect/ai_node,
/obj/structure/window/framed/colony,
/obj/machinery/door/poddoor/shutters/mainship{
	id = "Filtration Plant";
	name = "\improper Filtration Plant Shutters"
	},
/turf/open/floor/plating,
/area/bigredv3/inside/wall)
"JH" = (
/turf/open/floor/plating/ground/mars/dirttosand/autosmooth{
	dir = 1
	},
/area/bigredv3/outside/directions/se)
"JK" = (
/obj/structure/window/framed/colony,
/obj/machinery/door/poddoor/shutters/mainship{
	id = "Filtration Plant";
	name = "\improper Filtration Plant Shutters"
	},
/turf/open/floor/plating,
/area/bigredv3/inside/wall)
"JM" = (
/obj/item/clothing/head/warning_cone,
/turf/open/floor/asteroidfloor,
/area/bigredv3/outside/directions/s)
"JN" = (
/obj/structure/cable,
/obj/effect/decal/cleanable/dirt,
/obj/machinery/atmospherics/pipe/manifold/green/hidden,
/obj/effect/ai_node,
/turf/open/floor,
/area/bigredv3/inside/engi/east)
"Kn" = (
/turf/closed/wall,
/area/bigredv3/inside/wall)
"Lb" = (
/obj/structure/cable,
/obj/effect/decal/cleanable/dirt,
/obj/machinery/atmospherics/pipe/simple/green/hidden{
	dir = 4
	},
/turf/open/floor,
/area/bigredv3/inside/engi/east)
"LD" = (
/obj/structure/reagent_dispensers/watertank,
/turf/open/floor,
/area/bigredv3/inside/engi/east)
"LI" = (
/obj/machinery/atmospherics/pipe/simple/green/hidden{
	dir = 4
	},
/obj/effect/ai_node,
/obj/structure/cable,
/turf/open/floor/marking/asteroidwarning,
/area/bigredv3/outside/directions/s)
"Mc" = (
/turf/open/floor/plating/ground/mars/cavetodirt{
	dir = 1
	},
/area/bigredv3/outside/directions/se)
"Me" = (
/turf/closed/wall/r_wall,
/area/bigredv3/inside/wall)
"MC" = (
/turf/open/floor/marking/asteroidwarning{
	dir = 1
	},
/area/bigredv3/outside/directions/se)
"Po" = (
/obj/structure/table,
/obj/item/radio/headset/survivor,
/turf/open/floor,
/area/bigredv3/inside/engi/east)
"Qe" = (
/obj/structure/window/framed/colony,
/turf/open/floor/plating,
/area/bigredv3/inside/wall)
"Qp" = (
/obj/machinery/door/poddoor/two_tile_hor{
	name = "\improper Eta Lab Lockdown"
	},
/turf/open/floor/plating/ground/mars/random/dirt,
/area/bigredv3/outside/directions/se)
"Qq" = (
/obj/structure/fence/standard/xenoproof,
/turf/open/floor/plating/ground/mars/random/cave,
/area/bigredv3/outside/directions/s)
"Qy" = (
/obj/machinery/floodlight/outpost/bigred,
/turf/open/floor/plating/ground/mars/random/dirt,
/area/bigredv3/outside/directions/se)
"Re" = (
/obj/effect/ai_node,
/turf/open/floor/plating/ground/mars/random/cave,
/area/bigredv3/outside/directions/se)
"RV" = (
/turf/open/floor/plating/ground/mars/random/dirt,
/area/bigredv3/outside/directions/s)
"RX" = (
/turf/open/floor/plating/ground/mars/random/cave,
/area/bigredv3/outside/directions/se)
"SI" = (
/obj/effect/decal/cleanable/blood/drip,
/turf/open/floor/asteroidfloor,
/area/bigredv3/outside/directions/s)
"Tg" = (
/obj/item/clothing/head/warning_cone,
/turf/open/floor/plating/ground/mars/random/dirt,
/area/bigredv3/outside/directions/s)
"TC" = (
/obj/machinery/floodlight/outpost/bigred,
/turf/open/floor/plating/ground/mars/random/sand,
/area/bigredv3/outside/directions/s)
"Uj" = (
/turf/open/liquid/water/river,
/area/bigredv3/caves/rock)
"UR" = (
/turf/open/floor/plating/ground/mars/cavetodirt{
	dir = 9
	},
/area/bigredv3/outside/directions/se)
"Va" = (
/obj/item/clothing/head/warning_cone,
/turf/open/floor/plating/ground/mars/random/cave/rock,
/area/bigredv3/outside/directions/s)
"Vb" = (
/turf/closed/mineral/smooth/bigred,
/area/bigredv3/caves/rock)
"VI" = (
/turf/open/floor/plating/ground/mars/random/sand,
/area/bigredv3/outside/directions/se)
"Wr" = (
/obj/effect/landmark/lv624/fog_blocker,
/turf/open/floor/plating/ground/mars/random/cave,
/area/bigredv3/outside/directions/se)
"Xi" = (
/obj/structure/cable,
/obj/machinery/atmospherics/pipe/simple/green/hidden{
	dir = 4
	},
/obj/effect/ai_node,
/turf/open/floor,
/area/bigredv3/inside/engi/east)
"Xt" = (
/obj/effect/decal/cleanable/dirt,
/obj/machinery/atmospherics/pipe/simple/green/hidden{
	dir = 4
	},
/obj/structure/cable,
/turf/open/floor/marking/asteroidwarning,
/area/bigredv3/outside/directions/s)
"YE" = (
/obj/machinery/atmospherics/pipe/simple/green/hidden{
	dir = 6
	},
/obj/structure/cable,
/turf/open/floor/marking/asteroidwarning{
	dir = 4
	},
/area/bigredv3/outside/directions/se)
"YM" = (
/turf/open/floor/plating,
/area/bigredv3/inside/engi/east)
"YP" = (
/turf/open/floor/marking/asteroidwarning{
	dir = 4
	},
/area/bigredv3/outside/directions/se)
"Zd" = (
/obj/structure/cable,
/turf/open/floor/plating,
/area/bigredv3/inside/engi/east)

(1,1,1) = {"
Kn
cc
Kn
Kn
Ji
JK
JK
Kn
Kn
JK
JK
JK
Kn
Kn
LI
tk
tk
Me
Me
Me
Me
wI
ng
Me
Me
"}
(2,1,1) = {"
nd
ov
LD
Kn
mw
xp
mw
mw
mw
mw
mw
cK
cK
rW
ep
tk
TC
Me
Vb
Vb
Vb
nf
nb
ko
Vb
"}
(3,1,1) = {"
nd
Xi
lM
Kn
mw
mw
mw
mw
mw
mw
mw
mw
mw
JM
ep
tk
tk
Me
Vb
Vb
Vb
nf
ko
Vb
Vb
"}
(4,1,1) = {"
nd
ov
xg
Kn
SI
mw
br
kv
kv
kv
kv
br
cK
cK
ep
tk
ke
Me
Tg
Bd
HO
nf
ko
Vb
Vb
"}
(5,1,1) = {"
Kn
cc
Kn
Kn
mw
mw
kv
Uj
Uj
Uj
Uj
kv
cK
mw
ep
tk
wQ
wU
RV
fW
nf
nf
Va
Vb
Vb
"}
(6,1,1) = {"
fN
Lb
sC
Kn
mw
mw
kv
Uj
Uj
Uj
Uj
kv
cK
mw
Xt
tk
wQ
wQ
RV
fW
nf
nf
nf
ko
Vb
"}
(7,1,1) = {"
lv
Lb
xg
zp
mw
mw
kv
Uj
Uj
Uj
Uj
kv
cK
cK
Xt
tk
wQ
Me
Tg
ed
nf
nf
nf
ko
ii
"}
(8,1,1) = {"
st
JN
lv
zp
mw
mw
kv
Uj
Uj
Uj
Uj
kv
mw
cK
Xt
tk
CZ
Me
RV
RV
fW
nf
nf
ab
Vb
"}
(9,1,1) = {"
lv
lG
lv
zp
mw
mw
br
kv
kv
kv
kv
br
cK
mw
ep
tk
wQ
Me
Tg
Bd
nf
bJ
bJ
ko
Vb
"}
(10,1,1) = {"
lv
lv
xk
zp
mw
xp
mw
mw
mw
cK
cK
cK
mw
xp
ep
tk
wQ
Al
RV
fW
bJ
mL
nf
ko
Vb
"}
(11,1,1) = {"
Po
xg
Jg
Kn
mw
mw
mw
cK
cK
mw
mw
mw
cK
mw
ep
tk
wQ
RV
Bd
bJ
nf
nf
nf
ko
Vb
"}
(12,1,1) = {"
Qe
Qe
Qe
Kn
mw
mw
br
kv
kv
kv
kv
br
cK
mw
ep
tk
wQ
Me
Va
bJ
nf
nf
ko
Vb
Vb
"}
(13,1,1) = {"
YM
YM
YM
Kn
mw
mw
kv
Uj
Uj
Uj
Uj
kv
mw
mw
ep
tk
wQ
Me
ii
nf
nf
nf
ko
Vb
Vb
"}
(14,1,1) = {"
Zd
Zd
Zd
Kn
mw
mw
kv
Uj
Uj
Uj
Uj
kv
mw
mw
ep
tk
CZ
Me
ii
nf
nf
nf
nf
Bf
ko
"}
(15,1,1) = {"
wO
IH
wO
Kn
mw
mw
kv
Uj
Uj
Uj
Uj
kv
mw
mw
ep
tk
wQ
Me
ab
nf
nf
nf
Qq
Qq
nf
"}
(16,1,1) = {"
Kn
Kn
Kn
Kn
mw
mw
kv
Uj
Uj
Uj
Uj
kv
mw
mw
ep
tk
wQ
Me
ed
bJ
nf
nf
Qq
nf
nf
"}
(17,1,1) = {"
Vb
VI
VI
VI
MC
no
br
kv
kv
kv
kv
br
no
no
xc
VI
JH
Me
hB
EZ
RX
kX
kX
RX
RX
"}
(18,1,1) = {"
Vb
Vb
VI
VI
MC
pJ
no
no
no
no
no
no
no
pJ
xc
VI
JH
Qp
js
Mc
Wr
kX
RX
RX
RX
"}
(19,1,1) = {"
Vb
Vb
VI
VI
rr
ez
YP
ez
YE
Gp
Gp
Gp
Gp
es
fa
nm
js
js
UR
Wr
Re
kX
RX
RX
Re
"}
(20,1,1) = {"
Vb
VI
VI
VI
VI
VI
VI
MC
xc
VI
VI
VI
VI
VI
VI
JH
js
Me
hG
RX
Wr
kX
RX
RX
RX
"}
(21,1,1) = {"
VI
VI
VI
VI
VI
VI
VI
MC
xc
VI
VI
VI
VI
VI
nm
js
js
Me
Mc
Vb
ii
kX
RX
RX
RX
"}
(22,1,1) = {"
VI
VI
VI
VI
vl
VI
VI
MC
xc
VI
VI
vl
VI
VI
JH
js
Qy
Me
Vb
ii
Vb
RX
RX
RX
RX
"}
(23,1,1) = {"
yN
VI
VI
VI
VI
VI
VI
uG
tU
VI
VI
VI
VI
nm
js
js
js
Me
Vb
ii
Vb
RX
RX
RX
RX
"}
(24,1,1) = {"
VI
VI
VI
VI
VI
VI
VI
MC
tU
VI
VI
VI
nm
js
js
js
js
Me
Vb
ii
Vb
jt
jt
jt
jt
"}
