//MAP CONVERTED BY dmm2tgm.py THIS HEADER COMMENT PREVENTS RECONVERSION, DO NOT REMOVE
"a" = (
/turf/open/space/basic,
/area/space)
"d" = (
/obj/effect/landmark/lv624/fog_blocker/xeno_spawn,
/turf/closed/mineral/smooth/bigred,
/area/bigredv2/caves/rock)
"e" = (
/obj/machinery/miner/damaged/platinum,
/turf/open/floor/plating/ground/mars/random/cave,
/area/bigredv2/caves/southeast)
"j" = (
/obj/effect/landmark/lv624/fog_blocker/xeno_spawn,
/turf/open/floor/plating/ground/mars/random/cave,
/area/bigredv2/caves/southeast)
"k" = (
/turf/closed/mineral/smooth/bigred/indestructible,
/area/bigredv2/caves/rock)
"l" = (
/obj/machinery/miner/damaged/platinum,
/turf/open/floor/plating/ground/mars/random/cave,
/area/bigredv2/caves/southeast/garbledradio)
"m" = (
/obj/effect/landmark/excavation_site_spawner,
/turf/open/floor/plating/ground/mars/random/cave,
/area/bigredv2/caves/southeast/garbledradio)
"q" = (
/obj/effect/landmark/patrol_point/tgmc_11,
/turf/open/floor/plating/ground/mars/random/cave,
/area/bigredv2/caves/southeast)
"v" = (
/turf/closed/mineral/smooth/bigred/indestructible,
/area/space)
"y" = (
/turf/open/floor/plating/ground/mars/random/cave,
/area/bigredv2/caves/east)
"D" = (
/turf/open/floor/plating/ground/mars/random/cave,
/area/bigredv2/caves/southeast)
"E" = (
/obj/effect/ai_node,
/turf/open/floor/plating/ground/mars/random/cave,
/area/bigredv2/caves/southeast/garbledradio)
"F" = (
/obj/effect/ai_node,
/turf/open/floor/plating/ground/mars/random/cave,
/area/bigredv2/caves/southeast)
"G" = (
/obj/effect/ai_node,
/turf/open/floor/plating/ground/mars/random/cave/rock,
/area/bigredv2/caves/southeast/garbledradio)
"I" = (
/obj/docking_port/stationary/crashmode,
/turf/closed/mineral/smooth/bigred,
/area/bigredv2/caves/rock)
"O" = (
/obj/effect/landmark/excavation_site_spawner,
/turf/open/floor/plating/ground/mars/random/cave,
/area/bigredv2/caves/southeast)
"R" = (
/obj/effect/landmark/xeno_silo_spawn,
/turf/open/floor/plating/ground/mars/random/cave,
/area/bigredv2/caves/southeast)
"S" = (
/turf/open/floor/plating/ground/mars/random/cave,
/area/bigredv2/caves/southeast/garbledradio)
"V" = (
/turf/closed/mineral/smooth/bigred,
/area/bigredv2/caves/rock)
"W" = (
/turf/open/floor/plating/ground/mars/random/cave/rock,
/area/bigredv2/caves/southeast)
"X" = (
/turf/open/floor/plating/ground/mars/random/cave/rock,
/area/bigredv2/caves/southeast/garbledradio)

(1,1,1) = {"
V
V
V
V
V
V
V
V
V
V
V
V
V
V
V
V
S
S
S
S
S
S
X
V
V
V
V
V
V
V
V
D
D
D
D
D
D
V
V
V
V
V
V
V
V
V
V
V
V
V
D
D
D
D
V
V
V
V
V
V
V
V
V
V
v
v
a
"}
(2,1,1) = {"
y
V
V
V
V
V
V
V
V
V
V
V
V
V
X
X
S
S
S
V
S
S
X
V
V
V
V
V
V
V
V
D
D
D
D
D
V
V
V
V
V
V
V
V
V
V
V
V
V
V
D
D
D
D
V
V
V
V
V
V
V
V
V
V
V
v
a
"}
(3,1,1) = {"
V
V
V
V
V
V
V
V
V
V
V
V
V
V
S
S
S
S
S
V
X
S
X
V
V
V
V
V
V
V
V
D
D
D
D
D
V
V
V
V
V
V
V
V
V
V
V
V
V
V
D
D
D
D
V
V
V
V
V
V
V
V
V
V
V
v
a
"}
(4,1,1) = {"
V
V
V
V
V
V
V
V
V
V
V
V
V
G
S
S
E
S
V
V
V
D
X
V
V
V
V
V
V
V
V
D
D
D
D
D
V
V
V
V
V
V
V
V
V
V
V
V
V
V
D
D
D
D
V
V
V
V
V
V
V
V
V
V
V
v
a
"}
(5,1,1) = {"
V
V
V
V
V
V
V
V
V
V
V
V
V
S
S
X
S
S
V
V
V
D
X
V
V
V
V
V
V
V
V
D
D
D
D
D
V
V
V
V
V
V
V
V
V
V
V
V
V
V
D
D
F
D
V
V
V
V
V
V
V
V
V
V
V
v
a
"}
(6,1,1) = {"
V
V
V
V
V
V
V
V
V
V
V
X
X
S
S
X
S
S
V
V
V
D
X
V
V
V
V
V
V
V
V
D
D
D
D
D
V
V
I
V
V
V
V
V
V
V
V
V
V
V
D
D
D
D
V
V
V
V
V
V
V
V
V
V
V
v
a
"}
(7,1,1) = {"
V
V
V
V
V
V
V
V
V
V
V
S
S
S
X
S
S
V
V
V
V
D
X
V
V
V
V
V
V
V
V
D
D
D
D
D
V
V
V
V
V
V
V
V
V
V
V
V
V
V
D
D
D
D
V
V
V
V
V
V
V
V
V
V
V
v
a
"}
(8,1,1) = {"
V
V
V
V
V
V
V
V
V
V
V
S
S
E
S
V
V
V
V
V
V
D
X
V
V
V
V
V
V
V
V
D
D
D
D
D
V
V
V
V
V
V
V
V
V
V
V
V
V
V
D
D
D
D
V
V
V
V
V
V
V
V
V
V
V
v
a
"}
(9,1,1) = {"
V
V
V
V
V
V
V
V
V
V
V
S
G
S
S
V
V
V
V
V
V
D
X
V
V
V
V
V
V
V
V
D
D
D
D
D
V
V
V
V
V
V
V
V
V
V
V
V
V
V
D
D
D
D
V
V
V
V
V
V
V
V
V
V
V
v
a
"}
(10,1,1) = {"
V
V
V
V
V
V
V
V
V
V
X
S
X
S
S
V
V
V
V
S
S
E
X
V
V
V
V
V
V
V
D
D
D
D
D
D
V
V
V
V
V
V
V
V
V
V
V
V
V
V
D
D
D
D
V
V
V
V
V
V
V
V
V
V
V
v
a
"}
(11,1,1) = {"
V
V
V
V
V
V
V
V
V
V
S
S
X
m
X
X
X
X
X
S
S
S
X
V
V
V
V
V
V
D
D
D
D
F
D
D
D
V
V
V
V
V
V
V
V
V
V
V
V
V
D
D
D
D
V
V
V
V
V
V
V
V
V
V
V
v
a
"}
(12,1,1) = {"
I
V
V
V
V
V
V
V
V
V
S
S
S
X
S
S
S
S
X
S
S
S
V
V
V
V
V
D
F
D
D
D
F
D
D
D
D
V
V
V
V
V
V
V
V
V
V
V
V
V
D
D
D
V
V
V
V
V
V
V
V
V
V
V
V
v
a
"}
(13,1,1) = {"
V
V
V
V
V
V
V
V
V
V
S
S
S
S
S
S
E
S
S
S
S
S
V
V
V
V
V
D
D
D
D
D
D
D
D
D
D
V
V
V
V
V
V
V
V
V
V
V
V
D
D
D
D
V
V
V
V
V
V
V
V
V
V
V
V
v
a
"}
(14,1,1) = {"
X
S
V
V
V
V
V
V
V
X
S
S
S
S
S
S
S
S
S
S
S
X
V
V
V
V
V
D
D
D
D
D
D
D
D
D
D
D
D
V
V
V
V
V
V
V
V
V
V
D
D
D
F
V
V
V
V
V
V
V
V
V
V
V
V
v
a
"}
(15,1,1) = {"
X
V
V
V
V
V
V
V
V
S
E
S
E
S
S
S
E
S
S
X
V
V
V
V
V
D
D
D
D
D
D
D
D
D
D
D
D
D
D
D
D
V
V
V
V
V
V
V
D
D
D
F
D
V
V
V
V
V
V
V
V
V
V
V
V
v
a
"}
(16,1,1) = {"
X
V
V
V
V
V
V
X
X
S
X
S
S
S
S
S
S
S
S
S
S
V
V
V
V
D
D
D
D
D
O
D
D
D
D
D
D
D
D
D
D
D
D
D
D
V
V
V
D
D
D
D
D
V
V
V
V
V
V
V
V
V
V
V
V
v
a
"}
(17,1,1) = {"
S
V
V
V
V
V
V
S
S
S
X
S
S
S
V
V
V
W
D
D
D
V
V
V
V
D
D
D
D
D
D
D
D
D
D
D
D
D
D
D
D
D
D
D
D
D
D
D
D
D
D
D
V
V
V
V
V
V
V
V
V
V
V
V
V
v
a
"}
(18,1,1) = {"
S
V
V
V
V
V
V
X
S
X
S
S
S
V
V
V
V
V
S
S
E
S
D
D
D
D
D
D
D
D
D
D
D
D
D
D
D
D
D
D
D
D
D
D
D
D
D
D
D
D
D
D
V
V
V
V
V
V
V
V
V
V
V
V
V
v
a
"}
(19,1,1) = {"
S
V
V
V
V
V
S
S
S
X
S
V
V
V
V
V
V
V
V
V
S
D
D
D
D
D
D
D
F
D
D
D
D
F
D
D
D
D
D
D
D
D
F
D
D
D
D
e
D
F
D
F
V
V
V
V
V
V
V
V
V
V
V
V
V
k
a
"}
(20,1,1) = {"
S
V
V
S
S
S
E
S
S
S
E
V
V
V
V
V
V
V
V
V
D
D
D
D
D
D
D
D
D
D
D
D
D
D
D
D
D
D
D
D
D
D
D
D
D
D
D
D
D
D
D
D
V
V
V
V
V
V
V
V
V
V
V
V
V
k
a
"}
(21,1,1) = {"
S
S
S
S
S
S
S
S
X
S
V
V
V
V
V
V
V
V
V
V
F
D
D
D
F
D
D
D
F
D
D
D
D
D
D
V
V
D
D
D
D
D
D
D
D
D
D
D
D
D
D
V
V
V
V
V
V
V
V
V
V
V
V
V
V
k
a
"}
(22,1,1) = {"
S
S
S
S
X
X
S
S
S
S
V
V
V
V
V
V
V
V
V
V
V
D
D
D
D
D
D
D
D
D
e
D
D
D
V
V
V
V
V
D
D
D
D
D
D
D
D
D
D
D
D
V
V
V
V
V
V
V
V
V
V
V
V
V
V
k
a
"}
(23,1,1) = {"
l
E
S
X
S
S
E
S
S
V
V
V
V
V
V
V
V
V
V
V
V
V
V
V
V
V
V
V
D
D
D
D
D
V
V
V
V
V
V
V
D
D
D
D
D
D
D
D
D
D
D
V
V
V
V
V
V
V
V
V
V
V
V
V
V
k
a
"}
(24,1,1) = {"
S
X
X
S
S
S
S
X
V
V
V
V
V
V
V
V
V
V
V
V
V
V
V
V
V
V
V
V
V
V
V
V
V
V
V
V
V
V
V
V
D
D
D
D
D
D
O
D
D
D
D
D
V
V
V
V
V
V
V
V
V
V
V
V
V
k
a
"}
(25,1,1) = {"
X
S
S
X
V
V
V
V
V
V
V
V
V
V
V
V
V
V
V
V
V
V
V
V
V
V
V
V
V
V
V
V
V
V
V
V
V
V
V
V
D
D
D
D
D
D
D
D
D
D
D
D
V
V
V
V
V
V
V
V
V
V
V
V
V
k
a
"}
(26,1,1) = {"
S
S
S
X
V
V
V
V
V
V
V
V
V
V
V
V
V
V
V
V
V
V
V
V
V
V
V
V
V
V
V
V
V
V
V
V
V
V
V
V
D
D
D
D
D
D
D
D
D
D
D
D
V
V
V
V
V
V
V
V
V
V
V
V
V
k
a
"}
(27,1,1) = {"
V
V
V
V
V
V
V
V
V
V
V
V
V
V
V
V
V
V
V
V
V
V
V
V
V
V
V
V
V
V
V
V
V
V
V
V
V
V
V
D
D
D
D
D
D
D
D
D
D
D
D
D
V
V
V
V
V
V
V
V
V
V
V
V
V
k
a
"}
(28,1,1) = {"
V
V
V
V
V
V
V
V
V
V
V
V
V
V
V
V
V
V
V
V
V
V
V
V
V
V
V
V
V
V
V
V
V
V
V
V
V
V
D
D
D
D
D
D
D
D
D
D
D
V
V
V
V
V
V
V
V
V
V
V
V
V
V
V
V
k
a
"}
(29,1,1) = {"
V
V
V
V
V
V
V
V
V
V
V
V
V
V
V
V
V
V
V
V
V
V
V
V
V
V
V
V
V
V
V
V
V
V
V
V
V
D
D
D
D
D
D
D
D
D
D
D
V
V
V
V
V
V
V
V
V
V
V
V
V
V
V
V
V
k
a
"}
(30,1,1) = {"
V
V
V
V
V
V
V
V
V
V
V
V
V
V
V
V
V
V
V
V
V
V
V
V
V
V
V
V
V
V
V
V
V
V
V
V
D
D
D
D
D
D
D
D
D
D
D
D
V
V
V
V
V
V
V
V
V
V
V
V
V
V
V
V
V
k
a
"}
(31,1,1) = {"
V
V
V
V
V
V
V
V
V
V
V
V
V
V
V
V
V
V
V
V
V
V
V
V
V
V
V
V
V
V
V
V
V
V
V
V
D
D
D
D
D
D
D
D
D
D
D
D
V
V
V
V
V
V
V
V
V
V
V
V
V
V
V
V
V
k
a
"}
(32,1,1) = {"
D
D
V
V
V
V
V
V
V
V
V
V
V
V
V
V
V
V
V
V
V
V
V
V
V
V
V
V
V
V
V
V
V
D
D
D
D
D
D
D
j
j
j
j
j
j
j
j
d
d
d
d
V
V
V
V
V
V
V
V
V
V
V
V
V
k
a
"}
(33,1,1) = {"
D
D
D
D
F
D
D
V
V
V
V
V
V
V
V
V
V
V
V
V
V
V
V
V
V
V
V
V
V
V
V
V
D
D
D
D
D
D
D
D
j
D
D
D
D
D
D
D
D
V
V
d
V
V
V
V
V
V
V
V
V
V
V
V
V
k
a
"}
(34,1,1) = {"
D
D
D
D
D
D
D
D
D
V
V
V
V
V
V
V
V
V
V
V
V
V
V
V
V
V
V
V
V
V
V
D
D
D
D
D
D
D
D
D
j
D
D
D
D
D
D
D
D
V
V
d
V
V
V
V
V
V
V
V
V
V
V
V
V
k
a
"}
(35,1,1) = {"
D
D
D
D
D
D
D
D
D
D
D
V
V
V
V
V
V
V
V
V
V
V
V
V
V
V
V
V
V
D
D
D
D
D
D
D
D
D
D
D
j
D
D
D
D
D
D
D
D
D
V
d
V
V
V
V
V
V
V
V
V
V
V
V
V
k
a
"}
(36,1,1) = {"
D
D
D
D
D
D
D
D
D
D
D
D
D
D
V
V
V
V
V
V
V
V
V
V
V
V
V
D
D
D
D
D
D
D
D
D
D
D
D
D
j
D
D
D
D
D
D
D
D
D
V
d
V
V
V
V
V
V
V
V
V
V
V
V
V
k
a
"}
(37,1,1) = {"
D
D
D
D
F
D
D
F
D
D
D
D
D
D
D
D
D
D
V
V
V
V
V
V
V
D
D
D
D
D
D
D
D
D
D
D
D
D
D
D
j
D
D
D
D
q
D
D
D
D
D
d
V
V
V
V
V
V
V
V
V
V
V
V
V
k
a
"}
(38,1,1) = {"
V
V
D
D
D
D
D
D
D
D
D
D
D
D
D
D
D
D
D
D
V
V
V
D
D
D
D
D
D
D
D
D
D
D
D
D
D
D
D
D
j
D
D
D
D
D
D
D
D
D
D
d
V
V
V
V
V
V
V
V
V
V
V
v
v
v
a
"}
(39,1,1) = {"
V
V
D
D
D
D
D
F
D
D
D
D
D
D
F
D
D
D
D
D
D
V
D
D
D
D
D
D
D
D
D
D
D
e
D
D
D
D
D
D
j
D
D
D
D
D
D
D
R
D
D
d
V
V
V
V
V
V
V
V
V
V
V
v
v
v
a
"}
(40,1,1) = {"
V
V
D
D
D
D
D
D
D
D
D
D
D
D
D
D
D
D
D
D
D
D
D
D
D
D
D
D
D
D
D
D
D
D
D
D
D
D
D
D
j
D
D
D
D
D
D
D
D
D
D
d
V
V
V
V
V
V
V
V
V
V
V
v
v
v
a
"}
(41,1,1) = {"
D
D
D
D
D
D
D
D
D
D
D
D
D
D
D
D
D
D
D
D
D
D
D
D
D
D
D
D
D
D
D
D
D
D
D
D
D
D
D
D
j
D
V
D
D
D
D
D
D
D
D
d
V
V
V
V
V
V
V
V
V
V
V
v
v
v
a
"}
(42,1,1) = {"
D
D
D
D
D
D
D
D
D
D
D
D
D
D
D
D
D
D
D
D
D
D
D
O
D
D
D
D
D
D
D
D
D
D
D
D
D
D
D
D
d
V
V
V
D
D
F
D
F
D
D
d
V
V
V
V
V
V
V
V
V
V
V
v
v
v
a
"}
(43,1,1) = {"
D
D
D
D
D
D
D
D
D
D
D
D
D
D
D
e
D
D
D
D
D
D
D
D
D
D
D
D
D
D
D
D
D
D
D
D
D
D
V
V
d
V
V
V
D
D
D
D
D
D
V
d
V
V
V
V
V
V
V
V
V
V
V
v
v
v
a
"}
(44,1,1) = {"
D
D
D
D
D
D
D
D
D
D
D
D
D
D
D
D
D
D
D
D
D
D
D
D
D
D
D
D
D
D
D
D
D
D
D
D
V
V
V
V
d
V
V
V
D
D
D
D
D
V
V
d
V
V
V
V
V
V
V
V
V
V
V
v
v
v
a
"}
(45,1,1) = {"
D
F
D
D
D
D
O
F
D
D
D
D
D
D
F
D
D
D
D
D
D
D
D
D
D
D
D
D
D
D
D
D
D
D
V
V
V
V
V
V
d
V
V
V
V
D
D
D
V
V
V
d
V
V
V
V
V
V
V
V
V
V
V
v
v
v
a
"}
(46,1,1) = {"
D
D
D
D
D
D
D
D
D
D
D
D
D
D
D
D
D
D
D
D
D
D
D
D
D
D
D
D
D
D
D
D
D
D
V
V
V
V
V
V
d
V
V
V
V
V
V
V
V
V
V
d
V
V
V
V
V
V
V
V
V
V
V
v
v
v
a
"}
(47,1,1) = {"
D
D
D
D
D
D
D
D
D
D
D
D
D
D
D
D
D
D
D
D
D
D
D
D
D
D
D
D
D
D
D
D
D
D
V
V
V
V
V
V
d
V
V
V
V
V
V
V
V
V
V
d
V
V
V
V
V
V
V
V
V
V
V
v
v
v
a
"}
(48,1,1) = {"
D
D
D
D
D
D
D
D
D
D
D
D
D
D
D
D
D
D
D
D
D
D
D
D
D
D
D
D
D
D
D
D
D
V
V
V
V
V
V
V
d
d
d
d
d
d
d
d
d
d
d
d
V
V
V
V
V
V
V
V
V
V
V
v
v
v
a
"}
(49,1,1) = {"
D
F
D
D
D
D
D
D
V
V
V
V
V
V
V
D
D
D
D
D
D
D
D
D
D
D
D
D
D
D
D
D
D
V
V
V
V
V
V
V
V
V
V
V
V
V
V
V
V
V
V
V
V
V
V
V
V
V
V
V
V
V
V
v
v
v
a
"}
(50,1,1) = {"
D
D
D
V
V
V
V
V
V
V
V
V
V
V
V
V
V
D
D
D
D
D
D
D
D
D
D
D
D
D
D
V
V
V
V
V
V
V
V
V
V
V
V
V
V
V
V
V
V
V
V
V
V
V
V
V
V
V
V
V
V
V
V
v
v
v
a
"}
(51,1,1) = {"
D
D
D
V
V
V
V
V
V
V
V
V
V
V
V
V
V
V
V
D
D
D
D
D
D
D
D
D
D
D
V
V
V
V
V
V
V
V
V
V
V
V
V
V
V
V
V
V
V
V
V
V
V
V
V
V
V
V
V
V
V
V
V
v
v
v
a
"}
(52,1,1) = {"
V
V
V
V
V
V
V
V
V
V
V
V
V
V
V
V
V
V
V
V
V
V
V
V
V
V
V
V
V
V
V
V
V
V
V
V
V
V
V
V
V
V
V
V
V
V
V
V
V
V
V
V
V
V
V
V
V
V
V
V
V
V
V
v
v
v
a
"}
(53,1,1) = {"
V
V
V
V
V
V
V
V
V
V
V
V
V
V
V
V
V
V
V
V
V
V
V
V
V
V
V
V
V
V
V
V
V
V
V
V
V
V
V
V
V
V
V
V
V
V
V
V
V
V
V
V
V
V
V
V
V
V
V
V
V
V
V
v
v
v
a
"}
(54,1,1) = {"
V
V
V
V
V
V
V
V
V
V
V
V
V
V
V
V
V
V
V
V
V
V
V
V
V
V
V
V
V
V
V
V
V
V
V
V
V
V
V
V
V
V
V
V
V
V
V
V
V
V
V
V
V
V
V
V
V
V
V
V
V
V
V
v
v
v
a
"}
(55,1,1) = {"
V
V
V
V
V
V
V
V
V
V
V
V
V
V
V
V
V
V
V
V
V
V
V
V
V
V
V
V
V
V
V
V
V
V
V
V
V
V
V
V
V
V
V
V
V
V
V
V
V
V
V
V
V
V
V
V
V
V
V
V
V
V
V
v
v
v
a
"}
(56,1,1) = {"
V
V
V
V
V
V
V
V
V
V
V
V
V
V
V
V
V
V
V
V
V
V
V
V
V
V
V
V
V
V
V
V
V
V
V
V
V
V
V
V
V
V
V
V
V
V
V
V
V
V
V
V
V
V
V
V
V
V
V
V
V
V
V
v
v
v
a
"}
(57,1,1) = {"
V
V
V
V
V
V
V
V
V
V
V
V
V
V
V
V
V
V
V
V
V
V
V
V
V
V
V
V
V
V
V
V
V
V
V
V
V
V
V
V
V
V
V
V
V
V
V
V
V
V
V
V
V
V
V
V
V
V
V
V
V
V
V
v
v
v
a
"}
(58,1,1) = {"
V
V
V
V
V
V
V
V
V
V
V
V
V
V
V
V
V
V
V
V
V
V
V
V
V
V
V
V
V
V
V
V
V
V
V
V
V
V
V
V
V
V
V
V
V
V
V
V
V
V
V
V
V
V
V
V
V
V
V
V
V
V
V
v
v
v
a
"}
(59,1,1) = {"
V
V
V
V
V
V
V
V
V
V
V
V
V
V
V
V
V
V
V
V
V
V
V
V
V
V
V
V
V
V
V
V
V
V
V
V
V
V
V
V
V
V
V
V
V
V
V
V
V
V
V
V
V
V
V
V
V
V
V
V
V
V
V
v
v
v
a
"}
(60,1,1) = {"
V
V
V
V
V
V
V
V
V
V
V
V
V
V
V
V
V
V
V
V
V
V
V
V
V
V
V
V
V
V
V
V
V
V
V
V
V
V
V
V
V
V
V
V
V
V
V
V
V
V
V
V
V
V
V
V
V
V
V
V
V
V
V
v
v
v
a
"}
(61,1,1) = {"
V
V
V
V
V
V
V
V
V
V
V
V
V
V
V
V
V
V
V
V
V
V
V
V
V
V
V
V
V
V
V
V
V
V
V
V
V
V
V
V
V
V
V
V
V
V
V
V
V
V
V
V
V
V
V
V
V
V
V
V
V
V
V
v
v
v
a
"}
(62,1,1) = {"
V
V
V
V
V
V
V
V
V
V
V
V
V
V
V
V
V
V
V
V
V
V
V
V
V
V
V
V
V
V
V
V
V
V
V
V
V
V
V
V
V
V
V
V
V
V
V
V
V
V
V
V
V
V
V
V
V
V
V
V
V
V
V
v
v
v
a
"}
(63,1,1) = {"
v
v
v
v
v
v
v
v
v
v
v
v
v
v
v
v
v
v
v
v
v
v
v
v
v
v
v
v
v
v
v
v
v
v
v
v
v
v
v
v
v
v
v
v
v
v
v
v
v
v
v
v
v
v
v
v
v
v
v
v
v
v
v
v
v
v
a
"}
(64,1,1) = {"
v
v
v
v
v
v
v
v
v
v
v
v
v
v
v
v
v
v
v
v
v
v
v
v
v
v
v
v
v
v
v
v
v
v
v
v
v
v
v
v
v
v
v
v
v
v
v
v
v
v
v
v
v
v
v
v
v
v
v
v
v
v
v
v
v
v
a
"}
(65,1,1) = {"
v
v
v
v
v
v
v
v
v
v
v
v
v
v
v
v
v
v
v
v
v
v
v
v
v
v
v
v
v
v
v
v
v
v
v
v
v
v
v
v
v
v
v
v
v
v
v
v
v
v
v
v
v
v
v
v
v
v
v
v
v
v
v
v
v
v
a
"}
(66,1,1) = {"
v
v
v
v
v
v
v
v
v
v
v
v
v
v
v
v
v
v
v
v
v
v
v
v
v
v
v
v
v
v
v
v
v
v
v
v
v
v
v
v
v
v
v
v
v
v
v
v
v
v
v
v
v
v
v
v
v
v
v
v
v
v
v
v
v
v
a
"}
(67,1,1) = {"
v
v
v
v
v
v
v
v
v
v
v
v
v
v
v
v
v
v
v
v
v
v
v
v
v
v
v
v
v
v
v
v
v
v
v
v
v
v
v
v
v
v
v
v
v
v
v
v
v
v
v
v
v
v
v
v
v
v
v
v
v
v
v
v
v
v
a
"}
(68,1,1) = {"
v
v
v
v
v
v
v
v
v
v
v
v
v
v
v
v
v
v
v
v
v
v
v
v
v
v
v
v
v
v
v
v
v
v
v
v
v
v
v
v
v
v
v
v
v
v
v
v
v
v
v
v
v
v
v
v
v
v
v
v
v
v
v
v
v
v
a
"}
(69,1,1) = {"
v
v
v
v
v
v
v
v
v
v
v
v
v
v
v
v
v
v
v
v
v
v
v
v
v
v
v
v
v
v
v
v
v
v
v
v
v
v
v
v
v
v
v
v
v
v
v
v
v
v
v
v
v
v
v
v
v
v
v
v
v
v
v
v
v
v
a
"}
(70,1,1) = {"
v
v
v
v
v
v
v
v
v
v
v
v
v
v
v
v
v
v
v
v
v
v
v
v
v
v
v
v
v
v
v
v
v
v
v
v
v
v
v
v
v
v
v
v
v
v
v
v
v
v
v
v
v
v
v
v
v
v
v
v
v
v
v
v
v
v
a
"}
(71,1,1) = {"
v
v
v
v
v
v
v
v
v
v
v
v
v
v
v
v
v
v
v
v
v
v
v
v
v
v
v
v
v
v
v
v
v
v
v
v
v
v
v
v
v
v
v
v
v
v
v
v
v
v
v
v
v
v
v
v
v
v
v
v
v
v
v
v
v
v
a
"}
