//MAP CONVERTED BY dmm2tgm.py THIS HEADER COMMENT PREVENTS RECONVERSION, DO NOT REMOVE
"as" = (
/obj/machinery/atmospherics/pipe/simple/green/hidden,
/obj/structure/cable,
/obj/effect/ai_node,
/turf/open/floor/marking/asteroidwarning{
	dir = 4
	},
/area/bigredv3/outside/directions/nw)
"aW" = (
/obj/machinery/light{
	dir = 1
	},
/turf/open/floor/plating/ground/mars/random/dirt,
/area/bigredv3/outside/medical/virology)
"bE" = (
/obj/effect/decal/cleanable/dirt,
/obj/effect/ai_node,
/turf/open/floor/marking/asteroidwarning{
	dir = 8
	},
/area/bigredv3/outside/directions/nw)
"bI" = (
/obj/structure/cable,
/obj/machinery/atmospherics/pipe/simple/green/hidden,
/obj/effect/ai_node,
/turf/open/floor/marking/asteroidwarning{
	dir = 4
	},
/area/bigredv3/outside/directions/nw)
"bT" = (
/obj/effect/ai_node,
/turf/open/floor/plating/ground/mars/random/sand,
/area/bigredv3/outside/directions/nw)
"ci" = (
/obj/structure/cargo_container/horizontal{
	dir = 4
	},
/turf/open/floor/plating,
/area/bigredv3/outside/directions/nw)
"cn" = (
/turf/closed/mineral/smooth/bigred/indestructible,
/area/space)
"ds" = (
/obj/effect/ai_node,
/turf/open/floor/marking/asteroidwarning{
	dir = 8
	},
/area/bigredv3/outside/directions/nw)
"dt" = (
/obj/machinery/atmospherics/pipe/simple/green/hidden{
	dir = 4
	},
/obj/structure/cable,
/turf/open/floor/marking/asteroidwarning{
	dir = 1
	},
/area/bigredv3/outside/directions/nw)
"dW" = (
/turf/open/floor/marking/asteroidwarning{
	dir = 8
	},
/area/bigredv3/outside/directions/nw)
"ev" = (
/turf/open/floor/marking/asteroidwarning{
	dir = 4
	},
/area/bigredv3/outside/directions/nw)
"fs" = (
/obj/effect/ai_node,
/turf/open/floor/marking/asteroidwarning{
	dir = 9
	},
/area/bigredv3/outside/directions/nw)
"fH" = (
/obj/effect/ai_node,
/turf/open/floor/plating/ground/mars/random/cave/rock,
/area/bigredv3/caves/west)
"fO" = (
/obj/machinery/light{
	dir = 1
	},
/turf/open/floor/plating/ground/mars/random/sand,
/area/bigredv3/outside/medical/virology)
"fY" = (
/obj/effect/decal/cleanable/dirt,
/turf/open/floor/asteroidfloor,
/area/bigredv3/outside/directions/nw)
"gc" = (
/turf/open/floor/plating/ground/mars/dirttosand/autosmooth{
	dir = 5
	},
/area/bigredv3/outside/directions/nw)
"gG" = (
/obj/effect/decal/cleanable/dirt,
/obj/effect/ai_node,
/turf/open/floor/marking/asteroidwarning{
	dir = 9
	},
/area/bigredv3/outside/directions/nw)
"gL" = (
/turf/open/floor/plating/ground/mars/cavetodirt{
	dir = 6
	},
/area/bigredv3/caves/west)
"hm" = (
/turf/open/floor/marking/asteroidwarning,
/area/bigredv3/outside/directions/nw)
"hG" = (
/turf/open/floor/plating/ground/mars/random/sand,
/area/bigredv3/caves/northwest)
"hH" = (
/turf/open/floor/plating/ground/mars/dirttosand/autosmooth{
	dir = 4
	},
/area/bigredv3/outside/directions/nw)
"io" = (
/turf/open/floor/plating/ground/mars/random/dirt,
/area/bigredv3/caves/west)
"iz" = (
/obj/structure/cable,
/obj/machinery/atmospherics/pipe/simple/green/hidden{
	dir = 6
	},
/turf/open/floor/marking/asteroidwarning{
	dir = 4
	},
/area/bigredv3/outside/directions/nw)
"iY" = (
/turf/open/floor/marking/asteroidwarning{
	dir = 9
	},
/area/bigredv3/outside/medical/virology)
"jE" = (
/turf/open/floor/plating,
/area/bigredv3/outside/directions/nw)
"jR" = (
/obj/machinery/light{
	dir = 1
	},
/obj/structure/largecrate/random/case/small,
/turf/open/floor/plating,
/area/bigredv3/outside/directions/nw)
"kd" = (
/turf/closed/wall/r_wall,
/area/bigredv3/inside/wall)
"ku" = (
/turf/open/floor/marking/asteroidwarning{
	dir = 1
	},
/area/bigredv3/outside/medical/virology)
"kA" = (
/obj/structure/rack,
/turf/open/floor/plating,
/area/bigredv3/outside/directions/nw)
"lp" = (
/turf/closed/mineral/smooth/bigred,
/area/bigredv3/caves/rock)
"lw" = (
/obj/machinery/atmospherics/pipe/simple/green/hidden,
/obj/structure/cable,
/obj/effect/ai_node,
/turf/open/floor/marking/asteroidwarning{
	dir = 1
	},
/area/bigredv3/outside/directions/nw)
"mO" = (
/obj/effect/turf_decal/sandedge,
/turf/open/floor/plating/ground/mars/random/sand,
/area/bigredv3/caves/northwest)
"nq" = (
/obj/effect/spawner/random/engineering/structure/tank/fuelweighted,
/turf/open/floor/plating,
/area/bigredv3/outside/directions/nw)
"pJ" = (
/turf/open/floor/marking/asteroidwarning{
	dir = 1
	},
/area/bigredv3/outside/directions/nw)
"pN" = (
/obj/effect/ai_node,
/turf/open/floor/marking/asteroidwarning{
	dir = 1
	},
/area/bigredv3/outside/medical/virology)
"qh" = (
/turf/open/floor/plating/ground/mars/dirttosand/autosmooth,
/area/bigredv3/outside/directions/nw)
"qD" = (
/obj/structure/cable,
/turf/open/floor/plating,
/area/bigredv3/outside/directions/nw)
"rY" = (
/obj/machinery/atmospherics/pipe/simple/green/hidden,
/obj/structure/cable,
/turf/open/floor/marking/asteroidwarning{
	dir = 4
	},
/area/bigredv3/outside/directions/nw)
"sj" = (
/obj/effect/decal/cleanable/dirt,
/turf/open/floor/marking/asteroidwarning{
	dir = 4
	},
/area/bigredv3/outside/directions/nw)
"sn" = (
/obj/effect/decal/cleanable/dirt,
/turf/open/floor/marking/asteroidwarning{
	dir = 10
	},
/area/bigredv3/outside/directions/nw)
"tz" = (
/turf/open/floor/plating/ground/mars/random/dirt,
/area/bigredv3/outside/directions/nw)
"um" = (
/obj/effect/decal/cleanable/dirt,
/obj/structure/cable,
/obj/machinery/atmospherics/pipe/simple/green/hidden{
	dir = 5
	},
/turf/open/floor/asteroidfloor,
/area/bigredv3/outside/directions/nw)
"uI" = (
/obj/effect/ai_node,
/turf/open/floor/plating/ground/mars/random/cave,
/area/bigredv3/caves/northwest)
"uU" = (
/obj/effect/ai_node,
/turf/open/floor/plating/ground/mars/random/cave,
/area/bigredv3/caves/west)
"xt" = (
/turf/open/floor/plating/ground/mars/dirttosand/autosmooth{
	dir = 1
	},
/area/bigredv3/outside/directions/nw)
"xJ" = (
/turf/open/floor/marking/asteroidwarning{
	dir = 5
	},
/area/bigredv3/outside/directions/nw)
"yt" = (
/obj/machinery/atmospherics/pipe/simple/green/hidden{
	dir = 10
	},
/obj/structure/cable,
/turf/open/floor/marking/asteroidwarning{
	dir = 5
	},
/area/bigredv3/outside/directions/nw)
"yu" = (
/obj/machinery/light{
	dir = 8
	},
/turf/open/floor/marking/asteroidwarning{
	dir = 1
	},
/area/bigredv3/outside/directions/nw)
"yz" = (
/turf/open/floor/plating/ground/mars/random/cave/rock,
/area/bigredv3/caves/northwest)
"zc" = (
/turf/closed/wall,
/area/bigredv3/inside/wall)
"zS" = (
/obj/structure/cable,
/obj/machinery/power/apc/weak/ntf,
/turf/open/floor/plating,
/area/bigredv3/outside/directions/nw)
"Ad" = (
/obj/effect/ai_node,
/turf/open/floor/asteroidfloor,
/area/bigredv3/outside/directions/nw)
"An" = (
/turf/open/floor/plating/warning{
	dir = 1
	},
/area/bigredv3/outside/directions/nw)
"Av" = (
/obj/machinery/light,
/obj/effect/spawner/random/engineering/structure/tank/fuelweighted,
/turf/open/floor/plating,
/area/bigredv3/outside/directions/nw)
"AE" = (
/obj/effect/decal/cleanable/dirt,
/turf/open/floor/marking/asteroidwarning,
/area/bigredv3/outside/directions/nw)
"AY" = (
/turf/open/floor/plating/warning{
	dir = 8
	},
/area/bigredv3/outside/directions/nw)
"By" = (
/obj/machinery/atmospherics/pipe/simple/green/hidden,
/obj/structure/cable,
/turf/open/floor/plating/warning{
	dir = 1
	},
/area/bigredv3/outside/directions/nw)
"Dx" = (
/turf/open/floor/plating/ground/mars/dirttosand/autosmooth{
	dir = 8
	},
/area/bigredv3/outside/directions/nw)
"DU" = (
/obj/machinery/atmospherics/pipe/manifold/green/hidden,
/obj/structure/cable,
/obj/effect/ai_node,
/turf/open/floor/plating,
/area/bigredv3/outside/directions/nw)
"Ef" = (
/obj/machinery/light{
	dir = 1
	},
/turf/open/floor/plating,
/area/bigredv3/outside/directions/nw)
"El" = (
/obj/structure/cargo_container/horizontal,
/turf/open/floor/plating,
/area/bigredv3/outside/directions/nw)
"Eq" = (
/turf/open/floor/plating/ground/mars/dirttosand/autosmooth{
	dir = 6
	},
/area/bigredv3/outside/directions/nw)
"EB" = (
/obj/effect/decal/cleanable/dirt,
/turf/open/floor/marking/asteroidwarning{
	dir = 6
	},
/area/bigredv3/outside/directions/nw)
"EO" = (
/turf/open/floor/plating/ground/mars/dirttosand/autosmooth{
	dir = 10
	},
/area/bigredv3/outside/directions/nw)
"Gl" = (
/turf/open/floor/plating/ground/mars/random/sand,
/area/bigredv3/outside/medical/virology)
"GK" = (
/obj/machinery/atmospherics/pipe/simple/green/hidden{
	dir = 4
	},
/obj/structure/cable,
/turf/open/floor/plating,
/area/bigredv3/outside/directions/nw)
"GM" = (
/obj/effect/decal/cleanable/dirt,
/turf/open/floor/marking/asteroidwarning{
	dir = 8
	},
/area/bigredv3/outside/directions/nw)
"Ha" = (
/turf/open/floor/marking/asteroidwarning{
	dir = 9
	},
/area/bigredv3/outside/directions/nw)
"HJ" = (
/obj/effect/ai_node,
/turf/open/floor/plating/ground/mars/random/dirt,
/area/bigredv3/outside/medical/virology)
"HX" = (
/obj/effect/ai_node,
/turf/open/floor/plating/ground/mars/random/cave/rock,
/area/bigredv3/caves/northwest)
"Ia" = (
/obj/effect/ai_node,
/turf/open/floor/plating/ground/mars/random/dirt,
/area/bigredv3/outside/directions/nw)
"IB" = (
/obj/structure/cable,
/obj/machinery/atmospherics/pipe/simple/green/hidden,
/turf/open/floor/marking/asteroidwarning{
	dir = 4
	},
/area/bigredv3/outside/directions/nw)
"Jf" = (
/turf/open/floor/plating/ground/mars/random/cave,
/area/bigredv3/caves/northwest)
"JJ" = (
/obj/machinery/atmospherics/pipe/simple/green/hidden{
	dir = 4
	},
/obj/structure/cable,
/obj/effect/ai_node,
/turf/open/floor/plating,
/area/bigredv3/outside/directions/nw)
"JZ" = (
/obj/machinery/light{
	dir = 8
	},
/turf/open/floor/plating,
/area/bigredv3/outside/directions/nw)
"Kf" = (
/turf/open/floor/asteroidfloor,
/area/bigredv3/outside/directions/nw)
"KS" = (
/obj/machinery/light,
/turf/open/floor/plating,
/area/bigredv3/outside/directions/nw)
"Li" = (
/obj/machinery/light{
	dir = 4
	},
/turf/open/floor/plating,
/area/bigredv3/outside/directions/nw)
"LY" = (
/obj/machinery/atmospherics/pipe/simple/green/hidden{
	dir = 4
	},
/obj/machinery/door/airlock/multi_tile/mainship/medidoor{
	dir = 1;
	name = "\improper Medical Clinic"
	},
/obj/structure/cable,
/turf/open/floor/tile/white,
/area/bigredv3/inside/medical/central)
"MD" = (
/turf/open/floor/plating/ground/mars/random/dirt,
/area/bigredv3/outside/medical/virology)
"MW" = (
/turf/open/floor/asteroidfloor,
/area/bigredv3/outside/medical/virology)
"Nf" = (
/obj/machinery/atmospherics/pipe/simple/green/hidden{
	dir = 4
	},
/obj/structure/cable,
/turf/open/floor/tile/white,
/area/bigredv3/inside/medical/central)
"Of" = (
/obj/effect/turf_decal/sandedge/corner2,
/turf/open/floor/plating/ground/mars/random/sand,
/area/bigredv3/caves/northwest)
"Os" = (
/turf/open/floor/plating/ground/mars/random/sand,
/area/bigredv3/outside/directions/nw)
"Ov" = (
/obj/effect/decal/cleanable/blood,
/turf/open/floor/plating/ground/mars/random/sand,
/area/bigredv3/outside/directions/nw)
"PI" = (
/obj/structure/fence/standard/xenoproof,
/turf/open/floor/plating/ground/mars/cavetodirt{
	dir = 4
	},
/area/bigredv3/caves/west)
"Qu" = (
/turf/open/floor/plating/ground/mars/random/cave,
/area/bigredv3/caves/west)
"Rk" = (
/turf/open/floor/tile/white,
/area/bigredv3/inside/medical/central)
"RD" = (
/turf/open/floor/plating/ground/mars/dirttosand/autosmooth{
	dir = 9
	},
/area/bigredv3/outside/medical/virology)
"RJ" = (
/obj/structure/cable,
/obj/machinery/atmospherics/pipe/simple/green/hidden{
	dir = 4
	},
/turf/open/floor/marking/asteroidwarning{
	dir = 1
	},
/area/bigredv3/outside/directions/nw)
"Sk" = (
/turf/open/floor/plating/ground/mars/random/cave/rock,
/area/bigredv3/caves/west)
"SQ" = (
/turf/open/floor/marking/asteroidwarning{
	dir = 8
	},
/area/bigredv3/outside/medical/virology)
"SR" = (
/obj/machinery/floodlight/outpost/bigred,
/turf/open/floor/plating/ground/mars/random/sand,
/area/bigredv3/outside/directions/nw)
"Td" = (
/obj/machinery/light{
	dir = 4
	},
/turf/open/floor/marking/asteroidwarning{
	dir = 1
	},
/area/bigredv3/outside/medical/virology)
"TI" = (
/obj/structure/cargo_container/horizontal{
	dir = 1
	},
/turf/open/floor/plating,
/area/bigredv3/outside/directions/nw)
"Wd" = (
/obj/structure/largecrate/random/case/double,
/turf/open/floor/plating,
/area/bigredv3/outside/directions/nw)
"Wl" = (
/obj/machinery/atmospherics/pipe/simple/green/hidden{
	dir = 4
	},
/obj/structure/cable,
/turf/open/floor/asteroidfloor,
/area/bigredv3/outside/directions/nw)
"XC" = (
/obj/machinery/atmospherics/pipe/simple/green/hidden{
	dir = 4
	},
/obj/structure/cable,
/turf/open/floor/plating/warning{
	dir = 8
	},
/area/bigredv3/outside/directions/nw)
"XJ" = (
/turf/open/floor/plating/ground/mars/dirttosand/autosmooth{
	dir = 5
	},
/area/bigredv3/outside/medical/virology)
"XW" = (
/turf/open/floor/plating/ground/mars/dirttosand/autosmooth{
	dir = 9
	},
/area/bigredv3/outside/directions/nw)
"Yy" = (
/obj/machinery/atmospherics/pipe/simple/green/hidden,
/obj/structure/cable,
/turf/open/floor/plating,
/area/bigredv3/outside/directions/nw)
"YW" = (
/obj/effect/decal/cleanable/dirt,
/turf/open/floor/marking/asteroidwarning{
	dir = 1
	},
/area/bigredv3/outside/directions/nw)
"ZP" = (
/obj/structure/fence/standard/xenoproof,
/turf/open/floor/plating/ground/mars/random/cave,
/area/bigredv3/caves/west)
"ZZ" = (
/obj/effect/ai_node,
/turf/open/floor/marking/asteroidwarning{
	dir = 4
	},
/area/bigredv3/outside/directions/nw)

(1,1,1) = {"
cn
cn
cn
cn
cn
cn
cn
cn
cn
cn
cn
cn
cn
cn
cn
cn
cn
cn
cn
cn
cn
cn
"}
(2,1,1) = {"
lp
lp
lp
lp
lp
lp
lp
lp
lp
lp
lp
lp
lp
lp
lp
lp
lp
lp
lp
lp
lp
lp
"}
(3,1,1) = {"
lp
lp
lp
lp
lp
lp
lp
lp
lp
lp
lp
lp
lp
lp
lp
lp
yz
Sk
Sk
Sk
lp
lp
"}
(4,1,1) = {"
lp
lp
lp
lp
lp
lp
lp
lp
lp
lp
lp
lp
lp
lp
lp
yz
Jf
Qu
Qu
uU
Sk
lp
"}
(5,1,1) = {"
lp
lp
lp
lp
lp
lp
lp
lp
lp
lp
lp
lp
lp
lp
HX
Jf
Jf
Qu
Qu
Qu
uU
Sk
"}
(6,1,1) = {"
lp
lp
lp
lp
lp
lp
lp
lp
lp
lp
lp
lp
lp
lp
Jf
Jf
Jf
Qu
Qu
Qu
Qu
Qu
"}
(7,1,1) = {"
lp
lp
lp
lp
lp
lp
lp
lp
lp
lp
lp
lp
lp
yz
Jf
Jf
Jf
Qu
Qu
Qu
Sk
Qu
"}
(8,1,1) = {"
lp
lp
lp
lp
lp
lp
lp
lp
Jf
Jf
Jf
Jf
Jf
Jf
Jf
Jf
Jf
Qu
Qu
Qu
Sk
uU
"}
(9,1,1) = {"
lp
uI
Jf
uI
Jf
Jf
Jf
Jf
uI
Jf
Jf
Jf
Jf
Jf
uI
Jf
Jf
Qu
Qu
Qu
fH
Qu
"}
(10,1,1) = {"
uI
Jf
Jf
Jf
Jf
Jf
Jf
Jf
Jf
Jf
Jf
Jf
yz
Jf
Jf
Jf
Jf
Qu
Qu
Qu
Sk
Qu
"}
(11,1,1) = {"
Jf
Jf
Jf
Jf
Jf
yz
Jf
Jf
Jf
Jf
Jf
Jf
Jf
Jf
Jf
Jf
Jf
Qu
Qu
Qu
Sk
lp
"}
(12,1,1) = {"
uI
Jf
yz
HX
Jf
Jf
Jf
Jf
uI
Jf
Jf
Jf
Jf
Jf
uI
Jf
Jf
Qu
Qu
Qu
fH
lp
"}
(13,1,1) = {"
yz
Jf
Jf
Jf
Jf
Jf
Jf
Jf
Jf
Jf
Jf
yz
Jf
Jf
Jf
Jf
Jf
Qu
Qu
Qu
Qu
fH
"}
(14,1,1) = {"
Jf
Jf
Jf
Jf
Jf
Jf
lp
lp
lp
lp
lp
lp
lp
lp
lp
lp
lp
Qu
Qu
Qu
Qu
Sk
"}
(15,1,1) = {"
uI
Jf
Jf
Jf
Jf
lp
lp
lp
lp
lp
lp
lp
lp
lp
lp
lp
lp
Qu
lp
lp
ZP
PI
"}
(16,1,1) = {"
Jf
Jf
Jf
lp
lp
lp
lp
lp
lp
lp
lp
lp
lp
lp
lp
lp
lp
lp
lp
lp
gL
io
"}
(17,1,1) = {"
Jf
Jf
lp
lp
lp
lp
lp
lp
lp
lp
lp
lp
lp
lp
lp
lp
lp
lp
kd
kd
kd
kd
"}
(18,1,1) = {"
lp
lp
lp
lp
lp
lp
lp
lp
lp
lp
lp
lp
lp
lp
lp
lp
lp
lp
kd
MD
MD
HJ
"}
(19,1,1) = {"
lp
lp
lp
lp
lp
lp
lp
lp
lp
lp
lp
lp
lp
lp
lp
lp
lp
lp
kd
MD
MD
MD
"}
(20,1,1) = {"
lp
lp
lp
lp
lp
lp
lp
lp
lp
lp
lp
lp
lp
lp
lp
lp
lp
lp
kd
MD
MD
iY
"}
(21,1,1) = {"
lp
lp
lp
lp
lp
lp
lp
lp
lp
lp
lp
lp
lp
lp
lp
lp
lp
lp
kd
XJ
MD
pN
"}
(22,1,1) = {"
lp
lp
lp
lp
lp
lp
lp
lp
lp
lp
lp
lp
lp
lp
lp
lp
lp
Os
kd
Gl
XJ
ku
"}
(23,1,1) = {"
lp
lp
lp
lp
lp
lp
lp
lp
lp
lp
lp
lp
lp
lp
lp
lp
lp
Os
kd
fO
Gl
ku
"}
(24,1,1) = {"
lp
lp
lp
lp
lp
lp
lp
lp
lp
lp
lp
lp
lp
Os
Os
Os
Os
Os
kd
Gl
RD
ku
"}
(25,1,1) = {"
lp
lp
lp
lp
lp
lp
lp
lp
lp
bT
Os
Os
Os
Os
Os
bT
Os
Os
kd
RD
MD
pN
"}
(26,1,1) = {"
lp
lp
lp
lp
lp
lp
lp
lp
lp
Os
Os
XW
Dx
EO
Os
Os
Os
Os
kd
MD
MD
ku
"}
(27,1,1) = {"
lp
lp
lp
lp
lp
lp
lp
lp
lp
Os
Os
xt
tz
qh
Os
Os
Os
Os
kd
MD
MD
ku
"}
(28,1,1) = {"
mO
hG
lp
lp
lp
Os
Os
Os
Os
Os
Os
gc
hH
Eq
Os
Os
Os
Os
kd
MD
MD
ku
"}
(29,1,1) = {"
mO
hG
hG
bT
Os
Os
Os
Os
Os
bT
Os
Os
Os
Os
Os
bT
Os
Os
kd
aW
MD
pN
"}
(30,1,1) = {"
mO
hG
Os
SR
Os
Os
XW
EO
Os
SR
Os
Os
Os
Os
Os
SR
Os
Os
kd
MD
MD
ku
"}
(31,1,1) = {"
Of
Os
Os
Os
Os
XW
tz
tz
Dx
EO
Os
Os
Os
XW
Dx
EO
Os
Os
kd
MD
iY
SQ
"}
(32,1,1) = {"
Os
Os
XW
Dx
Dx
tz
tz
tz
tz
tz
Dx
Dx
Dx
tz
tz
tz
Dx
Dx
kd
MD
Td
MW
"}
(33,1,1) = {"
Os
XW
tz
gG
GM
GM
dW
GM
GM
dW
ds
dW
dW
dW
GM
dW
GM
sn
kd
kd
kd
MW
"}
(34,1,1) = {"
Os
xt
fs
fY
fY
fY
sj
ev
sj
ZZ
iz
IB
IB
IB
IB
bI
IB
um
sn
tz
yu
Ad
"}
(35,1,1) = {"
XW
Ha
Kf
Kf
Kf
EB
tz
tz
pJ
Kf
Wl
Kf
hm
tz
tz
tz
Ia
dt
AE
tz
xJ
ev
"}
(36,1,1) = {"
xt
pJ
fY
fY
EB
tz
tz
tz
pJ
fY
Wl
fY
hm
tz
tz
tz
tz
RJ
AE
tz
tz
pJ
"}
(37,1,1) = {"
xt
YW
Kf
AE
tz
hH
kd
kd
kd
AY
XC
AY
kd
kd
kd
kd
tz
dt
AE
tz
tz
pJ
"}
(38,1,1) = {"
xt
pJ
Kf
AE
qh
Os
kd
nq
jE
jE
GK
jE
JZ
jE
jE
kd
tz
dt
hm
tz
tz
pJ
"}
(39,1,1) = {"
xt
pJ
Kf
hm
qh
Os
kd
jR
jE
jE
GK
jE
TI
ci
El
kd
tz
dt
Kf
GM
GM
Kf
"}
(40,1,1) = {"
bE
Kf
Ad
AE
qh
Os
kd
jE
jE
jE
GK
jE
jE
jE
jE
kd
Ia
yt
rY
rY
rY
bI
"}
(41,1,1) = {"
fY
Kf
fY
hm
qh
Os
kd
jE
jE
jE
JJ
jE
TI
ci
El
kd
hH
hH
hH
hH
tz
tz
"}
(42,1,1) = {"
ev
ev
sj
EB
qh
Os
kd
jE
jE
jE
GK
jE
jE
jE
jE
kd
Os
Os
Os
Os
gc
hH
"}
(43,1,1) = {"
tz
tz
tz
tz
tz
Os
kd
jE
jE
jE
GK
jE
jE
jE
jE
kd
Os
SR
Os
Os
Os
Os
"}
(44,1,1) = {"
tz
tz
tz
tz
tz
Ha
kd
Ef
jE
jE
GK
jE
jE
jE
Av
kd
Os
Os
Os
Os
Os
Os
"}
(45,1,1) = {"
dW
dW
dW
dW
dW
pJ
An
jE
jE
jE
GK
jE
jE
jE
jE
kd
Os
Os
Os
Os
Os
Os
"}
(46,1,1) = {"
Kf
Kf
Ad
Kf
Kf
pJ
An
jE
jE
jE
GK
jE
jE
jE
jE
kd
bT
Os
Os
Os
Os
bT
"}
(47,1,1) = {"
rY
rY
rY
as
rY
lw
By
Yy
Yy
Yy
DU
jE
jE
jE
kA
kd
Os
Os
Os
Os
Os
Os
"}
(48,1,1) = {"
hH
hH
tz
tz
tz
xJ
kd
Wd
jE
jE
GK
jE
jE
jE
jE
kd
Os
Os
Os
Os
Os
Os
"}
(49,1,1) = {"
Os
Os
gc
hH
hH
hH
kd
jR
jE
jE
GK
jE
jE
jE
KS
kd
Os
SR
Os
Os
Os
Os
"}
(50,1,1) = {"
Os
Os
SR
Os
Os
Os
kd
Wd
jE
jE
GK
jE
TI
ci
El
kd
Os
Os
Os
Os
Os
Os
"}
(51,1,1) = {"
Os
Os
Os
Os
Os
Os
kd
zS
qD
qD
GK
jE
jE
jE
jE
kd
bT
Os
Os
Os
Os
bT
"}
(52,1,1) = {"
Os
Os
bT
Os
Os
bT
kd
jE
Li
jE
JJ
jE
jE
jE
jE
kd
Os
Os
Os
Os
Os
Ov
"}
(53,1,1) = {"
Os
Os
Os
Os
bT
Os
kd
kd
kd
Rk
LY
kd
kd
kd
kd
kd
Os
Os
Os
Os
Os
Os
"}
(54,1,1) = {"
Os
Os
Os
Os
Os
Os
Os
Os
zc
Rk
Nf
zc
bT
Os
Os
Os
bT
Os
Os
Os
Os
bT
"}
