//MAP CONVERTED BY dmm2tgm.py THIS HEADER COMMENT PREVENTS RECONVERSION, DO NOT REMOVE
"aq" = (
/turf/open/floor/plating/ground/mars/dirttosand/autosmooth{
	dir = 4
	},
/area/bigredv3/outside/directions/nw)
"bb" = (
/obj/structure/cable,
/obj/machinery/atmospherics/pipe/simple/green/hidden{
	dir = 6
	},
/turf/open/floor/marking/asteroidwarning{
	dir = 4
	},
/area/bigredv3/outside/directions/nw)
"bF" = (
/turf/open/floor/plating/warning{
	dir = 8
	},
/area/bigredv3/outside/directions/nw)
"bG" = (
/turf/open/floor/marking/asteroidwarning{
	dir = 4
	},
/area/bigredv3/outside/directions/nw)
"bK" = (
/obj/machinery/light{
	dir = 8
	},
/turf/open/floor/plating,
/area/bigredv3/outside/directions/nw)
"bM" = (
/turf/open/floor/plating/ground/mars/cavetodirt{
	dir = 6
	},
/area/bigredv3/caves/west)
"fb" = (
/obj/structure/cable,
/obj/machinery/atmospherics/pipe/simple/green/hidden{
	dir = 4
	},
/turf/open/floor/plating/warning{
	dir = 8
	},
/area/bigredv3/outside/directions/nw)
"fk" = (
/obj/effect/turf_decal/sandedge,
/turf/open/floor/plating/ground/mars/random/sand,
/area/bigredv3/caves/northwest)
"fz" = (
/obj/effect/decal/cleanable/dirt,
/turf/open/floor/marking/asteroidwarning{
	dir = 10
	},
/area/bigredv3/outside/directions/nw)
"fG" = (
/obj/machinery/light{
	dir = 8
	},
/turf/open/floor/asteroidfloor,
/area/bigredv3/outside/directions/nw)
"fM" = (
/obj/machinery/light{
	dir = 8
	},
/turf/open/floor/marking/asteroidwarning{
	dir = 1
	},
/area/bigredv3/outside/directions/nw)
"gN" = (
/turf/open/floor/tile/white,
/area/bigredv3/outside/directions/nw)
"gV" = (
/obj/effect/ai_node,
/turf/open/floor/plating/ground/mars/random/cave/rock,
/area/bigredv3/caves/west)
"hV" = (
/turf/open/floor/plating/ground/mars/random/sand,
/area/bigredv3/caves/northwest)
"hX" = (
/obj/structure/cable,
/obj/machinery/atmospherics/pipe/simple/green/hidden{
	dir = 4
	},
/turf/open/floor/plating,
/area/bigredv3/outside/directions/nw)
"iu" = (
/turf/closed/wall/r_wall,
/area/bigredv3/inside/wall)
"iv" = (
/obj/machinery/atmospherics/pipe/simple/green/hidden,
/obj/structure/cable,
/turf/open/floor/plating,
/area/bigredv3/outside/directions/nw)
"jH" = (
/turf/closed/mineral/smooth/bigred,
/area/bigredv3/caves/rock)
"jQ" = (
/turf/open/floor/marking/asteroidwarning{
	dir = 9
	},
/area/bigredv3/outside/directions/nw)
"ki" = (
/turf/open/floor/plating/ground/mars/random/dirt,
/area/bigredv3/outside/medical/virology)
"kv" = (
/obj/structure/cargo_container/horizontal{
	dir = 4
	},
/turf/open/floor/plating,
/area/bigredv3/outside/directions/nw)
"mn" = (
/obj/machinery/atmospherics/pipe/manifold/green/hidden,
/obj/structure/cable,
/turf/open/floor/plating,
/area/bigredv3/outside/directions/nw)
"mQ" = (
/turf/open/floor/marking/asteroidwarning{
	dir = 5
	},
/area/bigredv3/outside/directions/nw)
"oO" = (
/turf/open/floor/plating/ground/mars/random/dirt,
/area/bigredv3/outside/directions/nw)
"pv" = (
/obj/effect/decal/cleanable/dirt,
/turf/open/floor/marking/asteroidwarning{
	dir = 8
	},
/area/bigredv3/outside/directions/nw)
"pB" = (
/turf/open/floor/plating/ground/mars/dirttosand/autosmooth{
	dir = 9
	},
/area/bigredv3/outside/medical/virology)
"pU" = (
/turf/open/floor/plating/ground/mars/dirttosand/autosmooth{
	dir = 8
	},
/area/bigredv3/outside/directions/nw)
"qz" = (
/obj/machinery/light{
	dir = 4
	},
/turf/open/floor/marking/asteroidwarning{
	dir = 1
	},
/area/bigredv3/outside/medical/virology)
"rH" = (
/obj/effect/ai_node,
/turf/open/floor/plating/ground/mars/random/sand,
/area/bigredv3/outside/directions/nw)
"si" = (
/obj/effect/ai_node,
/turf/open/floor/plating/warning{
	dir = 1
	},
/area/bigredv3/outside/directions/nw)
"sz" = (
/obj/machinery/atmospherics/pipe/simple/green/hidden{
	dir = 4
	},
/obj/structure/cable,
/turf/open/floor/plating,
/area/bigredv3/outside/directions/nw)
"tk" = (
/obj/effect/decal/cleanable/dirt,
/obj/effect/ai_node,
/turf/open/floor/marking/asteroidwarning{
	dir = 8
	},
/area/bigredv3/outside/directions/nw)
"to" = (
/turf/open/floor/plating/ground/mars/dirttosand/autosmooth{
	dir = 10
	},
/area/bigredv3/outside/directions/nw)
"tW" = (
/obj/effect/decal/cleanable/blood,
/turf/open/floor/plating/ground/mars/random/sand,
/area/bigredv3/outside/directions/nw)
"ul" = (
/obj/effect/ai_node,
/turf/open/floor/marking/asteroidwarning{
	dir = 9
	},
/area/bigredv3/outside/directions/nw)
"up" = (
/obj/structure/fence/standard/xenoproof,
/turf/open/floor/plating/ground/mars/random/cave,
/area/bigredv3/caves/west)
"vY" = (
/turf/open/floor/plating/ground/mars/random/sand,
/area/bigredv3/outside/directions/nw)
"xB" = (
/obj/machinery/power/apc/weak/ntf,
/obj/structure/cable,
/turf/open/floor/plating,
/area/bigredv3/outside/directions/nw)
"xM" = (
/turf/open/floor/plating/ground/mars/random/sand,
/area/bigredv3/outside/medical/virology)
"zb" = (
/turf/open/floor/asteroidfloor,
/area/bigredv3/outside/medical/virology)
"zJ" = (
/obj/effect/ai_node,
/turf/open/floor/plating,
/area/bigredv3/outside/directions/nw)
"AD" = (
/obj/structure/cable,
/turf/open/floor/plating,
/area/bigredv3/outside/directions/nw)
"Bn" = (
/obj/machinery/atmospherics/pipe/simple/green/hidden,
/obj/structure/cable,
/turf/open/floor/marking/asteroidwarning{
	dir = 4
	},
/area/bigredv3/outside/directions/nw)
"BW" = (
/obj/effect/ai_node,
/turf/open/floor/plating/ground/mars/random/cave/rock,
/area/bigredv3/caves/northwest)
"Cq" = (
/turf/open/floor/plating/ground/mars/random/dirt,
/area/bigredv3/caves/west)
"Dg" = (
/obj/machinery/atmospherics/pipe/simple/green/hidden{
	dir = 10
	},
/obj/structure/cable,
/turf/open/floor/marking/asteroidwarning{
	dir = 5
	},
/area/bigredv3/outside/directions/nw)
"DB" = (
/obj/structure/cargo_container/horizontal{
	dir = 2
	},
/turf/open/floor/plating,
/area/bigredv3/outside/directions/nw)
"EL" = (
/obj/machinery/atmospherics/pipe/simple/green/hidden,
/obj/structure/cable,
/turf/open/floor/plating/warning{
	dir = 1
	},
/area/bigredv3/outside/directions/nw)
"EQ" = (
/obj/effect/ai_node,
/turf/open/floor/plating/ground/mars/random/cave,
/area/bigredv3/caves/northwest)
"EV" = (
/turf/open/floor/plating/ground/mars/dirttosand/autosmooth{
	dir = 6
	},
/area/bigredv3/outside/directions/nw)
"FN" = (
/turf/open/floor/plating/ground/mars/random/cave/rock,
/area/bigredv3/caves/northwest)
"FY" = (
/obj/effect/ai_node,
/turf/open/floor/plating/ground/mars/random/cave,
/area/bigredv3/caves/west)
"Gc" = (
/turf/open/floor/plating/ground/mars/dirttosand/autosmooth{
	dir = 9
	},
/area/bigredv3/outside/directions/nw)
"GV" = (
/obj/effect/ai_node,
/turf/open/floor/marking/asteroidwarning{
	dir = 4
	},
/area/bigredv3/outside/directions/nw)
"Hm" = (
/turf/open/floor/asteroidfloor,
/area/bigredv3/outside/directions/nw)
"Hp" = (
/obj/machinery/floodlight/outpost/bigred,
/turf/open/floor/plating/ground/mars/random/sand,
/area/bigredv3/outside/directions/nw)
"IG" = (
/obj/effect/ai_node,
/turf/open/floor/marking/asteroidwarning{
	dir = 1
	},
/area/bigredv3/outside/medical/virology)
"II" = (
/obj/machinery/light{
	dir = 4
	},
/turf/open/floor/plating,
/area/bigredv3/outside/directions/nw)
"Jf" = (
/turf/open/floor/marking/asteroidwarning{
	dir = 8
	},
/area/bigredv3/outside/medical/virology)
"Jm" = (
/obj/machinery/atmospherics/pipe/simple/green/hidden{
	dir = 4
	},
/obj/structure/cable,
/turf/open/floor/asteroidfloor,
/area/bigredv3/outside/directions/nw)
"JU" = (
/obj/machinery/light{
	dir = 1
	},
/turf/open/floor/plating,
/area/bigredv3/outside/directions/nw)
"JW" = (
/obj/structure/cable,
/obj/machinery/atmospherics/pipe/simple/green/hidden,
/turf/open/floor/marking/asteroidwarning{
	dir = 4
	},
/area/bigredv3/outside/directions/nw)
"KS" = (
/turf/open/floor/plating/ground/mars/dirttosand/autosmooth{
	dir = 1
	},
/area/bigredv3/outside/directions/nw)
"KU" = (
/obj/machinery/atmospherics/pipe/simple/green/hidden,
/obj/structure/cable,
/obj/effect/ai_node,
/turf/open/floor/marking/asteroidwarning{
	dir = 1
	},
/area/bigredv3/outside/directions/nw)
"Lc" = (
/obj/effect/decal/cleanable/dirt,
/turf/open/floor/marking/asteroidwarning,
/area/bigredv3/outside/directions/nw)
"Lf" = (
/turf/open/floor/marking/asteroidwarning{
	dir = 9
	},
/area/bigredv3/outside/medical/virology)
"Lw" = (
/obj/structure/cable,
/obj/machinery/atmospherics/pipe/simple/green/hidden{
	dir = 4
	},
/obj/effect/ai_node,
/turf/open/floor/plating,
/area/bigredv3/outside/directions/nw)
"Mz" = (
/obj/structure/cargo_container/horizontal{
	dir = 1
	},
/turf/open/floor/plating,
/area/bigredv3/outside/directions/nw)
"ME" = (
/obj/effect/ai_node,
/turf/open/floor/marking/asteroidwarning{
	dir = 8
	},
/area/bigredv3/outside/directions/nw)
"MN" = (
/obj/effect/decal/cleanable/dirt,
/obj/structure/cable,
/obj/machinery/atmospherics/pipe/simple/green/hidden{
	dir = 5
	},
/turf/open/floor/asteroidfloor,
/area/bigredv3/outside/directions/nw)
"Nu" = (
/obj/effect/decal/cleanable/dirt,
/turf/open/floor/marking/asteroidwarning{
	dir = 1
	},
/area/bigredv3/outside/directions/nw)
"NG" = (
/obj/effect/ai_node,
/turf/open/floor/asteroidfloor,
/area/bigredv3/outside/directions/nw)
"NY" = (
/turf/open/floor/plating/ground/mars/dirttosand/autosmooth{
	dir = 5
	},
/area/bigredv3/outside/directions/nw)
"OG" = (
/turf/open/floor/marking/asteroidwarning{
	dir = 8
	},
/area/bigredv3/outside/directions/nw)
"OP" = (
/turf/open/floor/plating/warning{
	dir = 1
	},
/area/bigredv3/outside/directions/nw)
"Pv" = (
/obj/effect/decal/cleanable/dirt,
/turf/open/floor/marking/asteroidwarning{
	dir = 6
	},
/area/bigredv3/outside/directions/nw)
"Px" = (
/turf/open/floor/plating,
/area/bigredv3/outside/directions/nw)
"Qk" = (
/obj/machinery/atmospherics/pipe/simple/green/hidden{
	dir = 4
	},
/obj/structure/cable,
/obj/effect/ai_node,
/turf/open/floor/plating,
/area/bigredv3/outside/directions/nw)
"Qz" = (
/turf/open/floor/marking/asteroidwarning,
/area/bigredv3/outside/directions/nw)
"QN" = (
/turf/open/floor/plating/ground/mars/dirttosand/autosmooth{
	dir = 5
	},
/area/bigredv3/outside/medical/virology)
"QO" = (
/obj/effect/turf_decal/sandedge/corner2,
/turf/open/floor/plating/ground/mars/random/sand,
/area/bigredv3/caves/northwest)
"QU" = (
/obj/machinery/atmospherics/pipe/simple/green/hidden{
	dir = 4
	},
/obj/structure/cable,
/turf/open/floor/marking/asteroidwarning{
	dir = 1
	},
/area/bigredv3/outside/directions/nw)
"Ro" = (
/obj/structure/fence/standard/xenoproof,
/turf/open/floor/plating/ground/mars/cavetodirt{
	dir = 4
	},
/area/bigredv3/caves/west)
"RC" = (
/obj/effect/decal/cleanable/dirt,
/turf/open/floor/marking/asteroidwarning{
	dir = 4
	},
/area/bigredv3/outside/directions/nw)
"RX" = (
/obj/machinery/light{
	dir = 1
	},
/turf/open/floor/plating/ground/mars/random/sand,
/area/bigredv3/outside/medical/virology)
"SO" = (
/obj/structure/cable,
/obj/machinery/atmospherics/pipe/simple/green/hidden,
/obj/effect/ai_node,
/turf/open/floor/marking/asteroidwarning{
	dir = 4
	},
/area/bigredv3/outside/directions/nw)
"TP" = (
/turf/closed/mineral/smooth/bigred/indestructible,
/area/space)
"TR" = (
/obj/effect/decal/cleanable/dirt,
/turf/open/floor/asteroidfloor,
/area/bigredv3/outside/directions/nw)
"Ur" = (
/turf/open/floor/marking/asteroidwarning{
	dir = 1
	},
/area/bigredv3/outside/directions/nw)
"Vi" = (
/obj/effect/decal/cleanable/dirt,
/obj/effect/ai_node,
/turf/open/floor/marking/asteroidwarning{
	dir = 9
	},
/area/bigredv3/outside/directions/nw)
"VV" = (
/obj/structure/cable,
/obj/machinery/atmospherics/pipe/simple/green/hidden{
	dir = 4
	},
/turf/open/floor/marking/asteroidwarning{
	dir = 1
	},
/area/bigredv3/outside/directions/nw)
"Xa" = (
/obj/machinery/light,
/turf/open/floor/plating,
/area/bigredv3/outside/directions/nw)
"Xv" = (
/turf/open/floor/marking/asteroidwarning{
	dir = 1
	},
/area/bigredv3/outside/medical/virology)
"Xz" = (
/turf/open/floor/plating/ground/mars/dirttosand/autosmooth,
/area/bigredv3/outside/directions/nw)
"XX" = (
/obj/machinery/atmospherics/pipe/simple/green/hidden{
	dir = 4
	},
/obj/structure/cable,
/obj/machinery/door/airlock/multi_tile/mainship/medidoor{
	dir = 1;
	name = "\improper Medical Clinic"
	},
/turf/open/floor/tile/white,
/area/bigredv3/outside/directions/nw)
"Yc" = (
/turf/open/floor/plating/ground/mars/random/cave/rock,
/area/bigredv3/caves/west)
"Ys" = (
/obj/machinery/light{
	dir = 1
	},
/turf/open/floor/plating/ground/mars/random/dirt,
/area/bigredv3/outside/medical/virology)
"Yu" = (
/obj/effect/ai_node,
/turf/open/floor/plating/ground/mars/random/dirt,
/area/bigredv3/outside/directions/nw)
"Yv" = (
/turf/open/floor/plating/ground/mars/random/cave,
/area/bigredv3/caves/northwest)
"Yy" = (
/turf/open/floor/plating/ground/mars/random/cave,
/area/bigredv3/caves/west)

(1,1,1) = {"
TP
TP
TP
TP
TP
TP
TP
TP
TP
TP
TP
TP
TP
TP
TP
TP
TP
TP
TP
TP
TP
TP
"}
(2,1,1) = {"
jH
jH
jH
jH
jH
jH
jH
jH
jH
jH
jH
jH
jH
jH
jH
jH
jH
jH
jH
jH
jH
jH
"}
(3,1,1) = {"
jH
jH
jH
jH
jH
jH
jH
jH
jH
jH
jH
jH
jH
jH
jH
jH
FN
Yc
Yc
Yc
jH
jH
"}
(4,1,1) = {"
jH
jH
jH
jH
jH
jH
jH
jH
jH
jH
jH
jH
jH
jH
jH
FN
Yv
Yy
Yy
FY
Yc
jH
"}
(5,1,1) = {"
jH
jH
jH
jH
jH
jH
jH
jH
jH
jH
jH
jH
jH
jH
BW
Yv
Yv
Yy
Yy
Yy
FY
Yc
"}
(6,1,1) = {"
jH
jH
jH
jH
jH
jH
jH
jH
jH
jH
jH
jH
jH
jH
Yv
Yv
Yv
Yy
Yy
Yy
Yy
Yy
"}
(7,1,1) = {"
jH
jH
jH
jH
jH
jH
jH
jH
jH
jH
jH
jH
jH
FN
Yv
Yv
Yv
Yy
Yy
Yy
Yc
Yy
"}
(8,1,1) = {"
jH
jH
jH
jH
jH
jH
jH
jH
Yv
Yv
Yv
Yv
Yv
Yv
Yv
Yv
Yv
Yy
Yy
Yy
Yc
FY
"}
(9,1,1) = {"
jH
EQ
Yv
EQ
Yv
Yv
Yv
Yv
EQ
Yv
Yv
Yv
Yv
Yv
EQ
Yv
Yv
Yy
Yy
Yy
gV
Yy
"}
(10,1,1) = {"
EQ
Yv
Yv
Yv
Yv
Yv
Yv
Yv
Yv
Yv
Yv
Yv
FN
Yv
Yv
Yv
Yv
Yy
Yy
Yy
Yc
Yy
"}
(11,1,1) = {"
Yv
Yv
Yv
Yv
Yv
FN
Yv
Yv
Yv
Yv
Yv
Yv
Yv
Yv
Yv
Yv
Yv
Yy
Yy
Yy
Yc
jH
"}
(12,1,1) = {"
EQ
Yv
FN
BW
Yv
Yv
Yv
Yv
EQ
Yv
Yv
Yv
Yv
Yv
EQ
Yv
Yv
Yy
Yy
Yy
gV
jH
"}
(13,1,1) = {"
FN
Yv
Yv
Yv
Yv
Yv
Yv
Yv
Yv
Yv
Yv
FN
Yv
Yv
Yv
Yv
Yv
Yy
Yy
Yy
Yy
gV
"}
(14,1,1) = {"
Yv
Yv
Yv
Yv
Yv
Yv
jH
jH
jH
jH
jH
jH
jH
jH
jH
jH
jH
Yy
Yy
Yy
Yy
Yc
"}
(15,1,1) = {"
EQ
Yv
Yv
Yv
Yv
jH
jH
jH
jH
jH
jH
jH
jH
jH
jH
jH
jH
Yy
jH
jH
up
Ro
"}
(16,1,1) = {"
Yv
Yv
Yv
jH
jH
jH
jH
jH
jH
jH
jH
jH
jH
jH
jH
jH
jH
jH
jH
jH
bM
Cq
"}
(17,1,1) = {"
Yv
Yv
jH
jH
jH
jH
jH
jH
jH
jH
jH
jH
jH
jH
jH
jH
jH
jH
iu
iu
iu
iu
"}
(18,1,1) = {"
jH
jH
jH
jH
jH
jH
jH
jH
jH
jH
jH
jH
jH
jH
jH
jH
jH
jH
iu
ki
ki
ki
"}
(19,1,1) = {"
jH
jH
jH
jH
jH
jH
jH
jH
jH
jH
jH
jH
jH
jH
jH
jH
jH
jH
iu
ki
ki
ki
"}
(20,1,1) = {"
jH
jH
jH
jH
jH
jH
jH
jH
jH
jH
jH
jH
jH
jH
jH
jH
jH
jH
iu
ki
ki
Lf
"}
(21,1,1) = {"
jH
jH
jH
jH
jH
jH
jH
jH
jH
jH
jH
jH
jH
jH
jH
jH
jH
jH
iu
QN
ki
IG
"}
(22,1,1) = {"
jH
jH
jH
jH
jH
jH
jH
jH
jH
jH
jH
jH
jH
jH
jH
jH
jH
vY
iu
xM
QN
Xv
"}
(23,1,1) = {"
jH
jH
jH
jH
jH
jH
jH
jH
jH
jH
jH
jH
jH
jH
jH
jH
jH
vY
iu
xM
xM
Xv
"}
(24,1,1) = {"
jH
jH
jH
jH
jH
jH
jH
jH
jH
jH
jH
jH
jH
vY
vY
vY
vY
vY
iu
RX
pB
Xv
"}
(25,1,1) = {"
jH
jH
jH
jH
jH
jH
jH
jH
jH
rH
vY
vY
vY
vY
vY
rH
vY
vY
iu
pB
ki
IG
"}
(26,1,1) = {"
jH
jH
jH
jH
jH
jH
jH
jH
jH
vY
vY
Gc
pU
to
vY
vY
vY
vY
iu
ki
ki
Xv
"}
(27,1,1) = {"
jH
jH
jH
jH
jH
jH
jH
jH
jH
vY
vY
KS
oO
Xz
vY
vY
vY
vY
iu
ki
ki
Xv
"}
(28,1,1) = {"
fk
hV
jH
jH
jH
vY
vY
vY
vY
vY
vY
NY
aq
EV
vY
vY
vY
vY
iu
ki
ki
Xv
"}
(29,1,1) = {"
fk
hV
hV
rH
vY
vY
vY
vY
vY
rH
vY
vY
vY
vY
vY
rH
vY
vY
iu
ki
ki
IG
"}
(30,1,1) = {"
fk
hV
vY
Hp
vY
vY
Gc
to
vY
Hp
vY
vY
vY
vY
vY
Hp
vY
vY
iu
Ys
ki
Xv
"}
(31,1,1) = {"
QO
vY
vY
vY
vY
Gc
oO
oO
pU
to
vY
vY
vY
Gc
pU
to
vY
vY
iu
ki
Lf
Jf
"}
(32,1,1) = {"
vY
vY
Gc
pU
pU
oO
oO
oO
oO
oO
pU
pU
pU
oO
oO
oO
pU
pU
iu
ki
qz
zb
"}
(33,1,1) = {"
vY
Gc
oO
Vi
pv
pv
OG
pv
pv
OG
ME
OG
OG
OG
pv
OG
pv
fz
iu
iu
iu
zb
"}
(34,1,1) = {"
vY
KS
ul
TR
TR
TR
RC
bG
RC
GV
bb
JW
JW
JW
JW
SO
JW
MN
fz
oO
fM
NG
"}
(35,1,1) = {"
Gc
jQ
Hm
Hm
Hm
Pv
oO
oO
Ur
Hm
Jm
Hm
Qz
oO
oO
oO
Yu
QU
Lc
oO
mQ
bG
"}
(36,1,1) = {"
KS
Ur
TR
TR
Pv
oO
oO
oO
Ur
TR
Jm
TR
Qz
oO
oO
oO
oO
VV
Lc
oO
oO
Ur
"}
(37,1,1) = {"
KS
Nu
Hm
Lc
oO
aq
iu
iu
iu
bF
fb
bF
iu
iu
iu
iu
oO
QU
Lc
oO
oO
Ur
"}
(38,1,1) = {"
KS
Ur
Hm
Lc
Xz
vY
iu
Px
bK
Px
hX
Px
bK
Px
Px
iu
oO
QU
Qz
oO
oO
Ur
"}
(39,1,1) = {"
KS
Ur
Hm
Qz
Xz
vY
iu
Px
Px
Px
hX
Px
Mz
kv
DB
iu
oO
QU
Hm
pv
pv
Hm
"}
(40,1,1) = {"
tk
Hm
NG
Lc
Xz
Hp
iu
zJ
Px
Px
Lw
Px
Px
Px
Px
iu
Yu
Dg
Bn
Bn
Bn
SO
"}
(41,1,1) = {"
TR
Hm
TR
Qz
Xz
vY
iu
JU
Px
Px
hX
Px
Px
Px
Px
iu
aq
aq
aq
aq
oO
oO
"}
(42,1,1) = {"
bG
bG
RC
Pv
Xz
vY
iu
Px
Px
Px
hX
Px
Mz
kv
DB
iu
vY
vY
vY
vY
NY
aq
"}
(43,1,1) = {"
oO
oO
oO
oO
oO
vY
iu
xB
AD
AD
hX
Px
Px
Px
Px
iu
vY
Hp
vY
vY
vY
vY
"}
(44,1,1) = {"
oO
oO
oO
oO
oO
jQ
iu
JU
Px
Px
hX
Px
Px
Px
Xa
iu
vY
vY
vY
vY
vY
vY
"}
(45,1,1) = {"
OG
OG
OG
OG
OG
Ur
OP
Px
Px
Px
hX
Px
Px
Px
Px
iu
vY
vY
vY
vY
vY
vY
"}
(46,1,1) = {"
Hm
Hm
NG
Hm
Hm
Ur
si
Px
Px
Px
Lw
Px
Px
Px
zJ
iu
rH
vY
vY
vY
vY
rH
"}
(47,1,1) = {"
Bn
Bn
Bn
Bn
Bn
KU
EL
iv
iv
iv
mn
Px
Px
Px
Px
iu
vY
vY
vY
vY
vY
vY
"}
(48,1,1) = {"
aq
aq
oO
oO
oO
mQ
iu
Px
Px
Px
sz
Px
Px
Px
Px
iu
vY
vY
vY
vY
vY
vY
"}
(49,1,1) = {"
vY
vY
NY
aq
aq
aq
iu
JU
Px
Px
sz
Px
Px
Px
Xa
iu
vY
Hp
vY
vY
vY
vY
"}
(50,1,1) = {"
vY
vY
Hp
vY
vY
vY
iu
zJ
Px
Px
Qk
Px
Px
Px
zJ
iu
vY
vY
vY
vY
vY
vY
"}
(51,1,1) = {"
vY
vY
vY
vY
vY
vY
iu
Px
Px
Px
sz
Px
Mz
kv
DB
iu
rH
vY
vY
vY
vY
rH
"}
(52,1,1) = {"
vY
vY
rH
vY
vY
rH
iu
Px
II
Px
Qk
II
Px
Px
Px
iu
vY
vY
vY
vY
vY
tW
"}
(53,1,1) = {"
vY
vY
vY
vY
rH
vY
iu
iu
iu
gN
XX
iu
iu
iu
iu
iu
vY
vY
vY
vY
vY
vY
"}
(54,1,1) = {"
vY
vY
vY
vY
vY
vY
Ur
fG
Hm
Hm
Jm
Hm
Hm
fG
Hm
Qz
rH
vY
vY
vY
vY
rH
"}
