//MAP CONVERTED BY dmm2tgm.py THIS HEADER COMMENT PREVENTS RECONVERSION, DO NOT REMOVE
"d" = (
/obj/effect/landmark/excavation_site_spawner,
/obj/effect/ai_node,
/turf/open/floor/plating/ground/mars/random/cave,
/area/bigredv2/caves/southwest)
"f" = (
/turf/closed/mineral/smooth/bigred,
/area/bigredv2/caves/rock)
"g" = (
/obj/effect/landmark/lv624/fog_blocker/xeno_spawn,
/turf/open/floor/plating/ground/mars/random/cave,
/area/bigredv2/caves/southwest)
"j" = (
/obj/effect/landmark/patrol_point/som/som_11,
/turf/open/floor/plating/ground/mars/random/cave,
/area/bigredv2/caves/southwest)
"n" = (
/turf/closed/mineral/smooth/bigred/indestructible,
/area/space)
"t" = (
/turf/open/floor/plating/ground/mars/random/cave,
/area/bigredv2/caves/southwest)
"u" = (
/obj/effect/landmark/excavation_site_spawner,
/turf/open/floor/plating/ground/mars/random/cave,
/area/bigredv2/caves/southwest)
"w" = (
/turf/open/floor/plating/ground/mars/random/cave/rock,
/area/bigredv2/caves/southwest)
"x" = (
/obj/effect/landmark/lv624/fog_blocker/xeno_spawn,
/turf/open/floor/plating/ground/mars/random/cave/rock,
/area/bigredv2/caves/southwest)
"F" = (
/obj/effect/landmark/xeno_silo_spawn,
/turf/open/floor/plating/ground/mars/random/cave,
/area/bigredv2/caves/southwest)
"G" = (
/obj/effect/landmark/lv624/fog_blocker,
/turf/open/floor/plating/ground/mars/random/cave,
/area/bigredv2/caves/southwest)
"I" = (
/obj/effect/landmark/lv624/fog_blocker/xeno_spawn,
/turf/closed/mineral/smooth/bigred,
/area/bigredv2/caves/rock)
"K" = (
/obj/effect/landmark/xeno_tunnel_spawn,
/turf/open/floor/plating/ground/mars/random/cave,
/area/bigredv2/caves/southwest)
"P" = (
/obj/effect/landmark/lv624/fog_blocker,
/turf/closed/mineral/smooth/bigred,
/area/bigredv2/caves/rock)
"U" = (
/obj/effect/ai_node,
/turf/open/floor/plating/ground/mars/random/cave/rock,
/area/bigredv2/caves/southwest)
"W" = (
/obj/effect/ai_node,
/turf/open/floor/plating/ground/mars/random/cave,
/area/bigredv2/caves/southwest)

(1,1,1) = {"
n
n
n
n
n
n
n
n
n
n
n
n
n
n
n
n
n
n
n
n
n
n
n
n
n
n
n
n
n
n
n
n
n
n
n
n
n
n
n
n
n
n
n
"}
(2,1,1) = {"
f
f
f
f
f
f
f
f
f
f
f
f
f
I
f
f
f
f
f
f
f
f
f
f
f
f
f
f
f
f
f
f
f
f
f
n
n
n
n
n
n
n
n
"}
(3,1,1) = {"
f
f
f
f
f
f
f
f
f
f
f
f
f
I
f
f
f
f
f
f
f
f
f
f
f
f
f
f
f
f
f
f
f
f
f
n
n
n
n
n
n
n
n
"}
(4,1,1) = {"
f
f
f
f
f
f
f
f
f
f
f
f
f
I
f
f
f
f
f
f
f
f
f
f
f
f
f
f
f
f
f
f
f
f
f
n
n
n
n
n
n
n
n
"}
(5,1,1) = {"
f
f
f
f
f
f
f
f
f
f
f
f
f
I
f
f
f
f
f
f
f
f
t
t
t
t
t
f
f
f
f
f
f
f
f
n
n
n
n
n
n
n
n
"}
(6,1,1) = {"
f
f
f
f
f
f
f
f
f
f
f
f
f
I
f
f
f
t
w
w
w
w
w
t
t
t
t
t
f
f
f
f
f
f
f
n
n
n
n
n
n
n
n
"}
(7,1,1) = {"
f
f
f
f
t
t
W
t
t
f
f
f
f
g
t
w
t
t
t
t
t
t
t
t
t
t
F
t
f
f
f
f
f
f
f
n
n
n
n
n
n
n
n
"}
(8,1,1) = {"
f
f
t
t
t
t
t
t
t
t
t
f
f
g
U
t
t
t
t
t
t
t
W
t
t
t
t
W
t
f
f
f
f
f
f
n
n
n
n
n
n
n
n
"}
(9,1,1) = {"
f
t
t
t
t
t
t
t
t
t
t
t
t
g
t
t
t
t
t
t
t
t
t
t
t
t
t
t
t
f
f
f
f
f
f
n
n
n
n
n
n
n
n
"}
(10,1,1) = {"
t
t
W
t
t
t
W
t
t
t
t
W
t
g
W
f
f
f
f
f
t
t
t
t
t
t
t
t
t
f
f
f
f
f
f
n
n
n
n
n
n
n
n
"}
(11,1,1) = {"
t
t
t
t
t
t
t
t
t
t
t
t
t
g
t
f
f
f
f
f
f
f
t
K
w
t
t
t
t
f
f
f
f
f
f
n
n
n
n
n
n
n
n
"}
(12,1,1) = {"
t
t
t
t
t
t
t
t
t
t
f
f
f
g
t
t
f
f
f
f
f
f
f
f
t
t
t
t
t
f
f
f
f
f
f
n
n
n
n
n
n
n
n
"}
(13,1,1) = {"
t
w
U
f
f
f
f
f
f
f
f
f
f
g
t
t
t
f
f
f
f
f
f
f
t
t
t
t
t
f
f
f
f
f
f
n
n
n
n
n
n
n
n
"}
(14,1,1) = {"
t
t
w
f
f
f
f
f
f
f
f
f
f
g
t
t
t
t
t
f
f
f
f
f
f
t
t
w
f
f
f
f
f
f
f
n
n
n
n
n
n
n
n
"}
(15,1,1) = {"
t
t
t
w
w
f
f
f
f
f
f
f
f
x
W
t
t
t
t
t
f
f
f
f
f
t
t
t
f
f
f
f
f
f
f
n
n
n
n
n
n
n
n
"}
(16,1,1) = {"
t
t
t
t
w
f
f
f
f
f
f
f
f
I
t
W
t
t
t
t
W
f
f
f
f
t
t
t
f
f
f
f
f
f
f
n
n
n
n
n
n
n
n
"}
(17,1,1) = {"
t
t
t
t
w
f
f
f
f
f
f
f
f
I
t
t
t
t
t
u
t
W
t
t
t
t
t
U
f
f
f
f
f
f
f
n
n
n
n
n
n
n
n
"}
(18,1,1) = {"
t
t
t
t
w
f
f
f
f
f
f
f
f
I
t
t
t
t
t
t
t
t
t
t
t
t
W
f
f
f
f
f
f
f
f
n
n
n
n
n
n
n
n
"}
(19,1,1) = {"
t
t
W
t
U
f
f
f
f
f
f
f
f
I
I
g
g
g
g
g
g
g
g
x
g
g
g
I
I
I
I
I
I
I
I
n
n
n
n
n
n
n
n
"}
(20,1,1) = {"
f
t
t
t
t
w
f
f
f
f
f
f
f
f
f
f
t
t
t
t
t
t
t
w
t
t
t
f
f
f
f
f
f
f
f
n
n
n
n
n
n
n
n
"}
(21,1,1) = {"
f
f
f
t
t
w
f
f
f
f
f
f
f
f
f
f
f
t
t
t
t
t
w
t
t
t
t
f
f
f
f
f
f
f
f
n
n
n
n
n
n
n
n
"}
(22,1,1) = {"
f
f
f
t
t
t
w
t
f
f
f
f
f
f
f
f
f
f
f
f
t
t
w
f
f
t
t
f
f
f
f
f
f
f
f
n
n
n
n
n
n
n
n
"}
(23,1,1) = {"
f
f
f
t
t
t
t
t
t
f
f
f
f
f
f
f
f
f
f
f
f
f
f
f
f
t
t
t
f
f
f
f
f
f
f
n
n
n
n
n
n
n
n
"}
(24,1,1) = {"
f
f
f
t
t
t
t
t
w
t
t
f
f
f
f
f
f
f
f
f
f
f
f
f
t
t
t
t
f
f
f
f
f
f
f
n
n
n
n
n
n
n
n
"}
(25,1,1) = {"
f
f
f
w
t
t
t
t
t
t
w
t
f
f
f
f
f
f
f
f
f
f
f
f
t
W
t
t
f
f
f
f
f
f
f
n
n
n
n
n
n
n
n
"}
(26,1,1) = {"
f
f
f
f
W
t
t
t
t
t
t
t
w
f
f
f
f
f
f
f
f
f
f
f
f
t
W
t
f
f
f
f
f
f
f
n
n
n
n
n
n
n
n
"}
(27,1,1) = {"
f
f
f
t
t
W
t
j
t
t
t
t
t
t
f
f
f
f
f
f
f
f
f
f
f
t
t
t
t
f
f
f
f
f
f
n
n
n
n
n
n
n
n
"}
(28,1,1) = {"
f
f
t
t
t
t
t
t
t
t
t
t
t
t
w
f
f
f
f
f
f
f
f
f
f
f
t
t
t
f
f
f
f
f
f
n
n
n
n
n
n
n
n
"}
(29,1,1) = {"
f
t
t
t
t
t
t
t
t
t
t
t
t
t
t
f
f
f
f
f
f
f
f
f
f
f
t
t
t
f
f
f
f
f
f
n
n
n
n
n
n
n
n
"}
(30,1,1) = {"
f
t
t
t
t
t
t
t
t
w
f
w
W
t
t
t
f
f
f
f
f
f
f
f
f
f
t
t
t
t
f
f
f
f
f
n
n
n
n
n
n
n
n
"}
(31,1,1) = {"
f
t
t
t
t
t
t
t
t
w
f
f
w
W
t
t
t
f
f
f
f
f
f
f
f
f
U
t
t
t
f
f
f
f
f
n
n
n
n
n
n
n
n
"}
(32,1,1) = {"
f
t
W
t
t
W
f
t
t
w
f
f
f
t
W
t
t
W
t
f
f
f
f
f
f
f
w
U
t
t
f
f
f
f
f
n
n
n
n
n
n
n
n
"}
(33,1,1) = {"
f
t
t
t
f
f
f
w
w
f
f
f
f
t
t
t
t
t
t
t
w
f
f
f
f
f
f
w
W
t
t
f
f
f
f
n
n
n
n
n
n
n
n
"}
(34,1,1) = {"
f
t
t
t
f
f
f
f
f
f
f
f
f
f
t
t
t
t
t
t
t
w
f
f
f
f
f
f
t
t
t
t
f
f
f
n
n
n
n
n
n
n
n
"}
(35,1,1) = {"
f
t
t
t
f
f
f
f
f
f
f
f
f
t
t
t
t
t
t
t
w
f
f
f
f
f
f
f
t
t
t
f
f
f
f
n
n
n
n
n
n
n
n
"}
(36,1,1) = {"
f
t
t
t
f
f
f
f
f
f
f
f
f
w
t
t
t
t
t
t
w
f
f
f
f
f
f
f
t
t
t
f
f
f
f
n
n
n
n
n
n
n
n
"}
(37,1,1) = {"
t
t
t
t
f
f
f
f
f
f
f
f
f
f
f
f
t
d
t
t
t
U
f
f
f
f
f
f
t
u
t
f
f
f
f
n
n
n
n
n
n
n
n
"}
(38,1,1) = {"
t
t
t
t
f
f
f
f
f
f
f
f
f
f
f
f
t
t
t
t
t
w
f
f
f
f
w
w
t
t
t
f
f
f
f
n
n
n
n
n
n
n
n
"}
(39,1,1) = {"
t
t
t
t
f
f
f
f
f
f
f
f
f
f
f
f
w
t
t
t
t
w
f
f
f
f
w
w
t
t
f
f
f
f
f
n
n
n
n
n
n
n
n
"}
(40,1,1) = {"
t
t
t
t
f
f
f
f
f
f
f
f
f
f
f
f
f
f
f
t
t
t
w
w
f
f
f
f
t
t
f
f
f
f
f
n
n
n
n
n
n
n
n
"}
(41,1,1) = {"
G
G
G
P
P
P
P
P
P
P
P
P
P
P
f
f
f
f
f
t
t
t
t
w
f
f
f
f
t
t
f
f
f
f
f
n
n
n
n
n
n
n
n
"}
