//MAP CONVERTED BY dmm2tgm.py THIS HEADER COMMENT PREVENTS RECONVERSION, DO NOT REMOVE
"ad" = (
/obj/structure/cargo_container/gorg{
	dir = 4
	},
/turf/open/floor,
/area/bigredv2/outside/cargo)
"ar" = (
/obj/machinery/atmospherics/pipe/simple/green/hidden,
/obj/machinery/door/airlock/multi_tile/mainship/generic{
	name = "\improper Cargo Offices"
	},
/turf/open/floor,
/area/bigredv2/outside/cargo)
"at" = (
/obj/structure/cargo_container/green{
	dir = 1
	},
/turf/open/floor,
/area/bigredv2/outside/cargo)
"aw" = (
/obj/machinery/atmospherics/pipe/simple/green/hidden{
	dir = 10
	},
/obj/effect/decal/cleanable/dirt,
/turf/open/floor,
/area/bigredv2/outside/cargo)
"aU" = (
/obj/structure/table,
/obj/effect/spawner/random/engineering/tool,
/obj/effect/spawner/random/engineering/tool,
/obj/effect/spawner/random/engineering/bomb_supply,
/obj/effect/spawner/random/engineering/bomb_supply,
/turf/open/floor,
/area/bigredv2/outside/cargo)
"aV" = (
/obj/machinery/light{
	dir = 4
	},
/obj/effect/spawner/random/engineering/structure/tank/waterweighted,
/turf/open/floor,
/area/bigredv2/outside/cargo)
"ba" = (
/obj/machinery/atmospherics/pipe/simple/green/hidden,
/turf/open/floor/tile/dark,
/area/bigredv2/outside/engineering)
"bm" = (
/obj/machinery/atmospherics/pipe/manifold/green/hidden,
/turf/open/floor,
/area/bigredv2/outside/cargo)
"bw" = (
/obj/structure/closet/firecloset/full,
/turf/open/floor,
/area/bigredv2/outside/cargo)
"bE" = (
/obj/machinery/atmospherics/pipe/simple/green/hidden{
	dir = 4
	},
/obj/effect/ai_node,
/turf/open/floor,
/area/bigredv2/outside/cargo)
"bH" = (
/obj/machinery/atmospherics/components/unary/vent_pump{
	dir = 8;
	on = 1
	},
/turf/open/floor,
/area/bigredv2/outside/cargo)
"bK" = (
/obj/machinery/door/poddoor/shutters/mainship{
	id = "Cargonia";
	name = "\improper Cargo Shutters"
	},
/obj/structure/window/framed/colony/reinforced,
/turf/open/floor/plating,
/area/bigredv2/outside/cargo)
"bR" = (
/obj/structure/table,
/obj/effect/spawner/random/engineering/toolbox,
/obj/effect/spawner/random/engineering/tool,
/turf/open/floor,
/area/bigredv2/outside/cargo)
"bX" = (
/obj/effect/decal/cleanable/dirt,
/obj/effect/turf_decal/warning_stripes/box/empty,
/obj/structure/cargo_container/gorg,
/turf/open/floor,
/area/bigredv2/outside/cargo)
"cq" = (
/obj/machinery/atmospherics/pipe/simple/green/hidden,
/turf/open/floor,
/area/bigredv2/outside/cargo)
"cD" = (
/obj/structure/window/framed/colony,
/turf/open/floor/plating,
/area/bigredv2/outside/cargo)
"dq" = (
/obj/docking_port/stationary/crashmode,
/turf/closed/wall,
/area/bigredv2/outside/cargo)
"dx" = (
/turf/closed/wall/r_wall,
/area/bigredv2/outside/cargo)
"eS" = (
/turf/closed/wall/r_wall,
/area/bigredv2/outside/engineering)
"fe" = (
/obj/effect/spawner/random/misc/structure/supplycrate/normalweighted,
/obj/effect/decal/cleanable/dirt,
/turf/open/floor,
/area/bigredv2/outside/cargo)
"fj" = (
/obj/effect/spawner/random/engineering/structure/tank/fuelweighted,
/turf/open/floor,
/area/bigredv2/outside/cargo)
"fl" = (
/obj/structure/cargo_container/hd_blue{
	dir = 1
	},
/turf/open/floor,
/area/bigredv2/outside/cargo)
"hf" = (
/obj/structure/table,
/obj/effect/spawner/random/engineering/bomb_supply,
/obj/effect/spawner/random/engineering/tool,
/obj/effect/spawner/random/engineering/tool,
/obj/machinery/light{
	dir = 4
	},
/turf/open/floor,
/area/bigredv2/outside/cargo)
"hG" = (
/obj/effect/decal/cleanable/dirt,
/obj/machinery/atmospherics/pipe/simple/green/hidden,
/turf/open/floor,
/area/bigredv2/outside/cargo)
"hM" = (
/obj/machinery/atmospherics/pipe/simple/green/hidden,
/obj/effect/spawner/random/misc/structure/supplycrate/normalweighted,
/turf/open/floor,
/area/bigredv2/outside/cargo)
"hS" = (
/turf/open/floor/marking/bot,
/area/bigredv2/outside/cargo)
"iZ" = (
/obj/structure/cargo_container/ch_green{
	dir = 4
	},
/turf/open/floor/marking/bot,
/area/bigredv2/outside/cargo)
"jd" = (
/obj/machinery/atmospherics/pipe/simple/green/hidden,
/obj/effect/ai_node,
/turf/open/floor,
/area/bigredv2/outside/cargo)
"la" = (
/obj/machinery/computer/ordercomp,
/turf/open/floor,
/area/bigredv2/outside/cargo)
"li" = (
/obj/machinery/atmospherics/pipe/simple/green/hidden,
/obj/machinery/door/airlock/mainship/engineering/free_access{
	dir = 1;
	name = "\improper Cargo Bay Quartermaster"
	},
/turf/open/floor,
/area/bigredv2/outside/cargo)
"lj" = (
/obj/machinery/atmospherics/pipe/simple/green/hidden{
	dir = 4
	},
/obj/effect/decal/cleanable/dirt,
/obj/effect/ai_node,
/turf/open/floor,
/area/bigredv2/outside/cargo)
"lz" = (
/obj/effect/spawner/random/misc/structure/barrel,
/turf/open/floor,
/area/bigredv2/outside/cargo)
"lA" = (
/obj/effect/decal/cleanable/dirt,
/turf/open/floor,
/area/bigredv2/outside/cargo)
"lI" = (
/obj/structure/window/framed/colony,
/obj/machinery/door/poddoor/shutters/mainship{
	dir = 2;
	id = "Cargonia";
	name = "\improper Cargo Shutters"
	},
/turf/open/floor/plating,
/area/bigredv2/outside/cargo)
"nn" = (
/obj/machinery/atmospherics/pipe/simple/green/hidden{
	dir = 4
	},
/obj/machinery/light,
/turf/open/floor,
/area/bigredv2/outside/cargo)
"nH" = (
/obj/effect/spawner/random/misc/structure/supplycrate,
/turf/open/floor,
/area/bigredv2/outside/cargo)
"nS" = (
/obj/machinery/atmospherics/pipe/simple/green/hidden{
	dir = 4
	},
/turf/open/floor,
/area/bigredv2/outside/cargo)
"nX" = (
/obj/machinery/door/airlock/multi_tile/mainship/generic{
	name = "\improper Engineering Complex"
	},
/turf/open/floor/tile/dark,
/area/bigredv2/outside/engineering)
"oo" = (
/obj/machinery/light,
/turf/open/floor,
/area/bigredv2/outside/cargo)
"or" = (
/obj/machinery/door_control{
	dir = 8;
	id = "Cargonia";
	name = "Storm Shutters"
	},
/turf/open/floor,
/area/bigredv2/outside/cargo)
"ou" = (
/obj/effect/decal/cleanable/dirt,
/obj/effect/spawner/random/misc/structure/barrel,
/turf/open/floor/marking/bot,
/area/bigredv2/outside/cargo)
"pt" = (
/obj/effect/turf_decal/warning_stripes/box/empty,
/obj/structure/cargo_container/gorg,
/turf/open/floor,
/area/bigredv2/outside/cargo)
"pE" = (
/obj/effect/decal/cleanable/dirt,
/obj/machinery/atmospherics/pipe/simple/green/hidden{
	dir = 4
	},
/obj/effect/ai_node,
/turf/open/floor,
/area/bigredv2/outside/cargo)
"pF" = (
/obj/machinery/atmospherics/pipe/manifold/green/hidden{
	dir = 1
	},
/obj/effect/ai_node,
/turf/open/floor,
/area/bigredv2/outside/cargo)
"pI" = (
/obj/effect/decal/cleanable/dirt,
/obj/effect/spawner/random/misc/structure/supplycrate,
/turf/open/floor,
/area/bigredv2/outside/cargo)
"pV" = (
/obj/machinery/atmospherics/pipe/manifold/green/hidden{
	dir = 1
	},
/turf/open/floor,
/area/bigredv2/outside/cargo)
"qP" = (
/obj/structure/closet/crate/trashcart,
/turf/open/floor/marking/bot,
/area/bigredv2/outside/cargo)
"qU" = (
/obj/structure/cargo_container/nt{
	dir = 4
	},
/turf/open/floor/marking/bot,
/area/bigredv2/outside/cargo)
"rB" = (
/obj/structure/cargo_container/ch_green{
	dir = 1
	},
/turf/open/floor,
/area/bigredv2/outside/cargo)
"sR" = (
/obj/item/flashlight,
/obj/item/reagent_containers/spray/cleaner,
/turf/open/floor,
/area/bigredv2/outside/cargo)
"ts" = (
/obj/structure/table,
/obj/effect/spawner/random/engineering/tech_supply,
/obj/effect/spawner/random/engineering/tool,
/obj/effect/spawner/random/engineering/tool,
/turf/open/floor,
/area/bigredv2/outside/cargo)
"uf" = (
/turf/open/floor/marking/loadingarea,
/area/bigredv2/outside/cargo)
"uR" = (
/obj/machinery/prop/autolathe,
/turf/open/floor,
/area/bigredv2/outside/cargo)
"uY" = (
/turf/open/floor/marking/delivery,
/area/bigredv2/outside/cargo)
"vw" = (
/obj/structure/filingcabinet,
/turf/open/floor,
/area/bigredv2/outside/cargo)
"vM" = (
/obj/effect/decal/cleanable/dirt,
/obj/machinery/atmospherics/pipe/simple/green/hidden{
	dir = 5
	},
/turf/open/floor,
/area/bigredv2/outside/cargo)
"vU" = (
/obj/structure/cargo_container/hd_blue{
	dir = 4
	},
/turf/open/floor/marking/bot,
/area/bigredv2/outside/cargo)
"wh" = (
/obj/structure/cargo_container/green{
	dir = 4
	},
/turf/open/floor/marking/bot,
/area/bigredv2/outside/cargo)
"wn" = (
/obj/effect/decal/cleanable/dirt,
/obj/effect/decal/cleanable/dirt,
/turf/open/floor,
/area/bigredv2/outside/cargo)
"wH" = (
/obj/effect/decal/cleanable/dirt,
/obj/machinery/atmospherics/pipe/simple/green/hidden,
/obj/effect/ai_node,
/turf/open/floor,
/area/bigredv2/outside/cargo)
"xB" = (
/obj/machinery/light{
	dir = 1
	},
/obj/effect/spawner/random/misc/structure/supplycrate,
/turf/open/floor,
/area/bigredv2/outside/cargo)
"xE" = (
/obj/structure/cargo_container/ch_green,
/turf/open/floor/marking/bot,
/area/bigredv2/outside/cargo)
"xO" = (
/obj/item/reagent_containers/glass/bottle/tramadol,
/turf/open/floor,
/area/bigredv2/outside/cargo)
"yl" = (
/obj/machinery/door/airlock/mainship/engineering/free_access{
	name = "\improper Cargo Bay Quartermaster"
	},
/turf/open/floor,
/area/bigredv2/outside/cargo)
"yP" = (
/obj/effect/turf_decal/warning_stripes/box/empty,
/obj/structure/cargo_container/gorg{
	dir = 4
	},
/turf/open/floor,
/area/bigredv2/outside/cargo)
"zb" = (
/obj/machinery/atmospherics/components/unary/vent_pump{
	dir = 1;
	on = 1
	},
/obj/effect/ai_node,
/turf/open/floor,
/area/bigredv2/outside/cargo)
"zT" = (
/obj/machinery/atmospherics/components/unary/vent_pump{
	on = 1
	},
/turf/open/floor,
/area/bigredv2/outside/cargo)
"BG" = (
/obj/effect/decal/cleanable/blood,
/turf/open/floor,
/area/bigredv2/outside/cargo)
"BP" = (
/obj/item/reagent_containers/spray/cleaner,
/obj/machinery/atmospherics/pipe/simple/green/hidden,
/turf/open/floor,
/area/bigredv2/outside/cargo)
"CI" = (
/obj/machinery/door/airlock/multi_tile/mainship/generic{
	dir = 1;
	name = "\improper Cargo Bay"
	},
/turf/open/floor,
/area/bigredv2/outside/cargo)
"Et" = (
/obj/effect/decal/cleanable/dirt,
/turf/open/floor/marking/bot,
/area/bigredv2/outside/cargo)
"EI" = (
/obj/effect/spawner/random/misc/structure/supplycrate/normalweighted,
/turf/open/floor/marking/bot,
/area/bigredv2/outside/cargo)
"Fu" = (
/obj/structure/filingcabinet,
/obj/machinery/light{
	dir = 1
	},
/turf/open/floor,
/area/bigredv2/outside/cargo)
"FA" = (
/obj/effect/decal/cleanable/dirt,
/obj/effect/turf_decal/warning_stripes/box/empty,
/obj/structure/cargo_container/gorg{
	dir = 4
	},
/turf/open/floor,
/area/bigredv2/outside/cargo)
"FH" = (
/obj/effect/ai_node,
/turf/open/floor/marking/delivery,
/area/bigredv2/outside/cargo)
"FX" = (
/obj/structure/cargo_container/nt,
/turf/open/floor/marking/bot,
/area/bigredv2/outside/cargo)
"Gu" = (
/obj/effect/decal/cleanable/dirt,
/obj/item/megaphone,
/turf/open/floor,
/area/bigredv2/outside/cargo)
"GC" = (
/obj/machinery/light{
	dir = 8
	},
/turf/open/floor,
/area/bigredv2/outside/cargo)
"Hu" = (
/obj/machinery/atmospherics/pipe/simple/green/hidden,
/obj/effect/decal/cleanable/dirt,
/turf/open/floor,
/area/bigredv2/outside/cargo)
"Hw" = (
/obj/structure/cargo_container/hd_blue,
/turf/open/floor/marking/bot,
/area/bigredv2/outside/cargo)
"HW" = (
/obj/structure/bed/chair/office/dark,
/turf/open/floor,
/area/bigredv2/outside/cargo)
"Ik" = (
/obj/machinery/light{
	dir = 1
	},
/turf/open/floor,
/area/bigredv2/outside/cargo)
"Iw" = (
/obj/structure/cargo_container/gorg,
/turf/open/floor/marking/bot,
/area/bigredv2/outside/cargo)
"IE" = (
/obj/effect/turf_decal/warning_stripes/box/small{
	dir = 4
	},
/obj/effect/turf_decal/warning_stripes/box/arrow{
	dir = 4
	},
/turf/open/floor,
/area/bigredv2/outside/cargo)
"IF" = (
/obj/effect/ai_node,
/turf/open/floor,
/area/bigredv2/outside/cargo)
"IP" = (
/obj/structure/table,
/obj/effect/spawner/random/engineering/toolbox,
/turf/open/floor,
/area/bigredv2/outside/cargo)
"Jd" = (
/turf/open/floor/plating,
/area/bigredv2/outside/cargo)
"Je" = (
/obj/effect/decal/cleanable/dirt,
/obj/structure/closet/crate/trashcart,
/turf/open/floor/marking/bot,
/area/bigredv2/outside/cargo)
"Jf" = (
/obj/effect/spawner/random/engineering/tool,
/turf/open/floor,
/area/bigredv2/outside/cargo)
"Jg" = (
/obj/structure/table,
/obj/effect/spawner/random/engineering/bomb_supply,
/obj/effect/spawner/random/engineering/bomb_supply,
/obj/effect/spawner/random/engineering/tool,
/turf/open/floor,
/area/bigredv2/outside/cargo)
"Ji" = (
/obj/effect/spawner/random/misc/structure/supplycrate/normalweighted,
/turf/open/floor,
/area/bigredv2/outside/cargo)
"Js" = (
/obj/structure/table,
/obj/effect/spawner/random/weaponry/ammo,
/turf/open/floor,
/area/bigredv2/outside/cargo)
"JL" = (
/obj/effect/decal/cleanable/dirt,
/obj/effect/ai_node,
/turf/open/floor,
/area/bigredv2/outside/cargo)
"JU" = (
/obj/effect/decal/cleanable/dirt,
/obj/effect/decal/cleanable/dirt,
/obj/effect/ai_node,
/turf/open/floor,
/area/bigredv2/outside/cargo)
"KD" = (
/obj/machinery/atmospherics/pipe/simple/green/hidden{
	dir = 4
	},
/obj/machinery/door/airlock/mainship/security/glass/free_access{
	name = "\improper Cargo Bay Security"
	},
/turf/open/floor,
/area/bigredv2/outside/cargo)
"LD" = (
/obj/effect/spawner/random/misc/structure/supplycrate/normalweighted,
/turf/open/floor/marking/loadingarea,
/area/bigredv2/outside/cargo)
"Mw" = (
/obj/structure/closet/emcloset,
/turf/open/floor,
/area/bigredv2/outside/cargo)
"Op" = (
/obj/structure/table,
/obj/effect/spawner/random/engineering/tool,
/turf/open/floor,
/area/bigredv2/outside/cargo)
"Ov" = (
/obj/structure/table,
/obj/effect/spawner/random/engineering/bomb_supply,
/obj/effect/spawner/random/engineering/bomb_supply,
/turf/open/floor,
/area/bigredv2/outside/cargo)
"OL" = (
/obj/machinery/power/apc/high/ntf,
/turf/open/floor,
/area/bigredv2/outside/cargo)
"Pf" = (
/obj/effect/decal/cleanable/dirt,
/obj/machinery/atmospherics/pipe/manifold/green/hidden{
	dir = 8
	},
/turf/open/floor,
/area/bigredv2/outside/cargo)
"PF" = (
/obj/effect/decal/cleanable/dirt,
/obj/effect/spawner/random/misc/structure/supplycrate/normalweighted,
/turf/open/floor,
/area/bigredv2/outside/cargo)
"Qn" = (
/obj/machinery/light{
	dir = 4
	},
/turf/open/floor,
/area/bigredv2/outside/cargo)
"QV" = (
/obj/structure/cargo_container/nt{
	dir = 1
	},
/turf/open/floor,
/area/bigredv2/outside/cargo)
"Sh" = (
/obj/effect/decal/cleanable/dirt,
/obj/machinery/atmospherics/components/unary/vent_pump{
	dir = 4;
	on = 1
	},
/turf/open/floor,
/area/bigredv2/outside/cargo)
"TG" = (
/obj/effect/decal/cleanable/dirt,
/obj/item/tool/lighter/random,
/turf/open/floor,
/area/bigredv2/outside/cargo)
"Ut" = (
/obj/effect/turf_decal/warning_stripes/box/small{
	dir = 8
	},
/obj/effect/turf_decal/warning_stripes/box/arrow{
	dir = 8
	},
/turf/open/floor,
/area/bigredv2/outside/cargo)
"VF" = (
/obj/effect/decal/cleanable/dirt,
/obj/structure/cargo_container/green,
/turf/open/floor/marking/bot,
/area/bigredv2/outside/cargo)
"Wb" = (
/turf/open/floor,
/area/bigredv2/outside/cargo)
"WM" = (
/turf/closed/wall,
/area/bigredv2/outside/cargo)
"Xm" = (
/obj/effect/decal/cleanable/dirt,
/obj/effect/ai_node,
/obj/machinery/light{
	dir = 8
	},
/turf/open/floor,
/area/bigredv2/outside/cargo)
"ZE" = (
/obj/effect/decal/cleanable/dirt,
/obj/machinery/atmospherics/pipe/simple/green/hidden{
	dir = 4
	},
/turf/open/floor,
/area/bigredv2/outside/cargo)
"ZF" = (
/obj/effect/turf_decal/warning_stripes/box/empty,
/turf/open/floor,
/area/bigredv2/outside/cargo)
"ZT" = (
/obj/effect/decal/cleanable/dirt,
/obj/effect/spawner/random/misc/structure/supplycrate/normalweighted,
/turf/open/floor/marking/bot,
/area/bigredv2/outside/cargo)

(1,1,1) = {"
Jd
Jd
Jd
dx
bK
bK
bK
dx
WM
WM
nS
CI
dq
WM
WM
WM
yl
WM
WM
"}
(2,1,1) = {"
FH
uY
uY
GC
Wb
Wb
Wb
fj
Wb
Wb
nS
Wb
Wb
GC
WM
Ik
Wb
ts
WM
"}
(3,1,1) = {"
Jf
Wb
Wb
uf
xE
ou
hS
FX
Iw
Wb
bE
Wb
Wb
Wb
WM
Wb
HW
Op
lI
"}
(4,1,1) = {"
cq
cq
vM
Wb
rB
PF
Wb
QV
ad
Wb
pV
wH
BP
cq
li
cq
zb
Op
lI
"}
(5,1,1) = {"
Ji
Wb
nS
uf
iZ
Et
hS
qU
qP
Wb
nS
Wb
lA
pI
cD
vw
lA
la
lI
"}
(6,1,1) = {"
lA
BG
pV
hM
cq
cq
cq
hG
cq
cq
bm
Qn
lA
lA
cD
vw
Wb
Wb
lI
"}
(7,1,1) = {"
fe
Wb
nS
uf
EI
Je
hS
ZT
hS
Wb
nn
WM
xB
Wb
WM
Fu
Wb
Wb
WM
"}
(8,1,1) = {"
Wb
Wb
nS
Wb
lA
lA
IF
lA
Wb
Wb
nS
Xm
Wb
nH
WM
cD
yl
cD
eS
"}
(9,1,1) = {"
Wb
Wb
nS
uf
Et
Hw
hS
VF
hS
Wb
nS
Gu
Wb
Wb
fj
Wb
Wb
oo
eS
"}
(10,1,1) = {"
Wb
Wb
nS
Wb
Wb
fl
Wb
at
lz
zT
bm
Wb
Wb
Wb
Wb
lA
Wb
Wb
nX
"}
(11,1,1) = {"
Wb
Wb
bH
LD
hS
vU
hS
wh
EI
Wb
pF
cq
cq
cq
cq
cq
jd
cq
ba
"}
(12,1,1) = {"
bw
Mw
Mw
Wb
Wb
Wb
Wb
Wb
Wb
Wb
ZE
JU
xO
Wb
Wb
Wb
Wb
bR
eS
"}
(13,1,1) = {"
WM
WM
WM
WM
cD
cD
cD
WM
Ik
Wb
ZE
wn
IE
Wb
IE
lA
Wb
bR
eS
"}
(14,1,1) = {"
Js
Js
uR
WM
Wb
Wb
Wb
WM
OL
Wb
ZE
wn
ZF
Wb
bX
lA
Wb
IP
eS
"}
(15,1,1) = {"
JL
Sh
oo
WM
lA
lA
fj
WM
Wb
lA
ZE
lA
pt
Wb
FA
Wb
Wb
Op
eS
"}
(16,1,1) = {"
lA
aw
cq
ar
Hu
Pf
cq
ar
cq
Hu
bm
lA
yP
Wb
pt
Wb
Wb
aU
eS
"}
(17,1,1) = {"
IF
TG
lA
Wb
lA
lj
Wb
Wb
Wb
lA
pE
Wb
ZF
IF
yP
Wb
Wb
Jg
eS
"}
(18,1,1) = {"
Wb
Wb
Wb
WM
Ik
nS
Wb
WM
Wb
sR
nS
Wb
Ut
Wb
Ut
Wb
Wb
Ov
eS
"}
(19,1,1) = {"
cD
cD
WM
WM
cD
KD
cD
WM
Wb
Wb
nS
hf
or
Wb
fj
fj
fj
aV
eS
"}
