//MAP CONVERTED BY dmm2tgm.py THIS HEADER COMMENT PREVENTS RECONVERSION, DO NOT REMOVE
"aC" = (
/obj/structure/cable,
/turf/open/floor/marking/asteroidwarning{
	dir = 1
	},
/area/bigredv3/outside/directions/nw)
"aE" = (
/turf/open/floor/plating/ground/mars/dirttosand/autosmooth{
	dir = 6
	},
/area/bigredv3/caves/northwest)
"bw" = (
/obj/machinery/atmospherics/pipe/simple/green/hidden{
	dir = 4
	},
/obj/structure/cable,
/turf/open/floor/plating,
/area/bigredv3/outside/directions/nw)
"bJ" = (
/turf/open/floor/plating/ground/mars/dirttosand/autosmooth{
	dir = 5
	},
/area/bigredv3/outside/medical/virology)
"bZ" = (
/obj/machinery/atmospherics/pipe/simple/green/hidden{
	dir = 4
	},
/obj/structure/cable,
/obj/effect/ai_node,
/turf/open/floor/plating,
/area/bigredv3/outside/directions/nw)
"cJ" = (
/obj/structure/cargo_container/horizontal{
	dir = 1
	},
/turf/open/floor/plating,
/area/bigredv3/outside/directions/nw)
"dx" = (
/obj/effect/decal/cleanable/dirt,
/obj/structure/cable,
/obj/effect/decal/cleanable/dirt,
/turf/open/floor/plating,
/area/bigredv3/outside/directions/nw)
"em" = (
/obj/effect/turf_decal/sandedge,
/turf/open/floor/marking/asteroidwarning{
	dir = 5
	},
/area/bigredv3/outside/directions/nw)
"eX" = (
/obj/machinery/atmospherics/pipe/simple/green/hidden,
/obj/structure/cable,
/turf/open/floor/marking/asteroidwarning{
	dir = 4
	},
/area/bigredv3/outside/directions/nw)
"gb" = (
/obj/machinery/atmospherics/pipe/simple/green/hidden{
	dir = 4
	},
/obj/structure/cable,
/turf/open/floor/asteroidfloor,
/area/bigredv3/outside/directions/nw)
"gK" = (
/turf/open/floor/plating/ground/mars/random/sand,
/area/bigredv3/outside/directions/nw)
"gN" = (
/obj/structure/cargo_container/hd_blue{
	dir = 1
	},
/turf/open/floor/plating,
/area/bigredv3/outside/directions/nw)
"hn" = (
/obj/effect/ai_node,
/turf/open/floor/plating/ground/mars/random/cave,
/area/bigredv3/caves/northwest)
"hy" = (
/turf/open/floor/plating/ground/mars/random/sand,
/area/bigredv3/outside/medical/virology)
"hT" = (
/turf/open/floor/plating/warning{
	dir = 1
	},
/area/bigredv3/outside/directions/nw)
"hX" = (
/obj/machinery/atmospherics/pipe/manifold/green/hidden,
/obj/structure/cable,
/turf/open/floor/plating,
/area/bigredv3/outside/directions/nw)
"iW" = (
/turf/open/floor/plating/ground/mars/dirttosand/autosmooth{
	dir = 9
	},
/area/bigredv3/outside/directions/nw)
"jc" = (
/turf/open/floor/plating/ground/mars/dirttosand/autosmooth{
	dir = 5
	},
/area/bigredv3/outside/directions/nw)
"jf" = (
/obj/structure/cable,
/turf/open/floor/asteroidfloor,
/area/bigredv3/outside/directions/nw)
"jS" = (
/obj/structure/cargo_container/hd_blue{
	dir = 8
	},
/turf/open/floor/plating,
/area/bigredv3/outside/directions/nw)
"jZ" = (
/turf/open/floor/plating/ground/mars/random/dirt,
/area/bigredv3/outside/directions/nw)
"ke" = (
/turf/open/floor/plating/ground/mars/dirttosand/autosmooth{
	dir = 8
	},
/area/bigredv3/outside/directions/nw)
"kv" = (
/obj/effect/decal/cleanable/dirt,
/obj/effect/decal/cleanable/dirt,
/obj/effect/decal/cleanable/dirt,
/turf/open/floor/marking/asteroidwarning{
	dir = 8
	},
/area/bigredv3/outside/directions/nw)
"kD" = (
/obj/effect/decal/cleanable/dirt,
/obj/structure/cable,
/turf/open/floor/asteroidfloor,
/area/bigredv3/outside/directions/nw)
"kW" = (
/turf/open/floor/plating/warning{
	dir = 8
	},
/area/bigredv3/outside/directions/nw)
"lf" = (
/obj/effect/decal/cleanable/dirt,
/obj/effect/decal/cleanable/dirt,
/obj/effect/decal/cleanable/dirt,
/obj/structure/cable,
/turf/open/floor/marking/asteroidwarning{
	dir = 9
	},
/area/bigredv3/outside/directions/nw)
"lm" = (
/turf/closed/mineral/smooth/bigred/indestructible,
/area/space)
"lM" = (
/obj/structure/cargo_container/green,
/turf/open/floor/plating,
/area/bigredv3/outside/directions/nw)
"ml" = (
/obj/effect/decal/cleanable/blood,
/turf/open/floor/plating/ground/mars/random/sand,
/area/bigredv3/outside/directions/nw)
"nh" = (
/obj/effect/ai_node,
/turf/open/floor/marking/asteroidwarning{
	dir = 10
	},
/area/bigredv3/outside/directions/nw)
"nU" = (
/obj/structure/cable,
/obj/machinery/atmospherics/pipe/simple/green/hidden,
/obj/effect/ai_node,
/turf/open/floor/asteroidfloor,
/area/bigredv3/outside/directions/nw)
"nY" = (
/turf/open/floor/plating/ground/mars/random/cave,
/area/bigredv3/caves/west)
"oj" = (
/obj/machinery/light,
/obj/effect/spawner/random/misc/structure/supplycrate/normalweighted,
/turf/open/floor/plating,
/area/bigredv3/outside/directions/nw)
"op" = (
/turf/open/floor/marking/asteroidwarning,
/area/bigredv3/outside/directions/nw)
"ph" = (
/obj/structure/cable,
/obj/effect/decal/cleanable/dirt,
/turf/open/floor/plating,
/area/bigredv3/outside/directions/nw)
"px" = (
/obj/effect/ai_node,
/turf/open/floor/plating/ground/mars/random/cave/rock,
/area/bigredv3/caves/west)
"pG" = (
/obj/machinery/light,
/obj/effect/spawner/random/engineering/structure/tank/fuelweighted,
/turf/open/floor/plating,
/area/bigredv3/outside/directions/nw)
"pR" = (
/obj/structure/cable,
/obj/machinery/atmospherics/pipe/simple/green/hidden,
/turf/open/floor/plating,
/area/bigredv3/outside/directions/nw)
"pS" = (
/obj/effect/ai_node,
/turf/open/floor/plating/ground/mars/random/sand,
/area/bigredv3/outside/directions/nw)
"qd" = (
/obj/effect/decal/cleanable/dirt,
/turf/open/floor/marking/asteroidwarning{
	dir = 4
	},
/area/bigredv3/outside/directions/nw)
"rf" = (
/obj/effect/decal/cleanable/dirt,
/obj/effect/decal/cleanable/dirt,
/turf/open/floor/marking/asteroidwarning{
	dir = 10
	},
/area/bigredv3/outside/directions/nw)
"ri" = (
/obj/effect/ai_node,
/turf/open/floor/marking/asteroidwarning{
	dir = 4
	},
/area/bigredv3/outside/medical/virology)
"ru" = (
/turf/open/floor/asteroidfloor,
/area/bigredv3/outside/medical/virology)
"rw" = (
/obj/structure/cargo_container/hd_blue{
	dir = 4
	},
/turf/open/floor/plating,
/area/bigredv3/outside/directions/nw)
"rV" = (
/obj/machinery/atmospherics/pipe/simple/green/hidden{
	dir = 4
	},
/obj/structure/cable,
/obj/machinery/door/airlock/multi_tile/mainship/medidoor{
	dir = 1;
	name = "\improper Medical Clinic"
	},
/turf/open/floor/tile/white,
/area/bigredv3/outside/directions/nw)
"so" = (
/obj/machinery/light{
	dir = 4
	},
/turf/open/floor/plating,
/area/bigredv3/outside/directions/nw)
"sq" = (
/obj/machinery/light{
	dir = 8
	},
/turf/open/floor/marking/asteroidwarning{
	dir = 1
	},
/area/bigredv3/outside/directions/nw)
"tZ" = (
/obj/machinery/atmospherics/pipe/simple/green/hidden,
/turf/open/floor/marking/asteroidwarning{
	dir = 4
	},
/area/bigredv3/outside/directions/nw)
"uB" = (
/obj/structure/cable,
/obj/machinery/atmospherics/pipe/simple/green/hidden,
/turf/open/floor/marking/asteroidwarning{
	dir = 4
	},
/area/bigredv3/outside/directions/nw)
"vL" = (
/obj/machinery/floodlight/outpost/bigred,
/turf/open/floor/plating/ground/mars/random/sand,
/area/bigredv3/outside/directions/nw)
"wr" = (
/obj/effect/ai_node,
/obj/effect/decal/cleanable/dirt,
/turf/open/floor/plating,
/area/bigredv3/outside/directions/nw)
"wA" = (
/turf/open/floor/asteroidfloor,
/area/bigredv3/outside/directions/nw)
"xc" = (
/turf/open/floor/tile/white,
/area/bigredv3/outside/directions/nw)
"xu" = (
/turf/closed/wall/r_wall,
/area/bigredv3/inside/wall)
"xH" = (
/obj/effect/decal/cleanable/dirt,
/turf/open/floor/plating,
/area/bigredv3/outside/directions/nw)
"xJ" = (
/obj/machinery/atmospherics/pipe/simple/green/hidden,
/obj/structure/cable,
/obj/effect/ai_node,
/turf/open/floor/marking/asteroidwarning{
	dir = 4
	},
/area/bigredv3/outside/directions/nw)
"xT" = (
/turf/open/floor/plating/ground/mars/dirttosand/autosmooth{
	dir = 4
	},
/area/bigredv3/outside/directions/nw)
"zg" = (
/obj/machinery/light{
	dir = 1
	},
/turf/open/floor/plating/ground/mars/dirttosand/autosmooth{
	dir = 5
	},
/area/bigredv3/outside/medical/virology)
"zy" = (
/obj/structure/largecrate/random/case/double,
/turf/open/floor/plating,
/area/bigredv3/outside/directions/nw)
"zR" = (
/obj/machinery/atmospherics/pipe/simple/green/hidden,
/obj/structure/cable,
/turf/open/floor/plating,
/area/bigredv3/outside/directions/nw)
"zV" = (
/obj/structure/cable,
/turf/closed/mineral/smooth/bigred,
/area/bigredv3/caves/rock)
"At" = (
/obj/structure/cable,
/turf/open/floor/marking/asteroidwarning,
/area/bigredv3/outside/directions/nw)
"AG" = (
/turf/open/floor/marking/asteroidwarning{
	dir = 1
	},
/area/bigredv3/outside/medical/virology)
"AR" = (
/obj/effect/ai_node,
/turf/open/floor/plating/ground/mars/random/dirt,
/area/bigredv3/outside/medical/virology)
"Bb" = (
/turf/open/floor/plating/ground/mars/dirttosand/autosmooth{
	dir = 4
	},
/area/bigredv3/caves/northwest)
"Bl" = (
/obj/structure/cable,
/obj/machinery/atmospherics/pipe/simple/green/hidden,
/obj/effect/decal/cleanable/dirt,
/turf/open/floor/marking/asteroidwarning{
	dir = 1
	},
/area/bigredv3/outside/directions/nw)
"BA" = (
/obj/effect/decal/cleanable/dirt,
/turf/open/floor/marking/asteroidwarning{
	dir = 1
	},
/area/bigredv3/outside/directions/nw)
"BO" = (
/obj/machinery/light,
/turf/open/floor/plating,
/area/bigredv3/outside/directions/nw)
"Cg" = (
/obj/machinery/light{
	dir = 1
	},
/turf/open/floor/plating/ground/mars/random/dirt,
/area/bigredv3/outside/medical/virology)
"CA" = (
/turf/open/floor/marking/asteroidwarning{
	dir = 10
	},
/area/bigredv3/outside/directions/nw)
"CG" = (
/turf/open/floor/marking/asteroidwarning{
	dir = 4
	},
/area/bigredv3/outside/medical/virology)
"CY" = (
/obj/structure/cable,
/obj/machinery/atmospherics/pipe/simple/green/hidden{
	dir = 6
	},
/obj/effect/ai_node,
/turf/open/floor/plating,
/area/bigredv3/outside/directions/nw)
"Dm" = (
/obj/effect/ai_node,
/turf/open/floor/plating,
/area/bigredv3/outside/directions/nw)
"Dv" = (
/turf/open/floor/plating/ground/mars/random/dirt,
/area/bigredv3/outside/medical/virology)
"DU" = (
/turf/open/floor/plating/ground/mars/random/cave/rock,
/area/bigredv3/caves/west)
"EA" = (
/turf/open/floor/plating/ground/mars/dirttosand/autosmooth{
	dir = 1
	},
/area/bigredv3/outside/directions/nw)
"Fo" = (
/obj/structure/cable,
/turf/open/floor/plating,
/area/bigredv3/outside/directions/nw)
"Fq" = (
/turf/open/floor/marking/asteroidwarning{
	dir = 4
	},
/area/bigredv3/outside/directions/nw)
"FG" = (
/obj/effect/turf_decal/sandedge{
	dir = 4
	},
/obj/structure/fence/standard/xenoproof,
/turf/open/floor/plating/ground/mars/random/dirt,
/area/bigredv3/caves/northwest)
"FO" = (
/obj/structure/fence/standard/xenoproof,
/turf/open/floor/plating/ground/mars/dirttosand/autosmooth{
	dir = 6
	},
/area/bigredv3/caves/northwest)
"Gr" = (
/obj/effect/spawner/random/misc/structure/supplycrate/normalweighted,
/obj/structure/cable,
/obj/machinery/power/apc/weak/ntf{
	dir = 1
	},
/turf/open/floor/plating,
/area/bigredv3/outside/directions/nw)
"Gu" = (
/obj/structure/cable,
/obj/machinery/atmospherics/pipe/simple/green/hidden{
	dir = 5
	},
/turf/open/floor/asteroidfloor,
/area/bigredv3/outside/directions/nw)
"Gv" = (
/obj/effect/ai_node,
/turf/open/floor/asteroidfloor,
/area/bigredv3/outside/directions/nw)
"Gx" = (
/turf/open/floor/plating/ground/mars/dirttosand/autosmooth{
	dir = 5
	},
/area/bigredv3/caves/northwest)
"GX" = (
/obj/effect/decal/cleanable/dirt,
/turf/closed/wall/r_wall,
/area/bigredv3/inside/wall)
"Hw" = (
/obj/effect/ai_node,
/turf/open/floor/plating/ground/mars/random/cave,
/area/bigredv3/caves/west)
"HV" = (
/obj/effect/decal/cleanable/dirt,
/turf/open/floor/marking/asteroidwarning,
/area/bigredv3/outside/directions/nw)
"JE" = (
/turf/open/floor/plating/ground/mars/cavetodirt{
	dir = 6
	},
/area/bigredv3/caves/west)
"JW" = (
/turf/open/floor/marking/asteroidwarning{
	dir = 5
	},
/area/bigredv3/outside/directions/nw)
"JY" = (
/turf/open/floor/plating/ground/mars/dirttosand/autosmooth,
/area/bigredv3/outside/directions/nw)
"LU" = (
/turf/open/floor/marking/asteroidwarning{
	dir = 5
	},
/area/bigredv3/outside/medical/virology)
"NF" = (
/obj/structure/cable,
/obj/machinery/atmospherics/pipe/simple/green/hidden{
	dir = 4
	},
/turf/open/floor/asteroidfloor,
/area/bigredv3/outside/directions/nw)
"Ov" = (
/obj/structure/cable,
/obj/machinery/atmospherics/pipe/simple/green/hidden{
	dir = 4
	},
/obj/effect/ai_node,
/turf/open/floor/plating/warning{
	dir = 8
	},
/area/bigredv3/outside/directions/nw)
"OU" = (
/obj/structure/cargo_container/green{
	dir = 1
	},
/turf/open/floor/plating,
/area/bigredv3/outside/directions/nw)
"Pb" = (
/obj/structure/cable,
/turf/open/floor/plating/warning{
	dir = 1
	},
/area/bigredv3/outside/directions/nw)
"Pe" = (
/turf/open/floor/marking/asteroidwarning{
	dir = 8
	},
/area/bigredv3/outside/medical/virology)
"PR" = (
/obj/effect/decal/cleanable/dirt,
/turf/open/floor/marking/asteroidwarning{
	dir = 5
	},
/area/bigredv3/outside/directions/nw)
"PU" = (
/turf/open/floor/plating/ground/mars/random/sand,
/area/bigredv3/caves/northwest)
"PY" = (
/obj/effect/spawner/random/misc/structure/supplycrate/normalweighted,
/turf/open/floor/plating,
/area/bigredv3/outside/directions/nw)
"Qe" = (
/obj/effect/spawner/random/misc/structure/barrel,
/turf/open/floor/plating,
/area/bigredv3/outside/directions/nw)
"Qm" = (
/obj/machinery/atmospherics/pipe/simple/green/hidden{
	dir = 4
	},
/obj/structure/cable,
/turf/open/floor/marking/asteroidwarning{
	dir = 1
	},
/area/bigredv3/outside/directions/nw)
"Ro" = (
/turf/open/floor/marking/asteroidwarning{
	dir = 8
	},
/area/bigredv3/outside/directions/nw)
"Ry" = (
/obj/structure/fence/standard/xenoproof,
/turf/open/floor/plating/ground/mars/cavetodirt{
	dir = 4
	},
/area/bigredv3/caves/west)
"RH" = (
/obj/effect/decal/cleanable/dirt,
/obj/structure/cable,
/obj/effect/decal/cleanable/dirt,
/turf/open/floor/marking/asteroidwarning,
/area/bigredv3/outside/directions/nw)
"RO" = (
/obj/structure/cargo_container/green{
	dir = 4
	},
/turf/open/floor/plating,
/area/bigredv3/outside/directions/nw)
"Td" = (
/turf/open/floor/plating/ground/mars/random/dirt,
/area/bigredv3/caves/west)
"Th" = (
/obj/structure/cargo_container/horizontal{
	dir = 4
	},
/turf/open/floor/plating,
/area/bigredv3/outside/directions/nw)
"Ti" = (
/turf/open/floor/marking/asteroidwarning{
	dir = 9
	},
/area/bigredv3/outside/directions/nw)
"Uk" = (
/turf/closed/mineral/smooth/bigred,
/area/bigredv3/caves/rock)
"Un" = (
/turf/open/floor/marking/asteroidwarning{
	dir = 1
	},
/area/bigredv3/outside/directions/nw)
"Uq" = (
/obj/machinery/light{
	dir = 1
	},
/turf/open/floor/plating,
/area/bigredv3/outside/directions/nw)
"Uz" = (
/obj/machinery/light{
	dir = 4
	},
/turf/open/floor/marking/asteroidwarning{
	dir = 1
	},
/area/bigredv3/outside/medical/virology)
"UJ" = (
/obj/effect/decal/cleanable/dirt,
/obj/effect/ai_node,
/turf/open/floor/marking/asteroidwarning{
	dir = 8
	},
/area/bigredv3/outside/directions/nw)
"UO" = (
/obj/machinery/light{
	dir = 8
	},
/turf/open/floor/plating,
/area/bigredv3/outside/directions/nw)
"UP" = (
/obj/effect/spawner/random/engineering/structure/tank/fuelweighted,
/turf/open/floor/plating,
/area/bigredv3/outside/directions/nw)
"Vv" = (
/turf/open/floor/marking/asteroidwarning{
	dir = 9
	},
/area/bigredv3/outside/medical/virology)
"VC" = (
/turf/open/floor/plating/ground/mars/random/cave/rock,
/area/bigredv3/caves/northwest)
"VG" = (
/obj/effect/turf_decal/sandedge,
/turf/open/floor/marking/asteroidwarning{
	dir = 9
	},
/area/bigredv3/outside/directions/nw)
"Wu" = (
/obj/effect/turf_decal/sandedge,
/turf/open/floor/plating/ground/mars/random/sand,
/area/bigredv3/outside/directions/nw)
"WG" = (
/obj/structure/cable,
/obj/effect/ai_node,
/turf/open/floor/asteroidfloor,
/area/bigredv3/outside/directions/nw)
"WS" = (
/obj/machinery/light{
	dir = 8
	},
/turf/open/floor/asteroidfloor,
/area/bigredv3/outside/directions/nw)
"WT" = (
/obj/machinery/atmospherics/pipe/simple/green/hidden,
/turf/open/floor/marking/asteroidwarning{
	dir = 1
	},
/area/bigredv3/outside/directions/nw)
"Xb" = (
/turf/open/floor/plating/ground/mars/random/cave,
/area/bigredv3/caves/northwest)
"Xi" = (
/obj/structure/fence/standard/xenoproof,
/turf/open/floor/plating/ground/mars/random/cave,
/area/bigredv3/caves/west)
"Xr" = (
/turf/open/floor/plating,
/area/bigredv3/outside/directions/nw)
"Xz" = (
/obj/machinery/atmospherics/pipe/simple/green/hidden{
	dir = 10
	},
/obj/structure/cable,
/turf/open/floor/marking/asteroidwarning{
	dir = 5
	},
/area/bigredv3/outside/directions/nw)
"XG" = (
/obj/machinery/atmospherics/pipe/simple/green/hidden,
/turf/open/floor/plating/warning{
	dir = 1
	},
/area/bigredv3/outside/directions/nw)
"XR" = (
/obj/machinery/light{
	dir = 1
	},
/obj/structure/largecrate/random/case/small,
/turf/open/floor/plating,
/area/bigredv3/outside/directions/nw)
"Yd" = (
/obj/effect/decal/cleanable/dirt,
/turf/open/floor/marking/asteroidwarning{
	dir = 8
	},
/area/bigredv3/outside/directions/nw)
"Yf" = (
/obj/structure/rack,
/turf/open/floor/plating,
/area/bigredv3/outside/directions/nw)
"Ys" = (
/obj/effect/spawner/random/misc/structure/barrel,
/obj/effect/decal/cleanable/dirt,
/turf/open/floor/plating,
/area/bigredv3/outside/directions/nw)
"Yw" = (
/obj/effect/decal/cleanable/dirt,
/obj/effect/ai_node,
/turf/open/floor/marking/asteroidwarning{
	dir = 10
	},
/area/bigredv3/outside/directions/nw)
"Yy" = (
/obj/machinery/atmospherics/pipe/simple/green/hidden{
	dir = 4
	},
/obj/structure/cable,
/obj/effect/decal/cleanable/dirt,
/turf/open/floor/plating,
/area/bigredv3/outside/directions/nw)
"YF" = (
/obj/effect/decal/cleanable/dirt,
/turf/open/floor/marking/asteroidwarning{
	dir = 6
	},
/area/bigredv3/outside/directions/nw)
"Za" = (
/obj/structure/cargo_container/horizontal,
/turf/open/floor/plating,
/area/bigredv3/outside/directions/nw)
"Zr" = (
/obj/effect/decal/cleanable/dirt,
/turf/open/floor/asteroidfloor,
/area/bigredv3/outside/directions/nw)

(1,1,1) = {"
lm
lm
lm
lm
lm
lm
lm
lm
lm
lm
lm
lm
lm
lm
lm
lm
lm
lm
lm
lm
lm
lm
"}
(2,1,1) = {"
Uk
Uk
Uk
Uk
Uk
Uk
Uk
Uk
Uk
Uk
Uk
Uk
Uk
Uk
Uk
Uk
Uk
Uk
Uk
Uk
Uk
Uk
"}
(3,1,1) = {"
Uk
Uk
Uk
Uk
Uk
Uk
Uk
Uk
Uk
Uk
Uk
Uk
Uk
Uk
Uk
Uk
DU
DU
DU
DU
Uk
Uk
"}
(4,1,1) = {"
Uk
Uk
Uk
Uk
Uk
Uk
Uk
Uk
Uk
Uk
Uk
Uk
Uk
Uk
Uk
DU
nY
nY
nY
nY
DU
Uk
"}
(5,1,1) = {"
Uk
Uk
Uk
Uk
Uk
Uk
Uk
Uk
Uk
Uk
Uk
Uk
Uk
Uk
DU
nY
nY
nY
nY
nY
nY
DU
"}
(6,1,1) = {"
Uk
Uk
Uk
Uk
Uk
Uk
Uk
Uk
Uk
Uk
Uk
Uk
Uk
Uk
nY
nY
nY
nY
nY
nY
nY
nY
"}
(7,1,1) = {"
Uk
Uk
Uk
Uk
Uk
Uk
Uk
Uk
Uk
Uk
Uk
Uk
Uk
VC
nY
nY
nY
nY
nY
nY
DU
nY
"}
(8,1,1) = {"
Uk
Uk
Uk
Uk
Uk
Uk
Uk
Uk
Xb
Xb
Xb
Xb
Xb
hn
nY
nY
nY
nY
nY
nY
px
nY
"}
(9,1,1) = {"
Uk
Xb
Xb
Xb
Xb
Xb
Xb
Xb
Xb
Xb
Xb
Xb
Xb
Xb
nY
nY
nY
nY
nY
nY
DU
nY
"}
(10,1,1) = {"
Xb
Xb
Xb
Xb
Xb
Xb
Xb
Xb
Xb
Xb
Xb
Xb
VC
Xb
nY
nY
nY
nY
nY
nY
DU
nY
"}
(11,1,1) = {"
Xb
Xb
Xb
Xb
Xb
VC
Xb
Xb
Xb
Xb
Xb
Xb
Xb
Xb
nY
nY
nY
nY
nY
nY
DU
Uk
"}
(12,1,1) = {"
Xb
Xb
VC
VC
Xb
Xb
hn
Xb
Xb
Xb
Xb
hn
Xb
hn
nY
nY
nY
nY
nY
nY
px
Uk
"}
(13,1,1) = {"
VC
Xb
Xb
Xb
Xb
Xb
Xb
Xb
Xb
Xb
Xb
VC
Xb
Xb
nY
nY
nY
nY
nY
nY
nY
DU
"}
(14,1,1) = {"
Xb
Xb
Xb
Xb
Xb
Xb
Uk
Uk
Uk
FO
FG
FG
FG
FO
Uk
Uk
Uk
nY
nY
nY
Hw
DU
"}
(15,1,1) = {"
Xb
Xb
Xb
Xb
Xb
Uk
Uk
Uk
Uk
Gx
Bb
Bb
aE
PU
Uk
Uk
Uk
nY
Uk
Uk
Xi
Ry
"}
(16,1,1) = {"
Xb
Xb
Xb
Uk
Uk
Uk
Uk
Uk
Uk
xu
xu
xu
xu
xu
Uk
Uk
Uk
Uk
Uk
Uk
JE
Td
"}
(17,1,1) = {"
Xb
Xb
Uk
Uk
Uk
Uk
Uk
Uk
Uk
PU
PU
PU
PU
PU
Uk
Uk
Uk
Uk
xu
xu
xu
xu
"}
(18,1,1) = {"
Uk
Uk
Uk
Uk
Uk
Uk
Uk
xu
xu
xu
xu
GX
xu
xu
xu
Uk
Uk
Uk
xu
Dv
Dv
Dv
"}
(19,1,1) = {"
Uk
Uk
Uk
Uk
Uk
Uk
Uk
xu
Qe
Xr
Xr
xH
xH
Xr
xu
xu
xu
xu
xu
Dv
Dv
Dv
"}
(20,1,1) = {"
Uk
Uk
Uk
Uk
Uk
Uk
Uk
xu
Uq
Xr
Xr
Dm
Xr
Xr
Xr
cJ
Th
Za
xu
Dv
AR
Vv
"}
(21,1,1) = {"
Uk
Uk
Uk
Uk
Uk
Uk
Uk
xu
Xr
Xr
Xr
Xr
wr
xH
Xr
Xr
Xr
Xr
xu
zg
Dv
AG
"}
(22,1,1) = {"
Uk
Uk
Uk
Uk
Uk
Uk
Uk
xu
Xr
Xr
Xr
xH
Xr
Dm
xH
Xr
Dm
BO
xu
hy
bJ
AG
"}
(23,1,1) = {"
Uk
Uk
Uk
Uk
Uk
Uk
Uk
xu
Xr
Xr
lM
PY
Xr
Xr
xH
Xr
xH
Xr
xu
hy
hy
AG
"}
(24,1,1) = {"
Uk
Uk
Uk
Uk
Uk
Uk
Uk
xu
Xr
Xr
OU
PY
Xr
Xr
lM
Xr
xH
Xr
Vv
Pe
Pe
ru
"}
(25,1,1) = {"
Uk
Uk
Uk
gK
gK
gK
gK
xu
Xr
Xr
RO
Xr
Xr
Xr
OU
xH
xH
Dm
AG
ru
ru
ru
"}
(26,1,1) = {"
Uk
gK
gK
gK
gK
gK
gK
xu
Xr
Xr
Qe
Xr
Xr
Xr
RO
Xr
Dm
Xr
LU
CG
ri
ru
"}
(27,1,1) = {"
Wu
gK
gK
gK
vL
gK
xu
xu
Xr
Xr
Xr
xH
xH
xH
Ys
xH
Xr
Xr
xu
Dv
Dv
AG
"}
(28,1,1) = {"
VG
Ro
nh
gK
gK
gK
xu
Xr
Xr
xH
Dm
Xr
Dm
Xr
xH
Xr
Dm
Xr
xu
Dv
Dv
AG
"}
(29,1,1) = {"
em
wA
op
gK
gK
gK
xu
Xr
Xr
Xr
xH
xH
Xr
jS
Xr
Xr
Xr
PY
xu
Cg
Dv
AG
"}
(30,1,1) = {"
zV
aC
At
gK
gK
gK
xu
Uq
Xr
xH
xH
Xr
Xr
gN
xH
xH
Xr
oj
xu
Dv
Dv
AG
"}
(31,1,1) = {"
Uk
Un
RH
gK
gK
iW
xu
Xr
Xr
Xr
Xr
Xr
Xr
rw
Xr
Fo
Fo
Gr
xu
Dv
Vv
Pe
"}
(32,1,1) = {"
gK
Un
At
ke
ke
jZ
xu
Xr
Xr
xH
Xr
Xr
PY
Xr
Xr
Fo
Xr
Xr
xu
Dv
Uz
ru
"}
(33,1,1) = {"
gK
Un
jf
Yd
Ro
Yd
CA
xH
xH
Xr
xH
Xr
Xr
Xr
xH
lf
kv
rf
xu
xu
xu
ru
"}
(34,1,1) = {"
gK
Un
WG
kD
kD
kD
At
ph
dx
Fo
CY
pR
pR
pR
pR
Bl
nU
Gu
Yw
jZ
sq
wA
"}
(35,1,1) = {"
iW
Un
wA
wA
wA
Fq
YF
Xr
Xr
Xr
Yy
Xr
Xr
Xr
Xr
BA
Zr
gb
HV
jZ
JW
Fq
"}
(36,1,1) = {"
EA
Un
Zr
Zr
YF
jZ
xu
Xr
so
xH
bw
xH
Xr
Xr
Xr
PR
qd
NF
HV
jZ
jZ
Un
"}
(37,1,1) = {"
EA
BA
wA
HV
jZ
xT
xu
xu
xu
kW
Ov
kW
xu
xu
xu
xu
jZ
Qm
HV
jZ
jZ
Un
"}
(38,1,1) = {"
EA
Un
wA
HV
JY
gK
xu
UP
Xr
Xr
bw
Xr
UO
Xr
Xr
xu
jZ
Qm
op
jZ
jZ
Un
"}
(39,1,1) = {"
EA
Un
wA
op
JY
gK
xu
XR
Xr
Xr
bw
Xr
cJ
Th
Za
xu
jZ
Qm
wA
Yd
Ro
wA
"}
(40,1,1) = {"
UJ
wA
Gv
HV
JY
gK
xu
Xr
Xr
Xr
bw
Xr
Xr
Xr
Xr
xu
jZ
Xz
xJ
eX
eX
uB
"}
(41,1,1) = {"
Zr
wA
Zr
op
JY
gK
xu
Xr
Xr
Xr
bw
Xr
cJ
Th
Za
xu
xT
xT
xT
xT
jZ
jZ
"}
(42,1,1) = {"
Fq
Fq
qd
YF
JY
gK
xu
Xr
Xr
Xr
bw
Xr
Xr
Xr
Xr
xu
gK
gK
gK
gK
jc
xT
"}
(43,1,1) = {"
jZ
jZ
jZ
jZ
jZ
gK
xu
Xr
Xr
Xr
bw
Xr
Xr
Xr
Xr
xu
gK
vL
gK
gK
gK
gK
"}
(44,1,1) = {"
jZ
jZ
jZ
jZ
jZ
Ti
xu
Uq
Xr
Xr
bw
Xr
Xr
Xr
pG
xu
gK
gK
gK
gK
gK
gK
"}
(45,1,1) = {"
Ro
Ro
Ro
Ro
Ro
Un
hT
Xr
Xr
Xr
bw
Xr
Xr
Xr
Xr
xu
gK
gK
pS
gK
gK
gK
"}
(46,1,1) = {"
jf
jf
WG
jf
WG
aC
Pb
Fo
Xr
Xr
bZ
Xr
Xr
Xr
Xr
xu
gK
gK
gK
gK
gK
gK
"}
(47,1,1) = {"
tZ
tZ
tZ
tZ
tZ
WT
XG
zR
zR
zR
hX
Xr
Xr
Xr
Yf
xu
gK
gK
gK
gK
gK
gK
"}
(48,1,1) = {"
xT
xT
jZ
jZ
jZ
JW
xu
zy
Xr
Xr
bw
Xr
Xr
Xr
Xr
xu
gK
gK
gK
gK
gK
gK
"}
(49,1,1) = {"
gK
gK
jc
xT
xT
xT
xu
XR
Xr
Xr
bw
Xr
Xr
Xr
BO
xu
gK
vL
gK
gK
gK
gK
"}
(50,1,1) = {"
gK
gK
vL
gK
gK
gK
xu
zy
Xr
Xr
bw
Xr
cJ
Th
Za
xu
gK
gK
gK
gK
gK
gK
"}
(51,1,1) = {"
gK
gK
gK
gK
gK
gK
xu
Xr
Xr
Xr
bw
Xr
Xr
Xr
Xr
xu
gK
gK
gK
gK
gK
gK
"}
(52,1,1) = {"
gK
gK
gK
gK
gK
gK
xu
Xr
so
Xr
bw
Xr
so
Xr
Xr
xu
gK
gK
gK
gK
gK
ml
"}
(53,1,1) = {"
gK
gK
gK
gK
gK
gK
xu
xu
xu
xc
rV
xu
xu
xu
xu
xu
gK
gK
gK
gK
gK
gK
"}
(54,1,1) = {"
gK
gK
gK
gK
gK
gK
Un
WS
wA
wA
gb
wA
wA
WS
wA
op
gK
gK
pS
gK
gK
gK
"}
