//MAP CONVERTED BY dmm2tgm.py THIS HEADER COMMENT PREVENTS RECONVERSION, DO NOT REMOVE
"ax" = (
/obj/effect/decal/cleanable/dirt,
/obj/machinery/door/airlock/multi_tile/mainship/generic{
	name = "\improper Engineering Complex"
	},
/turf/open/floor,
/area/bigredv3/inside/engi/west)
"bo" = (
/obj/effect/decal/cleanable/dirt,
/obj/machinery/atmospherics/pipe/simple/green/hidden{
	dir = 5
	},
/obj/structure/cable,
/turf/open/floor,
/area/bigredv3/inside/engi/west)
"bK" = (
/obj/structure/table,
/obj/effect/spawner/random/engineering/powercell,
/turf/open/floor,
/area/bigredv3/inside/engi/west)
"bO" = (
/obj/structure/bed/chair/office/light,
/turf/open/floor,
/area/bigredv3/inside/engi)
"cx" = (
/obj/machinery/atmospherics/pipe/simple/green/hidden{
	dir = 10
	},
/obj/structure/cable,
/turf/open/floor,
/area/bigredv3/inside/engi/west)
"dk" = (
/obj/machinery/atmospherics/pipe/manifold/green/hidden{
	dir = 4
	},
/obj/effect/ai_node,
/obj/structure/cable,
/turf/open/floor,
/area/bigredv3/inside/engi/west)
"dz" = (
/obj/effect/spawner/random/engineering/structure/tank/waterweighted,
/obj/effect/decal/cleanable/dirt,
/obj/machinery/light{
	dir = 4
	},
/turf/open/floor,
/area/bigredv3/inside/engi/fabrication)
"dI" = (
/obj/machinery/atmospherics/pipe/simple/green/hidden,
/obj/machinery/door/airlock/mainship/engineering/free_access{
	dir = 1;
	name = "\improper Chief Engineer's Office"
	},
/obj/structure/cable,
/turf/open/floor,
/area/bigredv3/inside/engi/ceo)
"dZ" = (
/turf/open/floor/plating/ground/mars/random/sand,
/area/bigredv3/outside/directions/s)
"fe" = (
/obj/machinery/light{
	dir = 1
	},
/obj/machinery/atmospherics/pipe/simple/green/hidden{
	dir = 4
	},
/obj/structure/cable,
/turf/open/floor,
/area/bigredv3/inside/engi/west)
"fh" = (
/obj/effect/decal/cleanable/dirt,
/obj/effect/spawner/random/machinery/machine_frame,
/turf/open/floor,
/area/bigredv3/inside/engi/west)
"gi" = (
/turf/open/floor/plating/ground/mars/random/dirt,
/area/bigredv3/outside/directions/sw)
"hx" = (
/obj/effect/decal/cleanable/dirt,
/obj/machinery/atmospherics/pipe/simple/green/hidden{
	dir = 4
	},
/obj/structure/cable,
/turf/open/floor,
/area/bigredv3/inside/engi/west)
"hH" = (
/turf/open/floor/plating/ground/mars/dirttosand/autosmooth{
	dir = 5
	},
/area/bigredv3/caves/southwest)
"if" = (
/obj/machinery/door/airlock/mainship/engineering/free_access{
	dir = 1;
	name = "\improper Engine Reactor Control"
	},
/obj/machinery/atmospherics/pipe/simple/green/hidden,
/turf/open/floor,
/area/bigredv3/inside/engi)
"jb" = (
/obj/structure/cable,
/turf/open/floor,
/area/bigredv3/inside/engi/fabrication)
"ke" = (
/turf/open/floor/plating/ground/mars/cavetodirt{
	dir = 4
	},
/area/bigredv3/caves/southwest)
"ko" = (
/obj/effect/spawner/random/engineering/structure/tank/fuelweighted,
/turf/open/floor,
/area/bigredv3/inside/engi/fabrication)
"ks" = (
/turf/open/floor/plating/ground/mars/cavetodirt{
	dir = 9
	},
/area/bigredv3/caves/southwest)
"kv" = (
/obj/machinery/atmospherics/pipe/simple/green/hidden,
/obj/structure/cable,
/turf/open/floor,
/area/bigredv3/inside/engi/ceo)
"ky" = (
/obj/machinery/atmospherics/pipe/simple/green/hidden{
	dir = 4
	},
/obj/effect/decal/cleanable/dirt,
/obj/structure/cable,
/turf/open/floor,
/area/bigredv3/inside/engi/west)
"lx" = (
/obj/machinery/power/monitor{
	name = "Main Power Grid Monitoring"
	},
/turf/open/floor,
/area/bigredv3/inside/engi)
"mi" = (
/obj/machinery/atmospherics/pipe/simple/green/hidden,
/obj/machinery/power/apc/weak/ntf{
	dir = 8
	},
/obj/structure/cable,
/turf/open/floor,
/area/bigredv3/inside/engi/west)
"mN" = (
/obj/effect/decal/cleanable/dirt,
/obj/effect/ai_node,
/turf/open/floor,
/area/bigredv3/inside/engi/west)
"nF" = (
/obj/structure/table,
/obj/effect/spawner/random/engineering/toolbox,
/turf/open/floor,
/area/bigredv3/inside/engi/west)
"nY" = (
/obj/machinery/atmospherics/pipe/manifold/green/hidden{
	dir = 8
	},
/obj/effect/ai_node,
/obj/structure/cable,
/turf/open/floor,
/area/bigredv3/inside/engi/west)
"oX" = (
/obj/effect/decal/cleanable/dirt,
/obj/machinery/atmospherics/pipe/simple/green/hidden{
	dir = 4
	},
/obj/effect/ai_node,
/obj/structure/cable,
/turf/open/floor,
/area/bigredv3/inside/engi/west)
"pe" = (
/turf/open/floor/marking/asteroidwarning{
	dir = 4
	},
/area/bigredv3/outside/directions/central)
"pq" = (
/obj/machinery/atmospherics/pipe/simple/green/hidden{
	dir = 9
	},
/obj/effect/ai_node,
/obj/structure/cable,
/turf/open/floor,
/area/bigredv3/inside/engi/west)
"pQ" = (
/turf/open/floor/plating/ground/mars/dirttosand/autosmooth{
	dir = 9
	},
/area/bigredv3/caves/southwest)
"pV" = (
/obj/effect/decal/cleanable/dirt,
/obj/effect/decal/cleanable/blood/oil,
/turf/open/floor,
/area/bigredv3/inside/engi/west)
"pX" = (
/obj/structure/bed/chair{
	dir = 4
	},
/turf/open/floor,
/area/bigredv3/inside/engi/west)
"qd" = (
/obj/effect/ai_node,
/turf/open/floor/plating/ground/mars/random/dirt,
/area/bigredv3/caves/southwest)
"qy" = (
/obj/structure/closet/radiation,
/turf/open/floor,
/area/bigredv3/inside/engi/west)
"qN" = (
/obj/machinery/light{
	dir = 4
	},
/obj/effect/decal/cleanable/dirt,
/turf/open/floor,
/area/bigredv3/inside/engi/west)
"rL" = (
/obj/machinery/computer/atmos_alert,
/obj/structure/table,
/turf/open/floor,
/area/bigredv3/inside/engi)
"rN" = (
/obj/machinery/vending/cigarette/colony,
/turf/open/floor,
/area/bigredv3/inside/engi/west)
"rX" = (
/obj/machinery/atmospherics/pipe/simple/green/hidden,
/obj/structure/cable,
/turf/open/floor,
/area/bigredv3/inside/engi/fabrication)
"se" = (
/obj/machinery/atmospherics/pipe/simple/green/hidden,
/obj/effect/decal/cleanable/dirt,
/obj/structure/cable,
/turf/open/floor,
/area/bigredv3/inside/engi/west)
"sl" = (
/turf/open/floor/plating/ground/mars/cavetodirt{
	dir = 10
	},
/area/bigredv3/caves/southwest)
"sG" = (
/obj/effect/ai_node,
/turf/open/floor/plating/ground/mars/cavetodirt{
	dir = 8
	},
/area/bigredv3/caves/southwest)
"sV" = (
/obj/structure/table,
/turf/open/floor,
/area/bigredv3/inside/engi/ceo)
"ta" = (
/obj/effect/decal/cleanable/dirt,
/obj/item/tool/weldpack,
/turf/open/floor,
/area/bigredv3/inside/engi/west)
"tr" = (
/obj/machinery/atmospherics/pipe/simple/green/hidden{
	dir = 4
	},
/obj/machinery/door/airlock/multi_tile/mainship/generic{
	dir = 1;
	name = "\improper Engineering Complex"
	},
/obj/structure/cable,
/turf/open/floor,
/area/bigredv3/inside/engi/west)
"tu" = (
/obj/structure/table,
/obj/effect/spawner/random/engineering/tool,
/obj/machinery/light{
	dir = 4
	},
/turf/open/floor,
/area/bigredv3/inside/engi/fabrication)
"tF" = (
/turf/open/floor/plating/ground/mars/dirttosand/autosmooth{
	dir = 4
	},
/area/bigredv3/caves/southwest)
"tG" = (
/obj/machinery/atmospherics/pipe/manifold/green/hidden{
	dir = 8
	},
/obj/structure/cable,
/turf/open/floor,
/area/bigredv3/inside/engi/west)
"ub" = (
/obj/effect/decal/cleanable/dirt,
/obj/machinery/door/airlock/mainship/secure/free_access{
	name = "\improper Engineering Secure Storage"
	},
/obj/structure/cable,
/turf/open/floor,
/area/bigredv3/inside/engi/fabrication)
"uD" = (
/obj/machinery/atmospherics/pipe/manifold/green/hidden{
	dir = 4
	},
/obj/structure/cable,
/turf/open/floor,
/area/bigredv3/inside/engi/locker_room)
"vs" = (
/obj/effect/ai_node,
/turf/open/floor/plating/ground/mars/random/cave,
/area/bigredv3/caves/southwest)
"vN" = (
/obj/structure/bed/chair/office/light{
	dir = 8
	},
/turf/open/floor,
/area/bigredv3/inside/engi)
"vS" = (
/obj/machinery/atmospherics/pipe/simple/green/hidden,
/obj/effect/ai_node,
/obj/structure/cable,
/turf/open/floor,
/area/bigredv3/inside/engi/west)
"wd" = (
/turf/open/floor,
/area/bigredv3/inside/engi/west)
"wK" = (
/obj/machinery/atmospherics/pipe/simple/green/hidden{
	dir = 5
	},
/obj/effect/ai_node,
/obj/structure/cable,
/turf/open/floor,
/area/bigredv3/inside/engi/west)
"xd" = (
/obj/machinery/floodlight/outpost/bigred,
/turf/open/floor/plating/ground/mars/random/dirt,
/area/bigredv3/outside/directions/sw)
"xD" = (
/obj/effect/decal/cleanable/dirt,
/obj/structure/sign/safety/electronics{
	dir = 1
	},
/turf/open/floor,
/area/bigredv3/inside/engi/fabrication)
"xM" = (
/turf/open/floor/plating/ground/mars/random/sand,
/area/bigredv3/outside/directions/central)
"yb" = (
/obj/structure/bed/chair{
	dir = 8
	},
/turf/open/floor,
/area/bigredv3/inside/engi/west)
"yc" = (
/obj/effect/decal/cleanable/dirt,
/obj/machinery/air_alarm{
	dir = 1
	},
/turf/open/floor,
/area/bigredv3/inside/engi/west)
"yu" = (
/obj/machinery/door/airlock/mainship/engineering/free_access{
	name = "\improper Engine Reactor Control"
	},
/turf/open/floor,
/area/bigredv3/inside/engi)
"zc" = (
/turf/open/floor/plating/ground/mars/random/cave/rock,
/area/bigredv3/caves/southwest)
"ze" = (
/turf/open/floor/plating/ground/mars/dirttosand/autosmooth,
/area/bigredv3/caves/southwest)
"zl" = (
/turf/open/floor/plating/ground/mars/dirttosand/autosmooth{
	dir = 8
	},
/area/bigredv3/caves/southwest)
"zo" = (
/turf/open/floor/plating/ground/mars/dirttosand/autosmooth{
	dir = 1
	},
/area/bigredv3/caves/southwest)
"Aq" = (
/obj/effect/landmark/start/job/survivor,
/obj/effect/landmark/start/latejoinsurvivor,
/turf/open/floor,
/area/bigredv3/inside/engi/west)
"Au" = (
/obj/effect/ai_node,
/turf/open/floor/plating/ground/mars/random/sand,
/area/bigredv3/caves/southwest)
"AW" = (
/obj/machinery/computer/area_atmos,
/turf/open/floor,
/area/bigredv3/inside/engi/west)
"Bb" = (
/obj/machinery/vending/snack,
/turf/open/floor,
/area/bigredv3/inside/engi/west)
"Be" = (
/obj/structure/bed/chair/office/light{
	dir = 4
	},
/turf/open/floor,
/area/bigredv3/inside/engi/west)
"BS" = (
/obj/machinery/computer/arcade,
/turf/open/floor,
/area/bigredv3/inside/engi/west)
"Cu" = (
/obj/machinery/atmospherics/pipe/simple/green/hidden,
/obj/machinery/door/airlock/mainship/engineering/free_access{
	dir = 1;
	name = "\improper Engineering Tool Storage"
	},
/obj/structure/cable,
/turf/open/floor,
/area/bigredv3/inside/engi/fabrication)
"CC" = (
/obj/structure/rack,
/obj/item/camera_film,
/turf/open/floor,
/area/bigredv3/inside/engi/west)
"CK" = (
/obj/machinery/floodlight/outpost/bigred,
/turf/open/floor/plating/ground/mars/random/cave,
/area/bigredv3/caves/southwest)
"CX" = (
/turf/closed/wall/r_wall,
/area/bigredv3/inside/wall)
"De" = (
/obj/machinery/power/apc/weak/ntf{
	dir = 4
	},
/obj/structure/cable,
/turf/open/floor,
/area/bigredv3/inside/engi/fabrication)
"Dp" = (
/turf/open/floor/plating/ground/mars/random/dirt,
/area/bigredv3/outside/directions/s)
"Dw" = (
/turf/open/floor/plating/ground/mars/cavetodirt{
	dir = 1
	},
/area/bigredv3/caves/southwest)
"DP" = (
/obj/structure/table,
/obj/effect/spawner/random/engineering/tool,
/turf/open/floor,
/area/bigredv3/inside/engi)
"Ed" = (
/obj/machinery/atmospherics/pipe/simple/green/hidden,
/turf/open/floor,
/area/bigredv3/inside/engi)
"Ej" = (
/obj/effect/decal/cleanable/dirt,
/obj/structure/cable,
/turf/open/floor,
/area/bigredv3/inside/engi/fabrication)
"Fe" = (
/obj/machinery/atmospherics/pipe/simple/green/hidden,
/obj/structure/cable,
/turf/open/floor,
/area/bigredv3/inside/engi/west)
"Fi" = (
/obj/machinery/atmospherics/pipe/simple/green/hidden,
/obj/effect/ai_node,
/obj/structure/cable,
/turf/open/floor,
/area/bigredv3/inside/engi/fabrication)
"Fk" = (
/obj/machinery/light{
	dir = 8
	},
/turf/open/floor,
/area/bigredv3/inside/engi/fabrication)
"Ga" = (
/obj/structure/table,
/obj/effect/spawner/random/engineering/toolbox,
/obj/effect/decal/cleanable/dirt,
/turf/open/floor,
/area/bigredv3/inside/engi/west)
"Gg" = (
/obj/machinery/floodlight/outpost/bigred,
/turf/open/floor/plating/ground/mars/random/dirt,
/area/bigredv3/caves/southwest)
"Gm" = (
/obj/effect/ai_node,
/obj/structure/cable,
/turf/open/floor,
/area/bigredv3/inside/engi/fabrication)
"GR" = (
/obj/effect/decal/cleanable/dirt,
/turf/open/floor,
/area/bigredv3/inside/engi/west)
"Hk" = (
/obj/machinery/floodlight/outpost/bigred,
/turf/open/floor/plating/ground/mars/random/sand,
/area/bigredv3/caves/southwest)
"HC" = (
/obj/structure/table,
/obj/effect/spawner/random/engineering/toolbox,
/turf/open/floor,
/area/bigredv3/inside/engi/fabrication)
"HQ" = (
/obj/effect/decal/cleanable/dirt,
/obj/machinery/atmospherics/components/unary/vent_pump{
	dir = 1;
	on = 1
	},
/turf/open/floor,
/area/bigredv3/inside/engi/west)
"Ih" = (
/obj/structure/table,
/obj/effect/spawner/random/engineering/tool,
/turf/open/floor,
/area/bigredv3/inside/engi/fabrication)
"IN" = (
/obj/machinery/vending/cola,
/turf/open/floor,
/area/bigredv3/inside/engi/west)
"Jq" = (
/obj/machinery/atmospherics/pipe/simple/green/hidden,
/turf/open/floor,
/area/bigredv3/inside/engi/west)
"Jw" = (
/obj/structure/table,
/obj/item/tool/lighter/random,
/turf/open/floor,
/area/bigredv3/inside/engi/fabrication)
"Jx" = (
/obj/machinery/door/airlock/mainship/engineering/free_access{
	dir = 1;
	name = "\improper Engineering SMES"
	},
/turf/open/floor/plating,
/area/bigredv3/inside/engi/fabrication)
"JS" = (
/obj/machinery/bot/mulebot,
/turf/open/floor,
/area/bigredv3/inside/engi/west)
"JZ" = (
/obj/effect/spawner/random/machinery/machine_frame,
/turf/open/floor,
/area/bigredv3/inside/engi/west)
"Ke" = (
/turf/open/floor,
/area/bigredv3/inside/engi/locker_room)
"Ky" = (
/turf/open/floor/plating/ground/mars/random/dirt,
/area/bigredv3/caves/southwest)
"Kz" = (
/obj/structure/table,
/obj/item/tool/lighter/random,
/obj/item/lightreplacer,
/turf/open/floor,
/area/bigredv3/inside/engi/west)
"KR" = (
/obj/effect/decal/cleanable/dirt,
/obj/item/lightreplacer,
/turf/open/floor,
/area/bigredv3/inside/engi/west)
"LP" = (
/obj/machinery/computer/station_alert,
/obj/structure/table,
/turf/open/floor,
/area/bigredv3/inside/engi)
"LU" = (
/obj/machinery/atmospherics/pipe/simple/green/hidden{
	dir = 4
	},
/obj/structure/cable,
/turf/open/floor,
/area/bigredv3/inside/engi/west)
"LW" = (
/turf/open/floor,
/area/bigredv3/inside/engi/fabrication)
"Mx" = (
/obj/structure/table,
/obj/effect/decal/cleanable/dirt,
/obj/item/clothing/glasses/welding,
/turf/open/floor,
/area/bigredv3/inside/engi/west)
"MU" = (
/obj/machinery/atmospherics/pipe/manifold/green/hidden{
	dir = 1
	},
/obj/effect/ai_node,
/obj/structure/cable,
/turf/open/floor,
/area/bigredv3/inside/engi/west)
"Ne" = (
/obj/machinery/atmospherics/pipe/manifold/green/hidden,
/obj/effect/ai_node,
/obj/structure/cable,
/turf/open/floor,
/area/bigredv3/inside/engi/west)
"Nr" = (
/turf/open/floor/plating/ground/mars/dirttosand/autosmooth{
	dir = 9
	},
/area/bigredv3/outside/directions/s)
"NI" = (
/obj/machinery/atmospherics/pipe/simple/green/hidden{
	dir = 4
	},
/obj/machinery/door/airlock/mainship/engineering/free_access{
	name = "\improper Engineering Workshop"
	},
/obj/structure/cable,
/turf/open/floor,
/area/bigredv3/inside/engi/west)
"NS" = (
/turf/open/floor/plating/ground/mars/random/sand,
/area/bigredv3/outside/directions/sw)
"OK" = (
/turf/open/floor,
/area/bigredv3/inside/engi)
"Pd" = (
/obj/structure/table,
/obj/effect/spawner/random/misc/earmuffs,
/turf/open/floor,
/area/bigredv3/inside/engi/west)
"Pi" = (
/obj/effect/decal/cleanable/dirt,
/turf/open/floor,
/area/bigredv3/inside/engi/fabrication)
"Pw" = (
/obj/machinery/door_control{
	desc = "A remote control-switch for opening the engines blast doors.";
	dir = 8;
	id = "rad_door";
	name = "Reactor Radiation Shielding control"
	},
/turf/open/floor,
/area/bigredv3/inside/engi)
"PB" = (
/turf/open/floor,
/area/bigredv3/inside/engi/ceo)
"PT" = (
/obj/effect/decal/cleanable/dirt,
/obj/machinery/atmospherics/components/unary/vent_pump{
	dir = 1;
	on = 1
	},
/turf/open/floor,
/area/bigredv3/inside/engi)
"PW" = (
/turf/open/floor/plating/ground/mars/dirttosand/autosmooth{
	dir = 8
	},
/area/bigredv3/outside/directions/sw)
"Qe" = (
/turf/closed/wall,
/area/bigredv3/inside/wall)
"Qv" = (
/obj/structure/rack,
/obj/item/tool/analyzer,
/turf/open/floor,
/area/bigredv3/inside/engi/west)
"QY" = (
/obj/structure/table,
/obj/effect/spawner/random/engineering/tool,
/obj/effect/spawner/random/engineering/technology_scanner,
/turf/open/floor,
/area/bigredv3/inside/engi/fabrication)
"Rp" = (
/obj/effect/decal/cleanable/dirt,
/turf/open/floor,
/area/bigredv3/inside/engi)
"RB" = (
/turf/open/floor/plating/ground/mars/random/cave,
/area/bigredv3/caves/southwest)
"RM" = (
/obj/effect/decal/cleanable/dirt,
/obj/structure/sign/safety/electronics{
	dir = 1
	},
/obj/structure/cable,
/turf/open/floor,
/area/bigredv3/inside/engi/fabrication)
"RR" = (
/obj/effect/decal/cleanable/dirt,
/obj/item/clothing/mask/breath,
/turf/open/floor,
/area/bigredv3/inside/engi/west)
"Sv" = (
/obj/structure/window/framed/colony,
/turf/open/floor/plating,
/area/bigredv3/inside/wall)
"Sw" = (
/obj/machinery/atmospherics/components/unary/vent_pump,
/turf/open/floor,
/area/bigredv3/inside/engi/locker_room)
"SH" = (
/obj/structure/table,
/obj/machinery/light,
/obj/effect/spawner/random/engineering/tool,
/turf/open/floor,
/area/bigredv3/inside/engi/west)
"ST" = (
/obj/machinery/floodlight/outpost/bigred,
/turf/open/floor/plating/ground/mars/random/dirt,
/area/bigredv3/outside/directions/s)
"SV" = (
/turf/open/floor/plating/ground/mars/cavetodirt{
	dir = 8
	},
/area/bigredv3/caves/southwest)
"SZ" = (
/obj/machinery/atmospherics/components/unary/vent_pump{
	dir = 8;
	on = 1
	},
/turf/open/floor,
/area/bigredv3/inside/engi/west)
"Ta" = (
/obj/effect/ai_node,
/turf/open/floor/plating/ground/mars/dirttosand/autosmooth{
	dir = 5
	},
/area/bigredv3/caves/southwest)
"TA" = (
/obj/machinery/light{
	dir = 8
	},
/turf/open/floor,
/area/bigredv3/inside/engi/west)
"Ul" = (
/obj/machinery/light{
	dir = 8
	},
/obj/effect/spawner/random/misc/structure/supplycrate,
/turf/open/floor,
/area/bigredv3/inside/engi/fabrication)
"Va" = (
/obj/machinery/atmospherics/pipe/simple/green/hidden,
/obj/machinery/door/airlock/mainship/engineering/free_access{
	dir = 1;
	name = "\improper Engineering Lockers"
	},
/obj/structure/cable,
/turf/open/floor,
/area/bigredv3/inside/engi/locker_room)
"Vb" = (
/obj/effect/ai_node,
/turf/open/floor/plating/ground/mars/random/dirt,
/area/bigredv3/outside/directions/sw)
"VP" = (
/obj/structure/table,
/obj/effect/decal/cleanable/dirt,
/obj/item/tool/pen,
/turf/open/floor,
/area/bigredv3/inside/engi/west)
"Wy" = (
/obj/effect/decal/cleanable/dirt,
/obj/item/clothing/head/welding,
/turf/open/floor,
/area/bigredv3/inside/engi/west)
"Xh" = (
/obj/structure/bed/chair{
	dir = 4
	},
/obj/effect/decal/cleanable/dirt,
/turf/open/floor,
/area/bigredv3/inside/engi/west)
"Xz" = (
/obj/structure/table,
/obj/effect/spawner/random/engineering/tool,
/obj/effect/spawner/random/engineering/technology_scanner,
/turf/open/floor,
/area/bigredv3/inside/engi/west)
"XC" = (
/obj/effect/decal/cleanable/dirt,
/obj/machinery/atmospherics/pipe/simple/green/hidden,
/turf/open/floor,
/area/bigredv3/inside/engi/west)
"XI" = (
/obj/machinery/door_control{
	dir = 1;
	id = "Engineering";
	name = "Storm Shutters"
	},
/turf/open/floor,
/area/bigredv3/inside/engi/west)
"XU" = (
/obj/structure/table,
/obj/item/tool/analyzer,
/turf/open/floor,
/area/bigredv3/inside/engi)
"Yb" = (
/turf/open/floor/plating/ground/mars/cavetodirt{
	dir = 5
	},
/area/bigredv3/caves/southwest)
"Yh" = (
/obj/structure/table,
/obj/effect/spawner/random/engineering/tool,
/obj/item/stack/sheet/metal{
	amount = 30
	},
/turf/open/floor,
/area/bigredv3/inside/engi/west)
"Yo" = (
/obj/structure/table,
/obj/item/tool/lighter/random,
/turf/open/floor,
/area/bigredv3/inside/engi/west)
"Yr" = (
/turf/open/floor/plating/ground/mars/random/sand,
/area/bigredv3/caves/southwest)
"Zj" = (
/obj/structure/table,
/obj/machinery/light{
	dir = 8
	},
/obj/effect/spawner/random/engineering/technology_scanner,
/turf/open/floor,
/area/bigredv3/inside/engi)
"ZD" = (
/turf/closed/mineral/smooth/bigred,
/area/bigredv3/caves/rock)

(1,1,1) = {"
Ke
Sw
uD
Va
Fe
nY
XC
Jq
XC
HQ
JZ
CX
NS
NS
NS
ZD
ZD
RB
RB
RB
RB
RB
RB
RB
RB
RB
RB
"}
(2,1,1) = {"
CX
CX
CX
CX
Qe
LU
GR
wd
GR
wd
fh
CX
PW
PW
PW
gi
ZD
ke
ke
ke
ke
ke
ke
RB
zc
CK
RB
"}
(3,1,1) = {"
Qe
xD
Ul
De
Qe
LU
wd
Be
wd
wd
SH
CX
Vb
gi
gi
gi
gi
qd
Ky
Ky
Ky
Ky
qd
Dw
vs
zc
RB
"}
(4,1,1) = {"
Jx
Gm
jb
Ej
Qe
LU
Ga
bK
VP
GR
Yh
CX
gi
gi
xd
gi
gi
Ky
Ky
Ky
Gg
Ky
Ky
Dw
RB
RB
RB
"}
(5,1,1) = {"
Qe
RM
LW
LW
Qe
NI
Sv
Sv
Sv
CX
CX
CX
ZD
gi
gi
gi
gi
Ky
Ky
Ky
Ky
Ky
ks
RB
RB
ZD
ZD
"}
(6,1,1) = {"
Qe
jb
dz
ko
Qe
LU
wd
GR
wd
qy
qy
CX
ZD
ZD
ZD
ZD
ZD
tF
tF
tF
Ky
Ky
Dw
RB
ZD
ZD
ZD
"}
(7,1,1) = {"
Qe
ub
Qe
Qe
Qe
oX
wd
wd
mN
wd
wd
CX
ZD
ZD
ZD
ZD
ZD
Yr
Yr
Yr
zo
Ky
Yb
ke
ZD
ZD
ZD
"}
(8,1,1) = {"
Fk
Ej
Qe
Qv
CC
LU
wd
wd
wd
wd
wd
CX
ZD
ZD
ZD
ZD
ZD
Yr
Yr
Yr
zo
Ky
Ky
Ky
Yb
RB
ZD
"}
(9,1,1) = {"
LW
Ej
Sv
wd
wd
hx
JS
wd
JS
wd
wd
CX
ZD
ZD
ZD
ZD
Yr
Au
pQ
zl
Ky
qd
Ky
Ky
Ky
Yb
RB
"}
(10,1,1) = {"
LW
Ej
Sv
wd
RR
hx
ta
wd
wd
wd
wd
CX
ZD
ZD
ZD
Hk
Yr
pQ
Ky
tF
tF
ZD
sG
sl
Ky
qd
Yb
"}
(11,1,1) = {"
rX
Fi
Cu
nY
Fe
pq
wd
wd
wd
wd
wd
CX
ZD
ZD
Yr
Yr
pQ
qd
ze
Yr
Yr
ZD
ZD
CK
SV
sl
Ky
"}
(12,1,1) = {"
Pi
Pi
Sv
ky
GR
GR
GR
qN
GR
qy
qy
CX
ZD
ZD
Yr
Yr
zo
Ky
ze
Yr
ZD
ZD
ZD
ZD
RB
RB
SV
"}
(13,1,1) = {"
Pi
Jw
Sv
ky
GR
Qe
Qe
Qe
yu
Qe
Qe
CX
ZD
ZD
Yr
Yr
zo
Ky
ze
ZD
ZD
ZD
ZD
ZD
zc
RB
zc
"}
(14,1,1) = {"
LW
Ih
Qe
LU
wd
Qe
Zj
DP
OK
OK
LP
CX
ZD
ZD
ZD
Yr
zo
Ky
ze
ZD
ZD
ZD
ZD
ZD
ZD
RB
RB
"}
(15,1,1) = {"
LW
HC
Sv
ky
KR
Qe
OK
vN
Rp
bO
DP
CX
ZD
ZD
ZD
Yr
zo
Ky
ze
ZD
ZD
ZD
ZD
ZD
ZD
vs
RB
"}
(16,1,1) = {"
tu
QY
Sv
MU
XC
if
Ed
Ed
PT
OK
lx
CX
ZD
ZD
ZD
Yr
zo
Ky
ze
ZD
ZD
ZD
ZD
ZD
ZD
RB
RB
"}
(17,1,1) = {"
Qe
Qe
Qe
fe
yc
Qe
Rp
Rp
Rp
bO
XU
CX
ZD
ZD
ZD
ZD
zo
Ky
ze
ZD
ZD
ZD
ZD
ZD
zc
RB
RB
"}
(18,1,1) = {"
sV
Sv
TA
LU
GR
Qe
OK
Pw
OK
OK
rL
CX
ZD
ZD
ZD
Hk
zo
Ky
ze
Yr
ZD
ZD
ZD
ZD
CK
zc
RB
"}
(19,1,1) = {"
PB
Sv
wd
LU
XI
Qe
Qe
Qe
yu
Qe
Qe
CX
ZD
ZD
Yr
Yr
zo
Ky
ze
Yr
ZD
ZD
ZD
RB
RB
RB
RB
"}
(20,1,1) = {"
PB
Sv
wd
LU
GR
wd
wd
TA
wd
GR
wd
CX
ZD
Yr
Yr
Yr
hH
Ky
Ky
zl
Yb
RB
zc
RB
RB
RB
RB
"}
(21,1,1) = {"
kv
dI
Fe
Ne
Xh
pX
pX
GR
wd
GR
wd
CX
ZD
Au
Yr
Yr
Yr
Ta
Ky
Ky
qd
Yb
ke
ke
ke
vs
RB
"}
(22,1,1) = {"
PB
Sv
wd
LU
Mx
Xz
Kz
GR
wd
wd
wd
CX
ZD
Yr
Yr
Yr
Yr
Yr
hH
tF
Ky
Ky
Ky
Ky
Ky
Dw
RB
"}
(23,1,1) = {"
Qe
Qe
Aq
LU
nF
Pd
Yo
wd
wd
wd
AW
CX
ZD
Yr
Yr
Yr
ZD
ZD
Yr
Yr
zo
Ky
Ky
Ky
Ky
Dw
RB
"}
(24,1,1) = {"
GR
ax
wd
LU
yb
yb
yb
GR
GR
wd
wd
CX
ZD
ZD
Yr
Yr
ZD
ZD
ZD
Yr
zo
Ky
Ky
Ky
Ky
Dw
RB
"}
(25,1,1) = {"
se
se
Fe
dk
mi
Fe
tG
bo
mN
wd
wd
CX
CX
ZD
ZD
ZD
ZD
ZD
ZD
Hk
zo
Ky
Ky
ks
SV
RB
zc
"}
(26,1,1) = {"
CX
CX
CX
CX
CX
BS
SZ
hx
GR
wd
wd
CX
CX
CX
ZD
ZD
ZD
ZD
ZD
ZD
zo
Ky
Ky
Dw
RB
CK
RB
"}
(27,1,1) = {"
pe
pe
pe
pe
CX
CX
rN
hx
Wy
wd
wd
CX
CX
CX
CX
ZD
ZD
ZD
ZD
ZD
ZD
Ky
Ky
Dw
RB
RB
RB
"}
(28,1,1) = {"
xM
xM
xM
xM
xM
CX
Bb
cx
vS
Fe
Fe
Fe
Fe
wK
CX
ZD
ZD
ZD
ZD
ZD
ZD
ZD
Ky
Dw
RB
zc
RB
"}
(29,1,1) = {"
xM
xM
xM
xM
xM
CX
IN
wd
pV
qN
GR
wd
wd
LU
CX
ZD
ZD
ZD
Nr
Dp
ZD
ZD
ZD
Dw
RB
vs
RB
"}
(30,1,1) = {"
xM
xM
xM
xM
xM
CX
CX
CX
CX
CX
CX
CX
wd
tr
CX
dZ
dZ
Nr
ST
Dp
Dp
CX
CX
CX
CX
CX
CX
"}
