//MAP CONVERTED BY dmm2tgm.py THIS HEADER COMMENT PREVENTS RECONVERSION, DO NOT REMOVE
"a" = (
/obj/structure/cable,
/obj/machinery/atmospherics/pipe/simple/green/hidden{
	dir = 5
	},
/turf/open/floor/marking/asteroidwarning{
	dir = 10
	},
/area/bigredv3/outside/directions/central)
"b" = (
/obj/structure/table,
/obj/effect/spawner/random/engineering/toolbox,
/obj/effect/spawner/random/engineering/toolbox,
/obj/machinery/light{
	dir = 1
	},
/turf/open/floor,
/area/bigredv3/inside/secondary/auxstore)
"c" = (
/obj/machinery/atmospherics/pipe/manifold/green/hidden{
	dir = 1
	},
/obj/structure/cable,
/obj/effect/ai_node,
/turf/open/floor/asteroidfloor,
/area/bigredv3/outside/directions/central)
"d" = (
/obj/machinery/atmospherics/pipe/simple/green/hidden{
	dir = 4
	},
/obj/structure/cable,
/turf/open/floor/asteroidfloor,
/area/bigredv3/outside/directions/central)
"e" = (
/obj/structure/table,
/obj/effect/spawner/random/engineering/toolbox,
/obj/effect/spawner/random/engineering/toolbox,
/turf/open/floor,
/area/bigredv3/inside/secondary/auxstore)
"f" = (
/obj/machinery/atmospherics/pipe/simple/green/hidden{
	dir = 4
	},
/obj/structure/cable,
/turf/open/floor,
/area/bigredv3/inside/secondary/auxstore)
"g" = (
/turf/open/floor/marking/asteroidwarning{
	dir = 4
	},
/area/bigredv3/outside/directions/central)
"h" = (
/turf/open/floor/marking/asteroidwarning{
	dir = 1
	},
/area/bigredv3/outside/directions/central)
"l" = (
/obj/machinery/atmospherics/pipe/simple/green/hidden{
	dir = 4
	},
/obj/structure/cable,
/obj/machinery/door/airlock/mainship/secure/locked/free_access{
	name = "\improper Emergency Vault"
	},
/turf/open/floor,
/area/bigredv3/inside/secondary/auxstore)
"n" = (
/obj/machinery/atmospherics/components/unary/vent_pump{
	dir = 1;
	on = 1
	},
/turf/open/floor,
/area/bigredv3/inside/secondary/auxstore)
"o" = (
/obj/effect/ai_node,
/turf/open/floor,
/area/bigredv3/inside/secondary/auxstore)
"q" = (
/obj/structure/cable,
/obj/machinery/power/apc/weak/ntf,
/turf/open/floor,
/area/bigredv3/inside/secondary/auxstore)
"r" = (
/turf/closed/wall,
/area/bigredv3/inside/wall)
"t" = (
/obj/machinery/atmospherics/pipe/simple/green/hidden,
/obj/structure/cable,
/turf/open/floor/marking/asteroidwarning{
	dir = 8
	},
/area/bigredv3/outside/directions/central)
"u" = (
/obj/machinery/atmospherics/pipe/simple/green/hidden{
	dir = 4
	},
/obj/structure/cable,
/turf/open/floor/marking/asteroidwarning,
/area/bigredv3/outside/directions/central)
"v" = (
/obj/structure/table,
/obj/effect/spawner/random/engineering/toolbox,
/obj/effect/spawner/random/engineering/toolbox,
/obj/machinery/light,
/turf/open/floor,
/area/bigredv3/inside/secondary/auxstore)
"A" = (
/obj/machinery/atmospherics/pipe/simple/green/hidden,
/obj/structure/cable,
/turf/open/floor/asteroidfloor,
/area/bigredv3/outside/directions/central)
"B" = (
/turf/open/floor/marking/asteroidwarning{
	dir = 5
	},
/area/bigredv3/outside/directions/central)
"C" = (
/obj/structure/cable,
/turf/open/floor,
/area/bigredv3/inside/secondary/auxstore)
"D" = (
/turf/open/floor/asteroidfloor,
/area/bigredv3/outside/directions/central)
"E" = (
/turf/open/floor,
/area/bigredv3/inside/secondary/auxstore)
"F" = (
/turf/open/floor/marking/asteroidwarning{
	dir = 8
	},
/area/bigredv3/outside/directions/central)
"I" = (
/obj/machinery/atmospherics/pipe/manifold/green/hidden{
	dir = 1
	},
/obj/structure/cable,
/turf/open/floor/asteroidfloor,
/area/bigredv3/outside/directions/central)
"J" = (
/obj/effect/ai_node,
/obj/structure/cable,
/obj/machinery/atmospherics/pipe/manifold/green/hidden{
	dir = 1
	},
/turf/open/floor/asteroidfloor,
/area/bigredv3/outside/directions/central)
"L" = (
/obj/machinery/atmospherics/pipe/simple/green/hidden{
	dir = 9
	},
/obj/structure/cable,
/obj/effect/ai_node,
/turf/open/floor/marking/asteroidwarning{
	dir = 6
	},
/area/bigredv3/outside/directions/central)
"M" = (
/turf/open/floor/marking/asteroidwarning{
	dir = 9
	},
/area/bigredv3/outside/directions/central)
"N" = (
/obj/structure/cable,
/obj/machinery/atmospherics/pipe/simple/green/hidden,
/turf/open/floor/marking/asteroidwarning{
	dir = 8
	},
/area/bigredv3/outside/directions/central)
"P" = (
/turf/open/floor/plating/ground/mars/random/sand,
/area/bigredv3/outside/directions/central)
"S" = (
/obj/machinery/atmospherics/pipe/simple/green/hidden{
	dir = 10
	},
/obj/structure/cable,
/turf/open/floor/asteroidfloor,
/area/bigredv3/outside/directions/central)
"W" = (
/obj/structure/cable,
/obj/machinery/atmospherics/pipe/simple/green/hidden{
	dir = 6
	},
/turf/open/floor,
/area/bigredv3/inside/secondary/auxstore)
"Y" = (
/obj/machinery/atmospherics/pipe/simple/green/hidden,
/obj/structure/cable,
/turf/open/floor/marking/asteroidwarning{
	dir = 4
	},
/area/bigredv3/outside/directions/central)

(1,1,1) = {"
P
M
F
D
c
S
t
N
a
"}
(2,1,1) = {"
P
h
r
r
r
r
r
r
u
"}
(3,1,1) = {"
P
h
r
e
E
E
e
r
u
"}
(4,1,1) = {"
P
h
r
e
E
E
e
r
u
"}
(5,1,1) = {"
P
h
r
b
E
E
v
r
u
"}
(6,1,1) = {"
P
h
r
e
E
E
e
r
u
"}
(7,1,1) = {"
P
h
r
e
o
E
e
r
I
"}
(8,1,1) = {"
P
h
r
q
C
E
e
r
J
"}
(9,1,1) = {"
P
h
r
b
C
E
v
r
d
"}
(10,1,1) = {"
P
h
r
e
W
n
e
r
u
"}
(11,1,1) = {"
P
h
r
e
f
E
e
r
u
"}
(12,1,1) = {"
P
h
r
e
f
E
e
r
u
"}
(13,1,1) = {"
P
h
r
b
f
E
v
r
u
"}
(14,1,1) = {"
P
h
r
e
f
E
e
r
u
"}
(15,1,1) = {"
P
h
r
r
l
r
r
r
u
"}
(16,1,1) = {"
P
B
g
D
c
A
Y
Y
L
"}
