//MAP CONVERTED BY dmm2tgm.py THIS HEADER COMMENT PREVENTS RECONVERSION, DO NOT REMOVE
"ac" = (
/turf/open/floor/plating/ground/mars/random/cave,
/area/bigredv3/caves/southwest)
"ad" = (
/obj/effect/landmark/lv624/fog_blocker,
/turf/open/floor/plating/ground/mars/random/cave,
/area/bigredv3/caves/southwest)
"ah" = (
/obj/effect/ai_node,
/turf/open/floor/plating/ground/mars/random/cave/rock,
/area/bigredv3/caves/southwest)
"aj" = (
/turf/open/floor/plating/ground/mars/random/cave/rock,
/area/bigredv3/caves/southwest)
"ak" = (
/obj/effect/landmark/xeno_silo_spawn,
/turf/open/floor/plating/ground/mars/random/cave,
/area/bigredv3/caves/southwest)
"aq" = (
/obj/effect/landmark/lv624/fog_blocker,
/turf/closed/mineral/smooth/bigred,
/area/bigredv3/caves/rock)
"as" = (
/obj/effect/ai_node,
/turf/open/floor/plating/ground/mars/random/cave,
/area/bigredv3/caves/southwest)
"au" = (
/turf/closed/mineral/smooth/bigred/indestructible,
/area/space)
"aw" = (
/obj/effect/landmark/lv624/fog_blocker/xeno_spawn,
/turf/open/floor/plating/ground/mars/random/cave/rock,
/area/bigredv3/caves/southwest)
"aH" = (
/turf/closed/mineral/smooth/bigred,
/area/bigredv3/caves/rock)
"aJ" = (
/obj/effect/landmark/lv624/fog_blocker/xeno_spawn,
/turf/open/floor/plating/ground/mars/random/cave,
/area/bigredv3/caves/southwest)
"aT" = (
/obj/effect/landmark/lv624/fog_blocker/xeno_spawn,
/turf/closed/mineral/smooth/bigred,
/area/bigredv3/caves/rock)
"fP" = (
/obj/structure/fence/standard/xenoproof,
/turf/open/floor/plating/ground/mars/random/cave,
/area/bigredv3/caves/southwest)
"gB" = (
/obj/effect/landmark/patrol_point/som/som_11,
/turf/open/floor/plating/ground/mars/random/cave,
/area/bigredv3/caves/southwest)
"hG" = (
/obj/effect/landmark/xeno_tunnel_spawn,
/turf/open/floor/plating/ground/mars/random/cave/rock,
/area/bigredv3/caves/southwest)
"Te" = (
/turf/closed/wall/r_wall,
/area/bigredv3/inside/wall)

(1,1,1) = {"
au
au
au
au
au
au
au
au
au
au
au
au
au
au
au
au
au
au
au
au
au
au
au
au
au
au
au
au
au
au
au
au
au
au
au
au
au
au
au
au
au
au
au
"}
(2,1,1) = {"
aH
aH
aH
aH
aH
aH
aH
aH
aH
aH
aH
aH
aH
aH
aH
aH
aH
aH
aH
aT
aH
aH
aH
aH
aH
aH
aH
aH
aH
aH
aH
aH
aH
aH
aH
au
au
au
au
au
au
au
au
"}
(3,1,1) = {"
aH
aH
aH
aH
aH
aH
aH
aH
aH
aH
aH
aH
aH
aH
aH
aH
aH
aH
aH
aT
aH
aH
aH
aH
aH
aH
aH
aH
aH
aH
aH
aH
aH
aH
aH
au
au
au
au
au
au
au
au
"}
(4,1,1) = {"
aH
aH
aH
aH
aH
aH
aH
aH
aH
aH
aH
aH
aH
aH
aH
aH
aH
aH
aH
aT
aH
aH
aH
aH
aH
aH
aH
aH
aH
aH
aH
aH
aH
aH
aH
au
au
au
au
au
au
au
au
"}
(5,1,1) = {"
aH
aH
aH
aH
aH
aH
aH
aH
aH
aH
aH
aH
aH
aH
aH
aH
aH
aH
aH
aT
aH
aH
aH
aH
aH
aH
aH
aH
aH
aH
aH
aH
aH
aH
aH
au
au
au
au
au
au
au
au
"}
(6,1,1) = {"
aH
aH
aH
aH
aH
aH
aH
aH
aH
aH
aH
aH
aH
aH
aH
aH
aH
aH
aH
aT
aH
aH
ac
aj
aj
hG
aj
aj
aH
aH
aH
aH
aH
aH
aH
au
au
au
au
au
au
au
au
"}
(7,1,1) = {"
aH
aH
aH
aH
ac
ac
ac
ac
ac
aH
aH
aH
aH
aH
aH
aj
ac
ac
ac
aJ
ac
ac
ac
ac
ac
ac
ac
ac
aj
aH
aH
aH
aH
aH
aH
au
au
au
au
au
au
au
au
"}
(8,1,1) = {"
aH
aH
ac
ac
ac
ac
ac
ac
ac
ac
ac
aH
aH
aH
aj
ac
ac
ac
ac
aJ
ac
ac
ac
ac
ac
ac
ac
ac
aj
aH
aH
aH
aH
aH
aH
au
au
au
au
au
au
au
au
"}
(9,1,1) = {"
aH
ac
ac
ac
ac
ac
ac
ac
ac
ac
ac
ac
ac
ac
ac
ac
ac
ac
ac
aJ
ac
ac
ac
ac
ac
ak
ac
ac
aj
aH
aH
aH
aH
aH
aH
au
au
au
au
au
au
au
au
"}
(10,1,1) = {"
ac
ac
as
ac
ac
ac
ac
ac
ac
ac
ac
as
ac
ac
ac
as
ac
ac
ac
aJ
ac
ac
ac
ac
ac
as
ac
ac
ac
aj
aH
aH
aH
aH
aH
au
au
au
au
au
au
au
au
"}
(11,1,1) = {"
ac
ac
ac
ac
ac
ac
ac
ac
ac
ac
ac
ac
ac
ac
ac
ac
ac
ac
ac
aJ
ac
ac
ac
ac
ac
ac
ac
ac
ac
aj
aH
aH
aH
aH
aH
au
au
au
au
au
au
au
au
"}
(12,1,1) = {"
ac
ac
ac
ac
ac
ac
ac
ac
aH
aH
aH
ac
ac
ac
ac
ac
ac
ac
ac
aJ
ac
ac
ac
ac
gB
ac
ac
ac
ac
ac
ac
ac
aH
aH
aH
au
au
au
au
au
au
au
au
"}
(13,1,1) = {"
ac
ac
aH
aH
aH
aH
aH
aH
aH
aH
aH
ac
ac
ac
ac
ac
ac
ac
ac
aJ
ac
ac
ac
ac
ac
ac
ac
ac
ac
ac
ac
ac
aH
aH
aH
au
au
au
au
au
au
au
au
"}
(14,1,1) = {"
ac
aH
aH
aH
aH
aH
aH
aH
aH
aH
aH
ac
ac
ac
ac
ac
ac
ac
ac
aJ
ac
ac
ac
ac
ac
ac
ac
aj
ac
ac
ac
aH
aH
aH
aH
au
au
au
au
au
au
au
au
"}
(15,1,1) = {"
aH
aH
aH
aH
aH
aH
aH
aH
aH
aH
aH
aj
ac
ac
ac
ac
ac
ac
ac
aJ
ac
ac
ac
ac
ac
ac
ac
ac
ac
ac
ac
aH
aH
aH
aH
au
au
au
au
au
au
au
au
"}
(16,1,1) = {"
aH
aH
aH
aH
aH
aH
aH
aH
aH
aH
aH
aH
ac
ac
ac
as
ac
ac
ac
aJ
as
ac
ac
ac
ac
as
ac
ac
ac
ac
ac
aH
aH
aH
aH
au
au
au
au
au
au
au
au
"}
(17,1,1) = {"
aH
aH
aH
aH
aH
aH
aH
aH
aH
aH
aH
aH
ac
ac
ac
ac
ac
ac
ac
aJ
aJ
aJ
aJ
aJ
aJ
aJ
aJ
aw
aJ
aJ
aJ
aT
aT
aT
aT
au
au
au
au
au
au
au
au
"}
(18,1,1) = {"
aH
aH
aH
aH
aH
aH
aH
aH
aH
aH
aH
aH
ac
ac
ac
ac
ac
ac
ac
ac
ac
ac
ac
ac
ac
ac
ac
ac
ac
ac
aH
aH
aH
aH
aH
au
au
au
au
au
au
au
au
"}
(19,1,1) = {"
aH
aH
aH
aH
aH
aH
aH
aH
aH
aH
aH
aH
ac
ac
ac
ac
ac
ac
ac
ac
ac
ac
ac
aj
ac
ac
ac
ac
aH
aH
aH
aH
aH
aH
aH
au
au
au
au
au
au
au
au
"}
(20,1,1) = {"
aH
aH
aH
aH
aH
aH
aH
aH
aH
aH
ac
aj
ac
ac
ac
ac
ac
ac
ac
ac
ac
ac
ac
aj
ac
ac
ac
aH
aH
aH
aH
aH
aH
aH
aH
au
au
au
au
au
au
au
au
"}
(21,1,1) = {"
aH
aH
aH
aH
aH
aH
aH
aH
aH
ac
ac
aj
ac
ac
ac
ac
ac
ac
ac
ac
ac
ac
aj
ac
ac
ac
ac
aH
aH
aH
aH
aH
aH
aH
aH
au
au
au
au
au
au
au
au
"}
(22,1,1) = {"
aH
aH
aH
aH
aH
aH
aH
aH
aH
ac
ac
ac
as
ac
ac
as
aj
aH
aj
ac
ac
ac
aj
aH
aH
ac
ac
aH
aH
aH
aH
aH
aH
aH
aH
au
au
au
au
au
au
au
au
"}
(23,1,1) = {"
aH
aH
aH
aH
aH
aH
aH
aH
ac
ac
ac
ac
ac
ac
ac
aj
aH
aH
aH
aH
aH
aH
aH
aH
aH
ac
ac
ac
aH
aH
aH
aH
aH
aH
aH
au
au
au
au
au
au
au
au
"}
(24,1,1) = {"
aH
aH
aH
aH
aH
ac
ac
ac
aj
ac
ac
aj
ac
ac
ac
aj
aH
aH
aH
aH
aH
aH
aH
aH
ac
ac
ac
ac
aH
aH
aH
aH
aH
aH
aH
au
au
au
au
au
au
au
au
"}
(25,1,1) = {"
aH
aH
aH
aH
aH
ac
ac
ac
ac
ac
aj
ac
ac
ac
ac
aH
aH
aH
aH
aH
aH
aH
aH
aH
ac
as
ac
ac
aH
aH
aH
aH
aH
aH
aH
au
au
au
au
au
au
au
au
"}
(26,1,1) = {"
aH
aH
aH
aH
as
ac
ac
ac
ac
ac
ac
ac
aj
ac
ac
aH
aH
aH
aH
aH
aH
aH
aH
aH
aH
ac
as
ac
aH
aH
aH
aH
aH
aH
aH
au
au
au
au
au
au
au
au
"}
(27,1,1) = {"
aH
aH
aH
ac
ac
as
ac
ac
ac
ac
ac
ac
as
ac
ac
aH
aH
aH
aH
aH
aH
aH
aH
aH
aH
ac
ac
ac
ac
aH
aH
aH
aH
aH
aH
au
au
au
au
au
au
au
au
"}
(28,1,1) = {"
aH
aH
ac
ac
ac
ac
ac
ac
ac
ac
ac
ac
ac
ac
aj
aH
aH
aH
aH
aH
aH
aH
aH
aH
aH
aH
ac
ac
ac
aH
aH
aH
aH
aH
aH
au
au
au
au
au
au
au
au
"}
(29,1,1) = {"
aH
ac
ac
ac
ac
ac
ac
ac
ac
ac
ac
ac
ac
ac
ac
aH
aH
aH
aH
aH
aH
aH
aH
aH
aH
aH
ac
ac
ac
aH
aH
aH
aH
aH
aH
au
au
au
au
au
au
au
au
"}
(30,1,1) = {"
aH
ac
ac
ac
ac
ac
ac
ac
ac
aj
aH
aj
as
ac
ac
ac
aH
aH
aH
aH
aH
aH
aH
aH
aH
aH
ac
ac
ac
ac
aH
aH
aH
aH
aH
au
au
au
au
au
au
au
au
"}
(31,1,1) = {"
aH
ac
ac
ac
ac
ac
ac
ac
ac
aj
aH
aH
aj
as
ac
ac
ac
aH
aH
aH
aH
aH
aH
aH
aH
aH
ah
ac
ac
ac
aH
aH
aH
aH
aH
au
au
au
au
au
au
au
au
"}
(32,1,1) = {"
aH
ac
as
ac
ac
as
aH
ac
ac
aj
aH
aH
aH
ac
as
ac
ac
as
ac
aH
aH
aH
aH
aH
aH
aH
aj
ah
ac
ac
aH
aH
aH
aH
aH
au
au
au
au
au
au
au
au
"}
(33,1,1) = {"
aH
ac
ac
ac
aH
aH
aH
aj
aj
aH
aH
aH
aH
ac
ac
ac
ac
ac
ac
ac
aj
aH
aH
aH
aH
aH
aH
aj
as
ac
ac
aH
aH
aH
aH
au
au
au
au
au
au
au
au
"}
(34,1,1) = {"
aH
fP
fP
fP
aH
aH
aH
aH
aH
aH
aH
aH
aH
aH
ac
ac
ac
ac
ac
ac
ac
aj
aH
aH
aH
aH
aH
aH
ac
ac
ac
ac
aH
aH
aH
au
au
au
au
au
au
au
au
"}
(35,1,1) = {"
aH
ac
ac
ac
aH
aH
aH
aH
aH
aH
aH
aH
aH
ac
ac
ac
ac
ac
ac
ac
aj
aH
aH
aH
aH
aH
aH
aH
ac
ac
ac
aH
aH
aH
aH
au
au
au
au
au
au
au
au
"}
(36,1,1) = {"
aH
Te
Te
Te
aH
aH
aH
aH
aH
aH
aH
aH
aH
aj
ac
ac
ac
ac
ac
ac
aj
aH
aH
aH
aH
aH
aH
aH
ac
ac
ac
aH
aH
aH
aH
au
au
au
au
au
au
au
au
"}
(37,1,1) = {"
ac
ac
ac
ac
aH
aH
aH
aH
aH
aH
aH
aH
aH
aH
aH
aH
ac
as
ac
ac
ac
ah
aH
aH
aH
aH
aH
aH
ac
ac
ac
aH
aH
aH
aH
au
au
au
au
au
au
au
au
"}
(38,1,1) = {"
ac
ac
ac
ac
aH
aH
aH
aH
aH
aH
aH
aH
aH
aH
aH
aH
ac
ac
ac
ac
ac
aj
aH
aH
aH
aH
aj
aj
ac
ac
ac
aH
aH
aH
aH
au
au
au
au
au
au
au
au
"}
(39,1,1) = {"
ac
ac
ac
ac
aH
aH
aH
aH
aH
aH
aH
aH
aH
aH
aH
aH
aj
ac
ac
ac
ac
aj
aH
aH
aH
aH
aj
aj
ac
ac
aH
aH
aH
aH
aH
au
au
au
au
au
au
au
au
"}
(40,1,1) = {"
ac
ac
ac
ac
aH
aH
aH
aH
aH
aH
aH
aH
aH
aH
aH
aH
aH
aH
aH
ac
ac
ac
aj
aj
aH
aH
aH
aH
ac
ac
aH
aH
aH
aH
aH
au
au
au
au
au
au
au
au
"}
(41,1,1) = {"
ad
ad
ad
aq
aq
aq
aq
aq
aq
aq
aq
aq
aq
aq
aH
aH
aH
aH
aH
ac
ac
ac
ac
aj
aH
aH
aH
aH
ac
ac
aH
aH
aH
aH
aH
au
au
au
au
au
au
au
au
"}
