//MAP CONVERTED BY dmm2tgm.py THIS HEADER COMMENT PREVENTS RECONVERSION, DO NOT REMOVE
"k" = (
/obj/effect/landmark/lv624/fog_blocker,
/turf/open/floor/plating/ground/mars/random/cave,
/area/bigredv3/caves/east/garbledradio)
"m" = (
/obj/effect/ai_node,
/turf/open/floor/plating/ground/mars/random/cave,
/area/bigredv3/caves/east/garbledradio)
"o" = (
/turf/open/floor/plating/ground/mars/random/cave,
/area/bigredv3/caves/northeast/garbledradio)
"z" = (
/turf/open/floor/plating/ground/mars/random/cave/rock,
/area/bigredv3/caves/east/garbledradio)
"B" = (
/obj/effect/ai_node,
/turf/open/floor/plating/ground/mars/random/cave,
/area/bigredv3/caves/northeast/garbledradio)
"C" = (
/turf/closed/mineral/smooth/bigred,
/area/bigredv3/caves/rock)
"G" = (
/turf/open/floor/plating/ground/mars/random/cave,
/area/bigredv3/caves/east/garbledradio)
"H" = (
/obj/effect/landmark/lv624/fog_blocker,
/obj/effect/ai_node,
/turf/open/floor/plating/ground/mars/random/cave,
/area/bigredv3/caves/east/garbledradio)
"V" = (
/obj/effect/landmark/lv624/fog_blocker,
/turf/closed/mineral/smooth/bigred,
/area/bigredv3/caves/rock)

(1,1,1) = {"
C
C
C
C
C
C
C
C
C
C
C
"}
(2,1,1) = {"
C
C
C
C
C
C
C
C
C
C
C
"}
(3,1,1) = {"
C
C
C
C
C
C
C
C
C
C
C
"}
(4,1,1) = {"
C
C
C
C
C
C
C
C
C
C
C
"}
(5,1,1) = {"
C
C
C
C
C
C
C
C
C
C
C
"}
(6,1,1) = {"
o
C
C
G
G
G
m
G
C
C
C
"}
(7,1,1) = {"
o
G
G
G
G
G
G
G
G
z
z
"}
(8,1,1) = {"
B
G
G
G
G
G
G
G
G
m
k
"}
(9,1,1) = {"
o
m
G
G
G
G
m
G
G
k
m
"}
(10,1,1) = {"
B
G
G
G
G
G
G
G
G
H
G
"}
(11,1,1) = {"
o
G
G
G
G
G
G
k
k
G
G
"}
(12,1,1) = {"
o
G
G
G
G
G
k
z
G
G
m
"}
(13,1,1) = {"
B
G
G
m
G
k
G
G
G
m
C
"}
(14,1,1) = {"
C
G
G
C
G
k
C
C
G
C
C
"}
(15,1,1) = {"
C
C
C
C
C
V
C
C
C
C
C
"}
(16,1,1) = {"
C
C
C
C
C
V
C
C
C
C
C
"}
(17,1,1) = {"
C
C
C
C
C
V
C
C
C
C
C
"}
(18,1,1) = {"
C
C
C
C
C
V
C
C
C
C
C
"}
(19,1,1) = {"
C
C
C
C
C
V
C
C
C
C
C
"}
(20,1,1) = {"
C
C
C
C
C
V
C
C
C
C
C
"}
(21,1,1) = {"
C
C
C
C
C
V
C
C
C
C
C
"}
(22,1,1) = {"
V
V
V
V
V
C
C
C
C
C
C
"}
