//MAP CONVERTED BY dmm2tgm.py THIS HEADER COMMENT PREVENTS RECONVERSION, DO NOT REMOVE
"aa" = (
/turf/open/floor/plating/ground/mars/random/cave/rock,
/area/bigredv2/caves/east/garbledradio)
"ab" = (
/obj/docking_port/stationary/crashmode,
/turf/open/floor/plating/ground/mars/random/cave,
/area/bigredv2/caves/east/garbledradio)
"ae" = (
/turf/open/floor/plating/ground/mars/random/cave,
/area/bigredv2/caves/east/garbledradio)
"af" = (
/obj/machinery/miner/damaged/platinum,
/turf/open/floor/plating/ground/mars/random/cave,
/area/bigredv2/caves/east/garbledradio)
"aj" = (
/obj/effect/landmark/lv624/fog_blocker/xeno_spawn,
/turf/open/floor/plating/ground/mars/random/cave,
/area/bigredv2/caves/east/garbledradio)
"am" = (
/obj/effect/landmark/lv624/fog_blocker/xeno_spawn,
/turf/open/floor/plating/ground/mars/random/cave,
/area/bigredv2/caves/east)
"ao" = (
/obj/effect/landmark/excavation_site_spawner,
/turf/open/floor/plating/ground/mars/random/cave,
/area/bigredv2/caves/east/garbledradio)
"ap" = (
/obj/effect/landmark/xeno_silo_spawn,
/turf/open/floor/plating/ground/mars/random/cave,
/area/bigredv2/caves/east/garbledradio)
"aq" = (
/turf/closed/mineral/smooth/bigred/indestructible,
/area/space)
"aw" = (
/obj/effect/landmark/lv624/fog_blocker/xeno_spawn,
/turf/closed/mineral/smooth/bigred,
/area/bigredv2/caves/rock)
"ax" = (
/obj/effect/landmark/xeno_silo_spawn,
/turf/open/floor/plating/ground/mars/random/cave,
/area/bigredv2/caves/east)
"aC" = (
/obj/effect/landmark/lv624/fog_blocker,
/turf/closed/mineral/smooth/bigred,
/area/bigredv2/caves/rock)
"aE" = (
/obj/effect/ai_node,
/turf/open/floor/plating/ground/mars/random/cave,
/area/bigredv2/caves/east/garbledradio)
"aG" = (
/obj/effect/landmark/excavation_site_spawner,
/turf/open/floor/plating/ground/mars/random/cave,
/area/bigredv2/caves/east)
"aK" = (
/obj/effect/ai_node,
/turf/open/floor/plating/ground/mars/random/cave/rock,
/area/bigredv2/caves/east/garbledradio)
"aL" = (
/obj/machinery/miner/damaged/platinum,
/turf/open/floor/plating/ground/mars/random/cave,
/area/bigredv2/caves/east)
"aN" = (
/obj/docking_port/stationary/crashmode,
/turf/closed/mineral/smooth/bigred,
/area/bigredv2/caves/rock)
"aO" = (
/obj/effect/landmark/lv624/fog_blocker/xeno_spawn,
/turf/open/floor/plating/ground/mars/random/cave/rock,
/area/bigredv2/caves/east/garbledradio)
"aP" = (
/turf/open/floor/plating/ground/mars/random/cave/rock,
/area/bigredv2/caves/east)
"aQ" = (
/obj/effect/landmark/lv624/fog_blocker/xeno_spawn,
/obj/effect/landmark/lv624/fog_blocker/xeno_spawn,
/turf/closed/mineral/smooth/bigred,
/area/bigredv2/caves/rock)
"aU" = (
/obj/structure/fence/standard/xenoproof,
/obj/effect/landmark/lv624/fog_blocker,
/turf/open/floor/plating/ground/mars/random/cave,
/area/bigredv2/caves/east/garbledradio)
"aV" = (
/obj/effect/landmark/lv624/fog_blocker/xeno_spawn,
/obj/effect/landmark/lv624/fog_blocker/xeno_spawn,
/turf/open/floor/plating/ground/mars/random/cave,
/area/bigredv2/caves/east/garbledradio)
"aW" = (
/obj/effect/ai_node,
/turf/open/floor/plating/ground/mars/random/cave,
/area/bigredv2/caves/east)
"aX" = (
/turf/closed/mineral/smooth/bigred,
/area/bigredv2/caves/rock)
"aZ" = (
/turf/open/floor/plating/ground/mars/random/cave,
/area/bigredv2/caves/east)
"pG" = (
/turf/open/floor/plating/ground/mars/random/sand,
/area/bigredv2/outside/se)
"WZ" = (
/obj/effect/ai_node,
/turf/open/floor/plating/ground/mars/random/sand,
/area/bigredv2/outside/se)

(1,1,1) = {"
pG
pG
pG
pG
pG
pG
pG
pG
pG
pG
pG
aX
aX
aX
aU
ae
ae
ae
ae
ae
ae
ae
ae
ae
ae
ae
ae
ae
aX
aX
aX
aX
aX
aX
aX
aX
aX
ae
ae
ae
ae
ae
"}
(2,1,1) = {"
pG
pG
pG
pG
pG
pG
pG
pG
pG
pG
pG
aX
aX
aX
aC
ae
ae
ae
ae
ae
ae
ae
ae
ae
ae
ae
ae
ae
aX
aX
aX
aX
aX
aX
aX
aX
aX
aX
ae
ae
aE
ae
"}
(3,1,1) = {"
pG
pG
pG
pG
pG
pG
pG
pG
pG
pG
pG
aX
aX
aX
aC
ae
ae
ae
ae
ae
ae
aX
aX
aX
aX
aX
ae
ae
ae
aX
aX
aX
aX
aX
aX
aX
aX
aX
ae
ae
ae
ae
"}
(4,1,1) = {"
pG
aX
aX
aX
aX
pG
pG
pG
pG
pG
pG
pG
aX
aX
aC
ae
ae
ae
ae
ae
ae
aX
aX
aX
aX
aX
aa
ae
ae
ae
ae
ae
ae
ae
ae
aX
aa
aa
ae
ae
ae
ae
"}
(5,1,1) = {"
pG
aX
aX
aX
aX
aX
aX
pG
pG
pG
pG
pG
pG
aX
aC
aX
ae
aV
aj
aj
aw
aw
aw
aw
aw
aw
aj
aO
aV
ae
ae
ae
ae
ae
ae
aa
ae
ae
ae
ae
ae
ae
"}
(6,1,1) = {"
pG
pG
aX
aX
aX
aX
aX
aX
pG
pG
pG
pG
pG
aX
aC
aX
aX
aj
ae
aX
aX
aX
aX
aX
aX
ae
ae
ae
aO
aa
aE
ae
ae
ae
ae
ae
ae
ae
ae
ae
aE
aa
"}
(7,1,1) = {"
pG
pG
pG
pG
pG
pG
pG
pG
pG
pG
pG
pG
pG
aX
aC
aX
aX
aj
ae
ae
ae
aX
ae
aX
aX
ae
aE
ae
aj
aE
ae
ae
ae
ae
ae
ae
ae
ae
ae
af
ae
aa
"}
(8,1,1) = {"
pG
pG
pG
pG
pG
pG
pG
pG
pG
pG
pG
pG
pG
aX
aC
aX
aX
aw
ae
ae
ae
aE
ae
ae
aE
aE
ae
ae
aj
ae
ae
ae
ae
ae
ae
ae
aa
ae
ae
ae
aa
aX
"}
(9,1,1) = {"
pG
pG
pG
pG
pG
WZ
pG
pG
pG
WZ
pG
pG
pG
aX
aC
aX
aX
aw
ae
ae
ae
ae
ae
ae
ae
ae
ae
aX
aw
aX
aX
aX
ae
ae
ae
ae
ae
aa
ae
ae
ae
aa
"}
(10,1,1) = {"
pG
pG
pG
pG
pG
pG
pG
pG
pG
pG
pG
pG
aX
aX
aC
aX
aX
aw
aX
aX
ae
ae
ae
ae
ae
aX
aX
aX
aw
aX
aX
aX
aX
aX
aX
aX
ae
ae
ae
ae
ae
aa
"}
(11,1,1) = {"
pG
pG
aX
pG
pG
pG
pG
pG
pG
pG
pG
aX
aX
aX
aC
aX
aX
aw
aX
ae
ae
ae
ae
ae
ae
ae
aX
aX
aw
aX
aX
aX
aX
aX
aX
aX
ae
ae
ae
ae
ae
aa
"}
(12,1,1) = {"
pG
aX
aX
pG
pG
pG
pG
pG
pG
aX
aX
aX
aX
aX
aC
aX
aX
aw
ae
aa
ae
ae
aa
ae
ae
ae
aX
aX
aw
aX
aX
aX
aX
aX
aX
aX
ae
ae
ae
ae
ae
aa
"}
(13,1,1) = {"
aX
aX
aX
pG
pG
pG
pG
pG
pG
aX
aX
aX
aX
aX
aC
aX
aX
aw
ae
ae
ae
ae
ae
ae
ae
ae
aX
aX
aw
aX
aX
aX
aX
aX
aX
aX
aa
ae
ae
ae
aa
aX
"}
(14,1,1) = {"
aX
aX
pG
pG
pG
pG
pG
pG
pG
aX
aX
aX
aX
aX
aC
aX
aX
aw
ae
ae
ae
aE
ap
ae
ae
ae
ae
aX
aw
aX
aX
aX
aX
aX
aX
aX
ae
ae
ae
ae
aE
aa
"}
(15,1,1) = {"
aX
pG
pG
pG
pG
pG
aX
aX
aX
aX
aX
aX
aX
aX
aC
aX
aX
aw
ae
ae
ae
ae
ae
ae
ae
ae
aX
aX
aw
aX
aX
aX
aX
aX
aX
aX
aX
aa
ae
ae
ae
aa
"}
(16,1,1) = {"
pG
pG
pG
pG
pG
WZ
aX
aX
aX
aX
aX
aX
aX
aX
aC
aX
aX
aw
aX
aX
aX
ae
ae
ae
ae
aX
aX
aX
aw
aX
aX
aX
aX
aX
aX
aX
aX
aX
ae
ae
ae
ae
"}
(17,1,1) = {"
pG
pG
pG
pG
pG
pG
aX
aX
aX
aX
aX
aX
aX
aX
aC
aX
aX
aw
aX
aX
aX
aX
aX
aX
aX
aX
aX
aX
aw
aX
aX
aX
aX
aX
aX
aX
aX
aX
ae
ae
ae
ae
"}
(18,1,1) = {"
aX
aX
aX
aX
aX
aX
aX
aX
aX
aX
aX
aX
aX
aX
aC
aX
aX
aQ
aw
aw
aw
aw
aw
aw
aw
aw
aw
aw
aQ
aX
aX
aX
aX
aX
aX
aX
ae
ae
ae
ae
ae
ae
"}
(19,1,1) = {"
aC
aC
aC
aC
aC
aC
aC
aC
aC
aC
aC
aC
aC
aC
aC
aX
aX
aX
aX
aX
aX
aX
aX
aX
aX
aX
aX
aX
aX
aX
aX
aX
aX
aX
aX
ae
ae
ae
ae
ae
ae
ae
"}
(20,1,1) = {"
aX
aX
aX
aX
aX
aX
aX
aX
aX
aX
aX
aX
aX
aX
aX
aX
aX
aX
aX
aX
aX
aX
aX
aX
aX
aN
aX
aX
aX
aX
aX
aX
aX
aX
ae
ae
ae
ae
ae
ae
ae
ae
"}
(21,1,1) = {"
aX
aX
aX
aX
aX
aX
aX
aX
aX
aX
aX
aX
aX
aX
aX
aX
aX
aX
aX
aX
aX
aX
aX
aX
aX
aX
aX
aX
aX
aX
aX
aX
aX
aX
ae
ae
ae
ae
ae
aa
ae
ae
"}
(22,1,1) = {"
aX
aa
aa
aK
aa
aa
aX
aX
aX
aX
aX
aX
aX
aX
aX
aX
aX
aX
aX
aX
aX
aX
aX
aX
aX
aX
aX
aX
aX
aX
aX
aX
aX
aX
ae
ae
ae
ae
ae
ae
aE
ae
"}
(23,1,1) = {"
aX
ae
ae
ae
ae
ae
aa
aX
aX
aX
aX
aX
aX
aX
aX
aX
aX
aX
aX
aX
aX
aX
aX
aX
aX
aX
aX
aX
aX
aX
aX
aX
aX
aX
ae
ae
aa
aX
aX
ae
ae
ae
"}
(24,1,1) = {"
aX
aa
ae
ae
ae
ae
aa
aX
aX
aX
aX
aX
aX
aX
aX
aX
aX
aX
aX
aX
aX
aX
aX
aX
aX
aX
aX
aX
aX
aX
aX
aX
ae
aa
ae
ae
aa
aX
aX
ae
ae
ae
"}
(25,1,1) = {"
aX
aX
aX
aK
ae
ae
aa
ae
aE
ae
ae
aX
aX
aX
aX
aX
aX
aX
aX
aX
aX
aX
aX
aX
aX
aX
aX
aX
aX
aX
ae
ae
aa
ae
ae
aa
aX
aX
aX
ae
ae
ae
"}
(26,1,1) = {"
aX
aX
aX
aX
aX
ae
aa
ae
ae
ae
ae
aX
aX
aX
aX
aa
aa
ae
ae
ae
ae
ae
aX
aX
aX
aX
aX
ae
ae
ae
ae
ae
ae
ae
aa
aX
aX
aX
aX
ae
aE
ae
"}
(27,1,1) = {"
aa
aa
aa
aa
aa
ae
aa
ae
ae
ae
ae
ae
ae
ae
ae
ae
ae
ae
ae
ae
ae
ae
ae
ae
ae
ae
ae
ae
ae
ae
ae
ae
ae
ae
ae
aa
aX
aa
aa
ae
ae
ae
"}
(28,1,1) = {"
aE
ae
ae
ae
ae
aE
ae
aa
aK
aa
aa
aa
aa
aa
ae
ae
aK
ae
ae
ae
ae
ae
ae
aE
ae
ae
ae
ae
ae
ae
ae
ae
ae
aE
ae
ae
aa
ae
ae
ae
ae
ae
"}
(29,1,1) = {"
ae
ae
ae
ae
ae
ae
ae
ae
ae
ae
ae
ae
ae
ae
ae
ae
aa
ae
ae
aa
ae
ae
ae
ae
ae
ae
ae
ae
ae
ae
ae
ae
ae
ae
ae
ae
ae
ae
ae
ae
ae
ae
"}
(30,1,1) = {"
ae
ae
ae
ae
ae
ae
ae
ae
ae
ae
ae
ae
ae
ae
ae
ae
aa
ae
ae
ao
ae
ae
ae
ae
ae
aa
ae
ae
ae
ae
ae
ae
ae
ae
ae
ae
ae
ae
ae
ae
aK
aX
"}
(31,1,1) = {"
ae
ae
ae
ae
ae
ae
ae
ae
ae
ae
ae
aa
aX
aX
ae
ae
aa
ae
ae
ae
ae
ae
ae
ae
ae
ae
ae
ae
ae
aX
aX
aX
aX
ae
ae
ae
ae
ae
ae
ae
aa
aX
"}
(32,1,1) = {"
aa
ae
ae
ae
ae
ae
ae
aX
aX
aX
aX
aX
aX
aX
aX
ae
aa
ae
ae
ae
ae
ae
ae
ae
ae
ae
aX
aX
aX
aX
aX
aX
aX
ae
ae
ae
ae
ae
ae
aa
ae
aX
"}
(33,1,1) = {"
ae
ae
ae
ae
af
ae
ae
aX
aX
aX
aX
aX
aX
aX
aX
ae
aa
ae
ae
ae
ae
ae
aX
aX
aX
aX
aX
aX
aX
aX
aX
aX
ae
aE
ae
ae
ae
ae
aa
ae
ae
ae
"}
(34,1,1) = {"
aa
ae
ae
aa
ae
ae
ae
aX
aX
aX
aX
aX
aX
aX
aa
ae
ae
ae
ae
ae
aX
aX
aX
aX
aX
aX
aX
aX
aX
aX
aX
aX
aE
ae
ae
ae
ae
ae
aa
ae
aE
ae
"}
(35,1,1) = {"
aX
aa
ae
ae
ae
ae
ae
ae
aX
aX
aX
aX
aX
aa
ae
ae
ae
ae
ae
aX
aX
aX
aX
aX
aX
aX
aX
aX
aX
aX
aZ
aE
ae
ae
ae
ae
ae
aX
aX
ae
ae
aZ
"}
(36,1,1) = {"
aX
aX
aX
ae
ae
aa
ae
ae
ae
aX
aX
aX
aa
ae
ae
ae
ae
ae
ae
aX
aX
aX
aX
aX
aX
aX
aX
aX
aX
aZ
aZ
aZ
aZ
aZ
ae
ae
aX
aX
aX
aX
aW
aZ
"}
(37,1,1) = {"
aX
aX
aX
ae
ae
aP
ae
aZ
ab
aa
ae
ae
ae
ae
aZ
ae
ae
aZ
aX
aX
aX
aX
aX
aX
aX
aX
aX
aX
aZ
aZ
aZ
aZ
aZ
aZ
aZ
aZ
aX
aX
aX
aX
aZ
aZ
"}
(38,1,1) = {"
aX
aX
aX
aZ
aZ
aW
aZ
aZ
aZ
ae
ae
aZ
aZ
aZ
aZ
aZ
aW
aX
aX
aX
aX
aX
aX
aX
aX
aX
aX
aX
aZ
aZ
aZ
aZ
aZ
aZ
aZ
aX
aX
aX
aX
aX
aX
aZ
"}
(39,1,1) = {"
aX
aX
aX
aX
aZ
aZ
aZ
aZ
aZ
aZ
aZ
aZ
aZ
aZ
aZ
aX
aX
aX
aX
aX
aX
aX
aX
aX
aX
aX
aX
aX
aZ
aZ
aZ
aZ
aZ
aZ
aZ
aX
aX
aX
aX
aX
aX
aX
"}
(40,1,1) = {"
aX
aX
aX
aX
aZ
aZ
aZ
aZ
aZ
aZ
aZ
aZ
aZ
aZ
aX
aX
aX
aX
aX
aX
aX
aX
aX
aX
aX
aX
aZ
aZ
aZ
aZ
aZ
aZ
aZ
aZ
aZ
aX
aX
aX
aX
aX
aX
aX
"}
(41,1,1) = {"
aX
aX
aX
aZ
aZ
aZ
aZ
aZ
aZ
aZ
aZ
aZ
aX
aX
aX
aX
aX
aX
aX
aX
aX
aX
aX
aX
aX
aZ
aZ
aZ
aZ
aZ
aZ
aZ
aZ
aZ
aZ
aX
aX
aX
aX
aX
aX
aX
"}
(42,1,1) = {"
aX
aX
aX
aZ
aZ
aZ
aZ
aZ
aZ
aZ
aZ
aZ
aX
aX
aX
aX
aX
aX
aX
aX
aZ
aX
aX
aX
aZ
aZ
aZ
aZ
aZ
aZ
aZ
aW
aZ
aZ
aZ
aX
aX
aX
aX
aX
aX
aX
"}
(43,1,1) = {"
aX
aX
aZ
aZ
aZ
aZ
aZ
aZ
aZ
aZ
aZ
aZ
aZ
aX
aX
aX
aX
aX
aX
aZ
aZ
aZ
aX
aX
aZ
aZ
aZ
aZ
aZ
aZ
aZ
aZ
aZ
aZ
aZ
aX
aX
aX
aX
aX
aX
aX
"}
(44,1,1) = {"
aX
aX
aZ
aZ
aZ
aZ
aZ
aZ
aZ
aZ
aZ
aZ
aZ
aZ
aZ
aX
aX
aX
aZ
aZ
aZ
aZ
aZ
aZ
aZ
aZ
aZ
aZ
aZ
aZ
aZ
aZ
aZ
aZ
aZ
aZ
aX
aX
aX
aX
aX
aX
"}
(45,1,1) = {"
aX
aX
aZ
aZ
aZ
aZ
aZ
aG
aZ
aZ
aZ
aZ
aZ
aZ
aZ
aZ
aZ
aZ
aZ
aZ
aZ
aZ
aZ
aG
aZ
aZ
aZ
aZ
aZ
aZ
aZ
aZ
aZ
aZ
aZ
aZ
aZ
aX
aX
aX
aX
aX
"}
(46,1,1) = {"
aZ
aZ
aZ
aZ
aZ
aZ
aZ
aZ
aZ
aZ
aZ
aZ
aZ
aZ
aZ
aZ
aZ
aZ
aZ
aZ
aZ
aZ
aZ
aZ
aZ
aZ
aZ
aZ
aZ
aZ
aZ
aZ
aZ
aZ
aZ
aZ
aZ
aZ
aZ
aZ
aZ
aZ
"}
(47,1,1) = {"
aZ
aZ
aZ
aZ
aZ
aZ
aZ
aZ
aZ
aZ
aZ
aZ
aZ
aZ
aZ
aZ
aZ
aZ
aZ
aZ
aZ
aZ
aZ
aZ
aZ
aZ
aZ
aZ
aZ
aZ
aZ
aZ
aZ
aZ
aZ
aZ
aZ
aZ
aZ
aZ
aZ
aZ
"}
(48,1,1) = {"
aW
aZ
aZ
aZ
aZ
aW
aZ
aZ
aZ
aZ
aZ
aZ
aZ
aZ
aW
aZ
aZ
aZ
aZ
aL
aZ
aZ
aZ
aW
aZ
aZ
aZ
aZ
aZ
aZ
aZ
aW
aZ
aZ
aZ
aZ
aZ
aZ
aZ
aW
aZ
aZ
"}
(49,1,1) = {"
aZ
aZ
aZ
aZ
aZ
aZ
aZ
aZ
aZ
aZ
aZ
aZ
aZ
aZ
aZ
aZ
aZ
aZ
aZ
aZ
aZ
aZ
aZ
aZ
aZ
aZ
aZ
aZ
aZ
aZ
aZ
aZ
aZ
aZ
aZ
aZ
aZ
aZ
aZ
aZ
aZ
aZ
"}
(50,1,1) = {"
aZ
aZ
aZ
aZ
aZ
aZ
aZ
aZ
aZ
aX
aX
aX
aX
aZ
aZ
aZ
aZ
aZ
aZ
aZ
aZ
aZ
aZ
aZ
aZ
aZ
aZ
aZ
aZ
aZ
aZ
aZ
aZ
aZ
aZ
aZ
aZ
aZ
aZ
aZ
aZ
aZ
"}
(51,1,1) = {"
aZ
aZ
aZ
aZ
aZ
aZ
aZ
aZ
aZ
aX
aX
aX
aX
aX
aZ
aZ
aZ
aZ
aZ
aZ
aZ
aZ
aZ
aZ
aZ
aZ
aZ
aZ
aZ
aX
aX
aX
aX
aZ
aZ
aZ
aZ
aZ
aZ
aZ
aZ
aZ
"}
(52,1,1) = {"
aZ
aP
aZ
aZ
aZ
aZ
aZ
aX
aX
aX
aX
aX
aw
aw
am
am
am
am
am
am
am
am
am
aZ
aZ
aZ
aZ
aZ
aX
aX
aX
aX
aX
aX
aZ
aZ
aG
aZ
aZ
aW
aZ
aZ
"}
(53,1,1) = {"
aW
aZ
aZ
aZ
aX
aX
aX
aX
aX
aX
aX
aX
aw
aX
aX
aZ
aZ
aZ
aZ
aZ
aZ
aZ
aw
aP
aZ
aZ
aZ
aX
aX
aX
aX
aX
aX
aX
aP
aZ
aZ
aZ
aZ
aZ
aZ
aZ
"}
(54,1,1) = {"
aZ
aZ
aZ
aZ
aX
aX
aX
aX
aX
aX
aX
aX
aw
aX
aX
aZ
aZ
aZ
aZ
aZ
aZ
aX
aw
aX
aZ
aX
aX
aX
aX
aX
aX
aX
aX
aX
aX
aX
aZ
aZ
aZ
aZ
aZ
aZ
"}
(55,1,1) = {"
aZ
aZ
aZ
aX
aX
aX
aX
aX
aX
aX
aX
aX
aw
aX
aZ
aZ
aZ
aZ
aZ
aZ
aZ
aX
aw
aX
aX
aX
aX
aX
aX
aX
aX
aX
aX
aX
aX
aX
aX
aX
aX
aZ
aZ
aZ
"}
(56,1,1) = {"
aZ
aZ
aZ
aX
aX
aX
aX
aX
aX
aX
aX
aX
aw
aX
aZ
aZ
aZ
aZ
aZ
ax
aZ
aX
aw
aX
aX
aX
aX
aX
aX
aX
aX
aX
aX
aX
aX
aX
aX
aX
aX
aX
aX
aX
"}
(57,1,1) = {"
aZ
aZ
aZ
aX
aX
aX
aX
aX
aX
aX
aX
aX
aw
aX
aX
aZ
aZ
aZ
aZ
aZ
aZ
aZ
aw
aX
aX
aX
aX
aX
aX
aX
aX
aX
aX
aX
aX
aX
aX
aX
aX
aX
aX
aX
"}
(58,1,1) = {"
aZ
aZ
aZ
aX
aX
aX
aX
aX
aX
aX
aX
aX
aw
aX
aX
aX
aZ
aZ
aZ
aZ
aZ
aZ
aw
aX
aX
aX
aX
aX
aX
aX
aX
aX
aX
aX
aX
aX
aX
aX
aX
aX
aX
aX
"}
(59,1,1) = {"
aW
aZ
aX
aX
aX
aX
aX
aX
aX
aX
aX
aX
aw
aw
aw
aw
aw
aw
aw
aw
aw
aw
aw
aX
aX
aX
aX
aX
aX
aX
aX
aX
aX
aX
aX
aX
aX
aX
aX
aX
aX
aX
"}
(60,1,1) = {"
aX
aX
aX
aX
aX
aX
aX
aX
aX
aX
aX
aX
aX
aX
aX
aX
aX
aX
aX
aX
aX
aX
aX
aX
aX
aX
aX
aX
aX
aX
aX
aX
aX
aX
aX
aX
aX
aX
aX
aX
aX
aX
"}
(61,1,1) = {"
aX
aX
aX
aX
aX
aX
aX
aX
aX
aX
aX
aX
aX
aX
aX
aX
aX
aX
aX
aX
aX
aX
aX
aX
aX
aX
aX
aX
aX
aX
aX
aX
aX
aX
aX
aX
aX
aX
aX
aX
aX
aX
"}
(62,1,1) = {"
aw
aw
aX
aX
aX
aX
aX
aX
aX
aX
aX
aX
aX
aX
aX
aX
aX
aX
aX
aX
aX
aX
aX
aX
aX
aX
aX
aX
aX
aX
aX
aX
aX
aX
aX
aX
aX
aX
aX
aX
aX
aX
"}
(63,1,1) = {"
aX
aw
aw
aX
aX
aX
aX
aX
aX
aX
aX
aX
aX
aX
aX
aX
aX
aX
aX
aX
aX
aX
aX
aX
aX
aX
aX
aX
aX
aX
aX
aX
aX
aX
aX
aX
aX
aX
aX
aX
aX
aX
"}
(64,1,1) = {"
aX
aX
aw
aX
aX
aX
aX
aX
aX
aX
aX
aX
aX
aX
aX
aX
aX
aX
aX
aX
aX
aX
aX
aX
aX
aX
aX
aX
aX
aX
aX
aX
aX
aX
aX
aX
aX
aX
aX
aX
aX
aX
"}
(65,1,1) = {"
aX
aX
aw
aX
aX
aX
aX
aX
aX
aX
aX
aX
aX
aX
aX
aX
aX
aX
aX
aX
aX
aX
aX
aX
aX
aX
aX
aX
aX
aX
aX
aX
aX
aX
aX
aX
aX
aX
aX
aX
aX
aX
"}
(66,1,1) = {"
aZ
aX
aq
aq
aq
aq
aq
aq
aq
aq
aq
aq
aq
aq
aq
aq
aq
aq
aq
aq
aq
aq
aq
aq
aq
aq
aq
aq
aq
aq
aq
aq
aq
aq
aq
aq
aq
aq
aq
aq
aq
aq
"}
