//MAP CONVERTED BY dmm2tgm.py THIS HEADER COMMENT PREVENTS RECONVERSION, DO NOT REMOVE
"a" = (
/turf/closed/wall,
/area/bigredv3/inside/wall)
"b" = (
/obj/machinery/atmospherics/pipe/simple/green/hidden,
/obj/structure/cable,
/turf/open/floor/tile/chapel{
	dir = 1
	},
/area/bigredv3/inside/colony/chapel)
"c" = (
/obj/machinery/air_alarm{
	dir = 1
	},
/turf/open/floor/tile/darkish,
/area/bigredv3/inside/colony/chapel)
"d" = (
/obj/structure/stairs/edge,
/turf/open/floor/tile/dark,
/area/bigredv3/inside/colony/chapel)
"g" = (
/obj/structure/window/framed/colony,
/obj/machinery/door/poddoor/shutters/mainship{
	dir = 2;
	id = "Chapel";
	name = "\improper Chapel Shutters"
	},
/turf/open/floor/plating,
/area/bigredv3/inside/wall)
"h" = (
/obj/structure/closet/wardrobe/chaplain_black,
/turf/open/floor/engine/cult,
/area/bigredv3/inside/colony/chapel)
"j" = (
/turf/open/floor/tile/chapel,
/area/bigredv3/inside/colony/chapel)
"k" = (
/obj/structure/bed/chair/wood/normal{
	dir = 8
	},
/turf/open/floor/tile/chapel{
	dir = 4
	},
/area/bigredv3/inside/colony/chapel)
"l" = (
/obj/structure/stairs/edge{
	dir = 1
	},
/turf/open/floor/tile/dark,
/area/bigredv3/inside/colony/chapel)
"m" = (
/turf/open/floor/engine/cult,
/area/bigredv3/inside/colony/chapel)
"n" = (
/obj/machinery/light{
	dir = 1
	},
/turf/open/floor/tile/darkish,
/area/bigredv3/inside/colony/chapel)
"q" = (
/obj/machinery/door_control{
	dir = 4;
	id = "Chapel";
	name = "Storm Shutters"
	},
/turf/open/floor/engine/cult,
/area/bigredv3/inside/colony/chapel)
"s" = (
/obj/machinery/atmospherics/pipe/simple/green/hidden{
	dir = 4
	},
/turf/open/floor/tile/darkish,
/area/bigredv3/inside/colony/chapel)
"w" = (
/obj/structure/table/wood,
/turf/open/floor/engine/cult,
/area/bigredv3/inside/colony/chapel)
"x" = (
/obj/machinery/atmospherics/pipe/manifold/green/hidden,
/obj/structure/cable,
/turf/open/floor/tile/darkish,
/area/bigredv3/inside/colony/chapel)
"y" = (
/turf/open/floor/tile/chapel{
	dir = 1
	},
/area/bigredv3/inside/colony/chapel)
"z" = (
/obj/machinery/light,
/turf/open/floor/tile/darkish,
/area/bigredv3/inside/colony/chapel)
"A" = (
/obj/machinery/atmospherics/pipe/simple/green/hidden,
/obj/structure/cable,
/turf/open/floor/tile/chapel{
	dir = 8
	},
/area/bigredv3/inside/colony/chapel)
"B" = (
/obj/structure/bed/chair/wood/normal{
	dir = 8
	},
/turf/open/floor/tile/chapel{
	dir = 1
	},
/area/bigredv3/inside/colony/chapel)
"C" = (
/obj/machinery/light{
	dir = 4
	},
/obj/machinery/power/apc/weak/ntf{
	dir = 8
	},
/obj/structure/cable,
/turf/open/floor/tile/darkish,
/area/bigredv3/inside/colony/chapel)
"D" = (
/turf/open/floor/tile/chapel{
	dir = 8
	},
/area/bigredv3/inside/colony/chapel)
"F" = (
/obj/structure/bed/chair/wood/normal{
	dir = 8
	},
/obj/effect/landmark/start/job/survivor,
/obj/effect/landmark/start/latejoinsurvivor,
/turf/open/floor/tile/chapel{
	dir = 4
	},
/area/bigredv3/inside/colony/chapel)
"H" = (
/obj/structure/window/framed/colony,
/obj/machinery/door/poddoor/shutters/mainship{
	id = "Chapel";
	name = "\improper Chapel Shutters"
	},
/turf/open/floor/plating,
/area/bigredv3/inside/wall)
"K" = (
/obj/machinery/atmospherics/components/unary/vent_pump{
	dir = 4;
	on = 1
	},
/turf/open/floor/engine/cult,
/area/bigredv3/inside/colony/chapel)
"L" = (
/obj/machinery/atmospherics/pipe/simple/green/hidden{
	dir = 4
	},
/obj/structure/table/wood,
/obj/item/storage/bible,
/turf/open/floor/engine/cult,
/area/bigredv3/inside/colony/chapel)
"M" = (
/obj/structure/cable,
/obj/machinery/atmospherics/pipe/simple/green/hidden,
/obj/machinery/door/airlock/multi_tile/mainship/generic{
	name = "\improper Chapel"
	},
/turf/open/floor/tile/darkish,
/area/bigredv3/inside/colony/chapel)
"P" = (
/obj/structure/table/wood,
/turf/open/floor/tile/darkish,
/area/bigredv3/inside/colony/chapel)
"S" = (
/obj/structure/bed/chair/wood/normal{
	dir = 8
	},
/turf/open/floor/tile/chapel{
	dir = 8
	},
/area/bigredv3/inside/colony/chapel)
"U" = (
/obj/machinery/atmospherics/components/unary/vent_pump{
	dir = 8;
	on = 1
	},
/obj/structure/cable,
/turf/open/floor/tile/darkish,
/area/bigredv3/inside/colony/chapel)
"V" = (
/obj/structure/bed/chair/wood/normal{
	dir = 8
	},
/turf/open/floor/tile/chapel,
/area/bigredv3/inside/colony/chapel)
"W" = (
/obj/machinery/atmospherics/pipe/simple/green/hidden,
/obj/structure/cable,
/turf/open/floor/tile/darkish,
/area/bigredv3/inside/colony/chapel)
"X" = (
/turf/open/floor/tile/chapel{
	dir = 4
	},
/area/bigredv3/inside/colony/chapel)
"Y" = (
/turf/open/floor/tile/darkish,
/area/bigredv3/inside/colony/chapel)
"Z" = (
/obj/structure/table/wood,
/obj/item/radio/headset/survivor,
/turf/open/floor/engine/cult,
/area/bigredv3/inside/colony/chapel)

(1,1,1) = {"
a
a
H
H
H
H
H
a
a
"}
(2,1,1) = {"
a
h
m
m
m
m
m
q
a
"}
(3,1,1) = {"
g
Y
d
m
K
m
l
Y
a
"}
(4,1,1) = {"
g
Y
Z
w
L
w
w
z
a
"}
(5,1,1) = {"
a
n
y
D
s
y
D
Y
a
"}
(6,1,1) = {"
g
Y
k
V
s
k
V
Y
a
"}
(7,1,1) = {"
g
Y
B
S
s
B
S
Y
a
"}
(8,1,1) = {"
a
n
k
V
s
F
V
z
a
"}
(9,1,1) = {"
g
Y
B
S
s
B
S
Y
a
"}
(10,1,1) = {"
g
Y
k
V
s
k
V
Y
a
"}
(11,1,1) = {"
a
n
B
S
s
B
S
z
a
"}
(12,1,1) = {"
g
Y
k
V
s
k
V
Y
a
"}
(13,1,1) = {"
g
Y
B
S
s
B
S
Y
a
"}
(14,1,1) = {"
a
n
k
V
s
k
V
z
a
"}
(15,1,1) = {"
M
W
b
A
x
y
D
Y
a
"}
(16,1,1) = {"
Y
Y
X
j
U
X
j
Y
a
"}
(17,1,1) = {"
a
Y
P
P
C
P
P
c
a
"}
(18,1,1) = {"
a
a
a
a
a
a
a
a
a
"}
