//MAP CONVERTED BY dmm2tgm.py THIS HEADER COMMENT PREVENTS RECONVERSION, DO NOT REMOVE
"c" = (
/obj/effect/ai_node,
/turf/open/floor/plating/ground/mars/random/cave,
/area/bigredv2/caves/northeast/garbledradio)
"d" = (
/turf/closed/wall/r_wall,
/area/bigredv2/caves/rock)
"e" = (
/obj/effect/landmark/lv624/fog_blocker,
/turf/open/floor/plating/ground/mars/random/cave,
/area/bigredv2/caves/northeast)
"g" = (
/obj/machinery/miner/damaged/platinum,
/turf/open/floor/plating/ground/mars/random/cave,
/area/bigredv2/caves/northeast)
"h" = (
/turf/closed/wall/r_wall,
/area/bigredv2/caves/lambda_lab)
"k" = (
/turf/open/floor/plating,
/area/bigredv2/caves/lambda_lab)
"l" = (
/obj/machinery/chem_dispenser,
/turf/open/floor/tile/whiteyellow{
	dir = 9
	},
/area/bigredv2/caves/lambda_lab)
"o" = (
/turf/open/floor/plating/ground/mars/random/cave,
/area/bigredv2/caves/northeast/garbledradio)
"r" = (
/turf/closed/mineral/smooth/bigred/indestructible,
/area/space)
"v" = (
/obj/effect/ai_node,
/turf/open/floor/plating/ground/mars/random/cave,
/area/bigredv2/caves/northeast)
"w" = (
/obj/structure/fence/standard/xenoproof,
/turf/open/floor/plating/ground/mars/random/cave,
/area/bigredv2/caves/northeast)
"x" = (
/turf/open/floor/plating/ground/mars/random/cave,
/area/bigredv2/caves/northeast)
"y" = (
/turf/open/floor/plating/ground/mars/random/cave/rock,
/area/bigredv2/caves/northeast)
"z" = (
/turf/open/floor/plating/ground/mars/random/cave/rock,
/area/bigredv2/caves/northeast/garbledradio)
"C" = (
/obj/machinery/chem_dispenser,
/turf/open/floor/tile/whiteyellow{
	dir = 1
	},
/area/bigredv2/caves/lambda_lab)
"E" = (
/obj/effect/ai_node,
/obj/effect/landmark/excavation_site_spawner,
/turf/open/floor/plating/ground/mars/random/cave,
/area/bigredv2/caves/northeast)
"G" = (
/obj/machinery/chem_master,
/turf/open/floor/tile/whiteyellow{
	dir = 5
	},
/area/bigredv2/caves/lambda_lab)
"I" = (
/obj/effect/landmark/lv624/fog_blocker,
/turf/closed/mineral/smooth/bigred,
/area/bigredv2/caves/rock)
"M" = (
/turf/closed/mineral/smooth/bigred,
/area/bigredv2/caves/rock)
"N" = (
/obj/structure/closet/crate/internals,
/turf/open/floor/plating,
/area/bigredv2/caves/lambda_lab)
"V" = (
/obj/effect/landmark/lv624/fog_blocker,
/obj/effect/ai_node,
/turf/open/floor/plating/ground/mars/random/cave,
/area/bigredv2/caves/northeast)
"X" = (
/obj/effect/landmark/excavation_site_spawner,
/turf/open/floor/plating/ground/mars/random/cave,
/area/bigredv2/caves/northeast/garbledradio)
"Y" = (
/obj/structure/closet/crate/freezer/rations,
/turf/open/floor/plating,
/area/bigredv2/caves/lambda_lab)

(1,1,1) = {"
r
r
r
r
r
r
r
r
r
r
r
r
r
r
r
r
r
r
r
r
M
M
M
M
M
o
o
o
o
z
M
M
"}
(2,1,1) = {"
r
r
r
r
r
r
r
r
r
r
r
r
r
r
r
r
r
r
r
r
M
M
M
z
z
o
o
o
o
z
M
M
"}
(3,1,1) = {"
r
r
r
r
r
r
r
r
r
r
r
r
r
r
r
r
r
r
r
r
M
M
M
o
o
o
o
o
o
z
M
M
"}
(4,1,1) = {"
r
r
r
r
r
r
r
r
r
r
r
r
r
r
r
r
r
r
r
r
M
M
M
o
o
o
o
o
o
o
z
M
"}
(5,1,1) = {"
r
r
r
r
r
r
r
r
r
r
r
r
r
r
r
r
r
r
r
r
M
M
M
o
c
o
o
o
o
c
z
M
"}
(6,1,1) = {"
r
r
r
r
r
r
r
r
r
r
r
r
r
r
r
r
r
r
r
r
M
M
M
z
o
o
o
o
o
o
z
M
"}
(7,1,1) = {"
r
r
r
r
r
r
r
r
r
r
r
r
r
r
r
r
r
r
r
r
M
M
M
M
M
z
o
o
o
o
z
M
"}
(8,1,1) = {"
r
r
r
r
r
r
r
r
r
r
r
r
r
r
r
r
r
r
r
r
M
M
M
M
M
M
o
o
o
o
o
z
"}
(9,1,1) = {"
r
r
r
r
r
r
r
r
r
r
r
r
r
r
r
r
r
r
r
r
M
M
M
M
M
M
z
o
o
o
o
o
"}
(10,1,1) = {"
r
r
r
r
r
r
r
r
r
r
r
r
r
r
r
r
r
r
r
r
M
M
M
M
M
M
M
z
o
c
o
o
"}
(11,1,1) = {"
r
r
r
r
r
r
r
r
r
r
r
r
r
r
r
r
r
r
r
r
M
M
M
M
M
M
M
M
M
o
c
o
"}
(12,1,1) = {"
r
r
r
r
r
r
r
r
r
r
r
r
r
r
r
r
r
r
r
r
M
M
M
M
M
M
M
M
M
z
o
c
"}
(13,1,1) = {"
r
r
r
r
r
r
r
r
r
r
r
r
r
r
r
r
r
r
r
r
M
M
M
M
M
M
M
M
M
M
M
M
"}
(14,1,1) = {"
r
r
r
r
r
r
r
r
r
r
r
r
r
r
r
r
r
r
r
r
M
M
M
M
M
M
M
M
M
M
M
M
"}
(15,1,1) = {"
r
r
r
r
r
r
r
r
r
r
r
r
r
r
r
r
r
r
r
r
M
M
M
M
M
M
M
d
d
d
d
d
"}
(16,1,1) = {"
r
r
r
r
r
r
r
r
r
r
r
r
r
r
r
r
r
r
r
r
M
M
M
M
M
M
M
d
o
o
o
o
"}
(17,1,1) = {"
r
r
r
r
r
r
r
r
r
r
r
r
r
r
r
r
r
r
r
r
M
M
M
M
M
M
M
d
o
o
o
o
"}
(18,1,1) = {"
r
r
r
r
r
r
r
r
r
r
r
r
r
r
r
r
r
r
r
r
M
M
M
M
M
M
M
d
o
o
o
c
"}
(19,1,1) = {"
r
r
r
r
r
r
r
r
r
r
r
r
r
r
r
r
r
r
r
r
M
M
M
M
M
M
M
o
o
o
o
o
"}
(20,1,1) = {"
r
r
r
r
r
r
r
r
r
r
r
r
r
r
r
r
r
r
r
r
M
M
M
M
M
M
X
o
o
o
o
o
"}
(21,1,1) = {"
r
r
r
r
r
r
r
r
r
r
r
r
r
r
r
r
r
r
r
r
M
M
M
M
M
M
o
o
o
o
o
o
"}
(22,1,1) = {"
r
r
r
r
r
r
r
r
r
r
r
r
r
r
r
r
r
r
r
r
M
M
M
M
M
o
o
o
o
o
o
o
"}
(23,1,1) = {"
r
r
r
r
r
r
r
r
r
r
r
r
r
r
r
r
r
r
r
r
M
M
M
M
M
o
c
o
o
o
o
c
"}
(24,1,1) = {"
r
r
r
r
r
r
r
r
r
r
r
r
r
r
r
r
r
r
r
r
M
M
M
M
o
o
o
o
o
o
o
o
"}
(25,1,1) = {"
r
r
r
r
r
r
r
r
r
r
r
r
r
r
r
r
r
r
r
r
M
M
M
o
o
o
o
o
o
o
o
o
"}
(26,1,1) = {"
r
r
r
r
r
r
r
r
r
r
r
r
r
r
r
r
r
r
r
r
M
M
M
x
x
o
o
o
o
o
o
M
"}
(27,1,1) = {"
r
r
r
r
r
r
r
r
r
r
r
r
r
r
r
r
r
r
r
r
M
M
x
x
x
x
x
o
o
o
M
M
"}
(28,1,1) = {"
r
r
r
r
r
r
r
r
r
r
r
r
r
r
r
r
r
r
r
r
M
M
v
x
x
x
v
x
o
o
M
I
"}
(29,1,1) = {"
r
r
r
r
r
r
r
r
r
r
r
r
r
r
r
r
r
r
r
r
M
M
x
x
x
x
x
x
o
M
I
M
"}
(30,1,1) = {"
r
r
r
r
r
r
r
r
r
r
r
r
r
r
r
r
r
r
r
r
M
M
M
x
x
x
x
x
M
I
M
M
"}
(31,1,1) = {"
r
r
r
r
r
r
r
r
r
r
r
r
r
r
r
r
r
r
r
r
M
M
M
x
x
x
x
x
M
I
M
h
"}
(32,1,1) = {"
r
r
r
r
r
r
r
r
r
r
r
r
r
r
r
r
r
r
r
r
M
M
M
x
x
x
x
x
M
I
M
h
"}
(33,1,1) = {"
r
r
r
r
r
r
r
r
r
r
r
r
r
r
r
r
r
r
r
r
M
M
M
x
x
x
v
x
M
I
M
h
"}
(34,1,1) = {"
r
r
r
r
r
r
r
r
r
r
r
r
r
r
r
r
r
r
r
r
M
M
M
x
x
x
x
x
M
I
M
h
"}
(35,1,1) = {"
r
r
r
r
r
r
r
r
r
r
r
r
r
r
r
r
r
r
r
r
M
M
M
x
x
x
x
x
M
I
M
h
"}
(36,1,1) = {"
r
r
r
r
r
r
r
r
r
r
r
r
r
r
r
r
r
r
r
r
M
M
M
x
x
x
x
x
M
I
M
M
"}
(37,1,1) = {"
r
r
r
r
r
r
r
r
r
r
r
r
r
r
r
r
r
r
r
r
M
M
M
x
x
x
x
x
M
I
M
M
"}
(38,1,1) = {"
r
r
r
r
r
r
r
r
r
r
r
r
r
r
r
r
r
r
r
r
M
M
M
x
x
x
x
x
M
I
M
M
"}
(39,1,1) = {"
r
r
r
r
r
r
r
r
r
r
r
r
r
r
r
r
r
r
r
r
M
M
M
x
x
x
x
x
w
I
h
h
"}
(40,1,1) = {"
r
r
r
r
r
r
r
r
r
r
r
r
r
r
r
r
r
r
r
r
M
M
M
x
x
x
x
x
w
e
h
k
"}
(41,1,1) = {"
r
r
r
r
r
r
r
r
r
r
r
r
r
r
r
r
r
r
r
r
M
M
M
x
x
x
x
x
w
e
h
N
"}
(42,1,1) = {"
r
r
r
r
r
r
r
r
r
r
r
r
r
r
r
r
r
r
r
r
M
M
M
x
x
x
x
x
w
e
h
Y
"}
(43,1,1) = {"
r
r
r
r
r
r
r
r
r
r
r
r
r
r
r
r
r
r
r
r
M
M
M
x
x
x
v
x
w
V
h
h
"}
(44,1,1) = {"
r
r
r
r
r
r
r
r
r
r
r
r
r
r
r
r
r
r
r
r
M
M
M
x
x
x
x
x
w
e
h
l
"}
(45,1,1) = {"
r
r
r
r
r
r
r
r
r
r
r
r
r
r
r
r
r
r
r
r
M
M
M
x
x
x
x
x
w
e
h
C
"}
(46,1,1) = {"
r
r
r
r
r
r
r
r
r
r
r
r
r
r
r
r
r
r
r
r
M
M
M
x
x
x
x
x
w
e
h
C
"}
(47,1,1) = {"
r
r
r
r
r
r
r
r
r
r
r
r
r
r
r
r
r
r
r
r
M
M
M
x
x
x
x
x
w
e
h
G
"}
(48,1,1) = {"
r
r
r
r
r
r
r
r
r
r
r
r
r
r
r
r
r
r
r
r
M
M
M
M
x
x
x
x
w
e
h
h
"}
(49,1,1) = {"
r
r
r
r
r
r
r
r
r
r
r
r
r
r
r
r
r
r
r
r
M
M
M
M
x
x
x
x
w
w
I
h
"}
(50,1,1) = {"
r
r
r
r
r
r
r
r
r
r
r
r
r
r
r
r
r
r
r
r
M
M
M
M
x
x
x
x
x
x
M
I
"}
(51,1,1) = {"
r
r
r
r
r
r
r
r
r
r
r
r
r
r
r
r
r
r
r
r
M
M
M
M
M
x
x
E
x
x
x
y
"}
(52,1,1) = {"
r
r
r
r
r
r
r
r
r
r
r
r
r
r
r
r
r
r
r
r
M
M
M
M
M
x
v
x
x
x
v
x
"}
(53,1,1) = {"
r
r
r
r
r
r
r
r
r
r
r
r
r
r
r
r
r
r
r
r
M
M
M
M
M
M
x
x
x
x
x
x
"}
(54,1,1) = {"
r
r
r
r
r
r
r
r
r
r
r
r
r
r
r
r
r
r
r
r
M
M
M
M
M
M
x
x
x
x
x
x
"}
(55,1,1) = {"
r
r
r
r
r
r
r
r
r
r
r
r
r
r
r
r
r
r
r
r
M
M
M
M
M
M
M
x
g
x
x
x
"}
(56,1,1) = {"
r
r
r
r
r
r
r
r
r
r
r
r
r
r
r
r
r
r
r
r
M
M
M
M
M
M
M
x
x
x
x
x
"}
(57,1,1) = {"
r
r
r
r
r
r
r
r
r
r
r
r
r
r
r
r
r
r
r
r
M
M
M
M
M
M
M
x
x
x
x
x
"}
(58,1,1) = {"
r
r
r
r
r
r
r
r
r
r
r
r
r
r
r
r
r
r
r
r
M
M
M
M
M
M
M
x
x
x
v
x
"}
(59,1,1) = {"
r
r
r
r
r
r
r
r
r
r
r
r
r
r
r
r
r
r
r
r
M
M
M
M
M
M
M
x
x
x
x
x
"}
(60,1,1) = {"
r
r
r
r
r
r
r
r
r
r
r
r
r
r
r
r
r
r
r
r
M
M
M
M
M
M
M
M
x
x
v
x
"}
(61,1,1) = {"
r
r
r
r
r
r
r
r
r
r
r
r
r
r
r
r
r
r
r
r
M
M
M
M
M
M
M
M
M
x
x
x
"}
(62,1,1) = {"
r
r
r
r
r
r
r
r
r
r
r
r
r
r
r
r
r
r
r
r
M
M
M
M
M
M
M
M
M
x
x
x
"}
(63,1,1) = {"
r
r
r
r
r
r
r
r
r
r
r
r
r
r
r
r
r
r
r
r
M
M
M
M
M
M
M
M
M
x
x
x
"}
(64,1,1) = {"
r
r
r
r
r
r
r
r
r
r
r
r
r
r
r
r
r
r
r
r
M
M
M
M
M
M
M
M
M
x
x
x
"}
(65,1,1) = {"
r
r
r
r
r
r
r
r
r
r
r
r
r
r
r
r
r
r
r
r
M
M
M
M
M
M
M
M
M
x
x
x
"}
