//MAP CONVERTED BY dmm2tgm.py THIS HEADER COMMENT PREVENTS RECONVERSION, DO NOT REMOVE
"a" = (
/turf/open/space/basic,
/area/space)
"d" = (
/turf/open/floor/plating/ground/mars/random/cave/rock,
/area/bigredv2/caves/southeast/garbledradio)
"k" = (
/turf/open/floor/plating/ground/mars/random/cave,
/area/bigredv2/caves/east)
"p" = (
/turf/open/floor/plating/ground/mars/random/cave,
/area/bigredv2/caves/southeast/garbledradio)
"s" = (
/turf/closed/mineral/smooth/bigred/indestructible,
/area/space)
"t" = (
/obj/effect/ai_node,
/turf/open/floor/plating/ground/mars/random/cave,
/area/bigredv2/caves/southeast/garbledradio)
"v" = (
/turf/closed/mineral/smooth/bigred,
/area/bigredv2/caves/rock)
"w" = (
/turf/open/floor/plating/ground/mars/random/cave/rock,
/area/bigredv2/caves/southeast)
"B" = (
/turf/open/floor/plating/ground/mars/random/cave,
/area/bigredv2/caves/southeast)
"G" = (
/obj/effect/ai_node,
/turf/open/floor/plating/ground/mars/random/cave/rock,
/area/bigredv2/caves/southeast/garbledradio)
"H" = (
/obj/docking_port/stationary/crashmode,
/turf/closed/mineral/smooth/bigred,
/area/bigredv2/caves/rock)
"I" = (
/obj/effect/landmark/patrol_point/tgmc_11,
/turf/open/floor/plating/ground/mars/random/cave,
/area/bigredv2/caves/southeast)
"J" = (
/obj/machinery/miner/damaged/platinum,
/turf/open/floor/plating/ground/mars/random/cave,
/area/bigredv2/caves/southeast/garbledradio)
"V" = (
/obj/machinery/miner/damaged/platinum,
/turf/open/floor/plating/ground/mars/random/cave,
/area/bigredv2/caves/southeast)
"W" = (
/obj/effect/ai_node,
/turf/open/floor/plating/ground/mars/random/cave/rock,
/area/bigredv2/caves/southeast)
"Z" = (
/obj/effect/ai_node,
/turf/open/floor/plating/ground/mars/random/cave,
/area/bigredv2/caves/southeast)

(1,1,1) = {"
v
v
v
v
v
v
v
v
v
v
v
v
v
v
v
v
t
p
p
p
p
t
d
v
v
v
v
v
v
v
v
B
B
B
B
B
B
v
v
v
v
v
v
v
v
v
v
v
v
v
B
B
B
B
v
v
v
v
v
v
v
v
v
s
s
s
a
"}
(2,1,1) = {"
k
v
v
v
v
v
v
v
v
v
v
v
v
v
d
d
p
p
p
v
p
p
d
v
v
v
v
v
v
v
v
B
B
B
B
B
v
v
v
v
v
v
v
v
v
v
v
v
v
v
B
B
B
B
v
v
v
v
v
v
v
v
v
s
s
s
a
"}
(3,1,1) = {"
v
v
v
v
v
v
v
v
v
v
v
v
v
v
p
p
p
p
p
v
d
p
d
v
v
v
v
v
v
v
v
B
B
B
B
B
v
v
v
v
v
v
v
v
v
v
v
v
v
v
w
B
w
B
v
v
v
v
v
v
v
v
v
s
s
s
a
"}
(4,1,1) = {"
v
v
v
v
v
v
v
v
v
v
v
v
v
G
p
p
t
p
v
v
v
p
d
v
v
v
v
v
v
v
v
B
B
B
B
B
v
v
v
v
v
v
v
v
v
v
v
v
v
v
B
B
B
B
v
v
v
v
v
v
v
v
v
s
s
s
a
"}
(5,1,1) = {"
v
v
v
v
v
v
v
v
v
v
v
v
v
p
p
d
p
p
v
v
v
p
d
v
v
v
v
v
v
v
v
B
B
Z
B
B
v
v
v
v
v
v
v
v
v
v
v
v
v
v
B
B
Z
B
v
v
v
v
v
v
v
v
v
s
s
s
a
"}
(6,1,1) = {"
v
v
v
v
v
v
v
v
v
v
v
d
d
p
p
d
p
p
v
v
v
p
d
v
v
v
v
v
v
v
v
B
B
B
w
B
v
v
H
v
v
v
v
v
v
v
v
v
v
v
B
B
B
B
v
v
v
v
v
v
v
v
v
s
s
s
a
"}
(7,1,1) = {"
v
v
v
v
v
v
v
v
v
v
v
p
p
p
d
p
p
v
v
v
v
p
d
v
v
v
v
v
v
v
v
w
B
B
B
B
v
v
v
v
v
v
v
v
v
v
v
v
v
Z
B
B
Z
B
v
v
v
v
v
v
v
v
v
s
s
s
a
"}
(8,1,1) = {"
v
v
v
v
v
v
v
v
v
v
v
p
p
t
p
v
v
v
v
v
v
p
d
v
v
v
v
v
v
v
v
B
B
B
B
B
v
v
v
v
v
v
v
v
v
v
v
v
B
B
B
w
B
B
v
v
v
v
v
v
v
v
v
s
s
s
a
"}
(9,1,1) = {"
v
v
v
v
v
v
v
v
v
v
v
p
G
p
p
v
v
v
v
v
v
p
d
v
v
v
v
v
v
v
v
B
B
B
B
B
v
v
v
v
v
v
v
v
v
v
v
v
B
B
w
w
B
B
v
v
v
v
v
v
v
v
v
s
s
s
a
"}
(10,1,1) = {"
v
v
v
v
v
v
v
v
v
v
d
p
d
p
p
v
v
v
v
p
p
t
d
v
v
v
v
v
v
v
B
B
B
B
B
v
v
v
v
v
v
v
v
v
v
B
B
B
B
B
B
B
B
v
v
v
v
v
v
v
v
v
v
s
s
s
a
"}
(11,1,1) = {"
v
v
v
v
v
v
v
v
v
v
p
p
d
p
d
d
d
d
d
p
p
p
d
v
v
v
v
v
v
B
B
B
B
Z
B
v
v
v
v
v
v
v
B
w
B
B
B
w
B
B
B
B
B
v
v
v
v
v
v
v
v
v
v
s
s
s
a
"}
(12,1,1) = {"
H
v
v
v
v
v
v
v
v
v
p
p
p
d
p
p
p
p
d
p
p
p
p
p
v
v
v
B
Z
B
B
B
Z
B
B
v
v
v
v
v
B
B
Z
w
B
w
B
B
B
Z
v
v
v
v
v
v
v
v
v
v
v
v
v
s
s
s
a
"}
(13,1,1) = {"
v
v
v
v
v
v
v
v
v
v
p
p
p
p
p
p
t
p
p
p
p
p
p
p
B
B
B
B
B
B
B
B
B
B
B
v
v
w
B
B
B
B
B
B
B
B
w
B
B
v
v
v
v
v
v
v
v
v
v
v
v
v
v
s
s
s
a
"}
(14,1,1) = {"
d
p
v
v
v
v
v
v
v
d
p
p
p
p
p
t
p
p
p
p
p
G
p
p
p
B
B
B
Z
B
B
Z
w
B
B
B
B
B
B
B
B
w
B
B
B
B
B
v
v
v
v
v
v
v
v
v
v
v
v
v
v
v
v
s
s
s
a
"}
(15,1,1) = {"
G
v
v
v
v
v
v
v
v
p
t
p
t
p
p
p
t
p
p
d
v
p
p
p
p
B
B
B
B
B
B
B
Z
B
B
w
B
Z
B
w
w
B
Z
v
v
v
v
v
v
v
v
v
v
v
v
v
v
v
v
v
v
v
v
s
s
s
a
"}
(16,1,1) = {"
d
v
v
v
v
v
v
d
d
p
d
p
p
p
p
p
p
p
p
v
v
v
v
p
B
B
B
B
B
B
B
B
B
B
B
B
B
B
B
B
B
v
v
v
v
v
v
v
v
v
v
v
v
v
v
v
v
v
v
v
v
v
v
s
s
s
a
"}
(17,1,1) = {"
p
v
v
v
v
v
v
p
p
p
d
p
p
p
v
v
v
v
v
v
v
v
v
v
v
v
B
B
B
B
B
B
B
B
B
B
v
v
v
v
v
v
v
v
v
v
v
v
v
v
v
v
v
v
v
v
v
v
v
v
v
v
v
s
s
s
a
"}
(18,1,1) = {"
p
v
v
v
v
v
v
d
p
d
p
p
p
v
v
v
v
v
v
v
v
v
v
v
v
v
B
B
B
B
B
B
B
B
B
B
v
v
v
v
v
v
v
v
v
v
v
v
v
v
v
v
v
v
v
v
v
v
v
v
v
v
v
s
s
s
a
"}
(19,1,1) = {"
p
v
v
v
v
v
p
p
p
d
p
v
v
v
v
v
v
v
v
v
v
v
v
v
v
B
B
B
Z
B
B
B
B
Z
B
B
v
v
v
v
v
v
v
v
v
v
v
v
v
v
v
v
v
v
v
v
v
v
v
v
v
v
v
s
s
s
a
"}
(20,1,1) = {"
p
v
v
p
p
p
t
p
p
p
t
v
v
v
v
v
v
v
v
B
B
B
B
B
B
B
B
B
B
B
B
B
B
w
B
B
v
v
v
v
v
v
v
v
v
v
v
v
v
v
v
v
v
v
v
v
v
v
v
v
v
v
v
s
s
s
a
"}
(21,1,1) = {"
p
p
p
p
p
p
p
p
d
p
v
v
v
v
v
v
v
v
v
B
Z
B
B
B
Z
B
B
B
Z
B
B
B
w
B
B
B
B
v
v
v
v
v
v
v
v
v
v
v
v
v
v
v
v
v
v
v
v
v
v
v
v
v
v
s
s
s
a
"}
(22,1,1) = {"
t
p
p
p
d
d
p
p
p
p
v
v
v
v
v
v
v
B
B
B
B
B
B
B
B
B
w
B
B
B
V
B
B
B
B
B
B
v
v
v
v
v
v
v
v
v
v
v
v
v
v
v
v
v
v
v
v
v
v
v
v
v
v
s
s
s
a
"}
(23,1,1) = {"
J
t
p
d
p
p
t
p
p
v
v
v
v
v
B
B
B
B
w
B
B
B
w
B
B
B
w
B
B
B
B
B
B
B
B
B
v
v
v
v
v
v
v
v
v
v
v
v
v
v
v
v
v
v
v
v
v
v
v
v
v
v
v
s
s
s
a
"}
(24,1,1) = {"
p
d
d
p
p
p
p
d
v
v
v
v
v
v
B
B
B
B
B
B
B
B
B
B
B
B
B
B
B
B
B
B
B
B
B
B
v
v
v
v
v
v
v
v
v
v
v
v
v
v
v
v
v
v
v
v
v
v
v
v
v
v
v
s
s
s
a
"}
(25,1,1) = {"
d
p
p
d
v
v
v
v
v
v
v
v
B
B
W
B
B
B
B
B
Z
B
B
B
Z
B
B
B
B
Z
B
B
B
B
B
B
v
v
v
v
v
v
v
v
v
v
v
v
v
v
v
v
v
v
v
v
v
v
v
v
v
v
v
s
s
s
a
"}
(26,1,1) = {"
p
p
p
d
v
v
v
v
v
v
v
v
B
B
B
B
B
B
B
B
B
B
B
w
v
B
B
B
Z
B
B
B
B
Z
B
v
v
v
v
v
v
v
v
v
v
v
v
v
v
v
v
v
v
v
v
v
v
v
v
v
v
v
v
s
s
s
a
"}
(27,1,1) = {"
v
v
v
v
v
v
v
v
v
v
B
Z
B
B
Z
B
B
B
B
B
B
B
B
v
v
v
B
B
B
B
B
B
B
B
B
v
v
v
v
v
v
v
v
v
v
v
v
v
v
v
v
v
v
v
v
v
v
v
v
v
v
v
v
s
s
s
a
"}
(28,1,1) = {"
v
v
v
v
v
v
v
v
v
B
B
w
B
B
B
B
B
B
B
B
B
B
B
v
v
v
B
B
B
w
B
B
B
B
v
v
v
v
v
v
v
v
v
v
v
v
v
v
v
v
v
v
v
v
v
v
v
v
v
v
v
v
v
s
s
s
a
"}
(29,1,1) = {"
v
v
v
v
v
v
v
v
v
B
B
B
B
w
B
B
B
B
B
B
v
v
v
v
v
v
B
B
B
B
B
B
B
v
v
v
v
v
v
v
v
v
v
v
v
v
v
v
v
v
v
v
v
v
v
v
v
v
v
v
v
v
v
s
s
s
a
"}
(30,1,1) = {"
v
v
v
v
v
v
v
v
v
B
B
B
B
B
B
B
B
B
B
B
v
v
v
v
v
v
v
v
B
B
B
B
v
v
v
v
v
v
v
v
v
v
v
v
v
v
v
v
v
v
v
v
v
v
v
v
v
v
v
v
v
v
v
s
s
s
a
"}
(31,1,1) = {"
v
v
v
v
v
v
v
Z
B
B
B
B
B
B
Z
w
B
v
v
v
v
v
v
v
v
v
v
v
v
B
B
v
v
v
v
v
v
v
v
v
v
v
v
v
v
v
v
v
v
v
v
v
v
v
v
v
v
v
v
v
v
v
v
s
s
s
a
"}
(32,1,1) = {"
B
B
v
v
v
v
v
B
B
B
w
B
w
B
B
B
B
v
v
v
v
v
v
v
v
v
v
v
v
v
v
v
v
v
v
v
v
v
v
v
v
v
v
v
v
v
v
v
v
v
v
v
v
v
v
v
v
v
v
v
v
v
v
s
s
s
a
"}
(33,1,1) = {"
Z
B
B
B
Z
v
v
B
B
B
B
B
B
B
B
v
v
v
v
v
v
v
v
v
v
v
v
v
v
v
v
v
v
v
v
v
v
v
v
v
v
v
v
v
v
v
v
v
v
v
v
v
v
v
v
v
v
v
v
v
v
v
v
s
s
s
a
"}
(34,1,1) = {"
B
B
B
B
B
B
B
B
B
B
B
B
B
B
v
v
v
v
v
v
v
v
v
v
v
v
v
v
v
v
v
v
v
v
v
v
v
v
v
v
v
v
v
v
v
v
v
v
v
v
v
v
v
v
v
v
v
v
v
v
v
v
v
s
s
s
a
"}
(35,1,1) = {"
B
B
B
B
B
w
B
B
w
B
B
B
B
v
v
v
v
v
v
v
v
v
v
v
v
v
v
v
v
v
v
v
v
v
v
v
v
v
v
v
v
v
v
v
v
v
v
v
v
v
v
v
v
v
v
v
v
v
v
v
v
v
v
s
s
s
a
"}
(36,1,1) = {"
B
B
B
B
B
B
B
B
B
B
B
B
v
v
v
v
v
v
v
v
v
v
v
v
v
v
v
v
v
v
v
v
v
v
v
v
v
v
v
v
v
v
v
v
v
v
v
v
v
v
v
v
v
v
v
v
v
v
v
v
v
v
v
s
s
s
a
"}
(37,1,1) = {"
Z
w
B
B
Z
B
B
Z
B
B
B
Z
v
v
v
v
v
v
v
v
v
v
v
v
v
v
v
v
v
v
v
v
v
v
v
v
v
v
v
v
v
v
v
v
v
v
v
v
v
v
v
v
v
v
v
v
v
v
v
v
v
v
v
s
s
s
a
"}
(38,1,1) = {"
v
v
B
B
B
B
B
B
B
B
B
B
B
B
v
v
v
v
v
v
v
v
v
v
v
v
v
v
v
v
v
v
v
v
v
v
v
v
v
v
v
v
v
v
v
v
v
v
v
v
v
v
v
v
v
v
v
v
v
v
v
v
v
s
s
s
a
"}
(39,1,1) = {"
v
v
B
B
B
w
B
Z
w
B
w
B
B
B
Z
B
Z
B
v
v
v
v
v
v
v
v
v
v
v
v
v
v
v
v
v
v
v
v
v
v
v
v
v
v
v
v
v
v
v
v
v
v
v
v
v
v
v
v
v
v
v
v
v
s
s
s
a
"}
(40,1,1) = {"
v
v
B
B
B
B
B
w
B
B
B
B
B
B
B
B
B
B
B
v
v
v
v
v
v
v
v
v
v
v
v
v
v
v
v
v
v
v
v
v
v
v
v
v
v
v
v
v
v
v
v
v
v
v
v
v
v
v
v
v
v
v
v
s
s
s
a
"}
(41,1,1) = {"
B
B
B
B
B
B
B
B
B
B
B
B
w
B
B
B
B
B
B
B
v
v
v
v
v
v
v
v
v
v
v
v
v
v
v
v
v
v
v
v
v
v
v
v
v
v
v
v
v
v
v
v
v
v
v
v
v
v
v
v
v
v
v
s
s
s
a
"}
(42,1,1) = {"
B
B
B
B
B
B
B
B
B
I
B
B
B
B
B
B
Z
B
B
B
Z
v
v
v
v
v
v
v
v
v
v
v
v
v
v
v
v
v
v
v
v
v
v
v
v
v
v
v
v
v
v
v
v
v
v
v
v
v
v
v
v
v
v
s
s
s
a
"}
(43,1,1) = {"
B
w
B
B
B
B
B
B
w
B
B
B
B
B
B
V
B
B
w
B
B
v
v
v
v
v
v
v
v
v
v
v
v
v
v
v
v
v
v
v
v
v
v
v
v
v
v
v
v
v
v
v
v
v
v
v
v
v
v
v
v
v
v
s
s
s
a
"}
(44,1,1) = {"
B
B
B
B
B
B
B
B
B
B
B
w
B
B
B
B
B
w
B
B
B
B
v
v
v
v
v
v
v
v
v
v
v
v
v
v
v
v
v
v
v
v
v
v
v
v
v
v
v
v
v
v
v
v
v
v
v
v
v
v
v
v
v
s
s
s
a
"}
(45,1,1) = {"
B
Z
B
B
B
B
w
Z
B
B
B
B
B
B
Z
B
B
B
B
B
Z
B
v
v
v
v
v
v
v
v
v
v
v
v
v
v
s
s
s
s
s
s
s
s
s
s
s
s
s
s
s
s
s
s
s
s
s
s
s
s
s
s
s
s
s
s
a
"}
(46,1,1) = {"
B
B
B
B
w
B
B
B
B
v
B
B
B
B
B
B
B
B
B
B
w
B
v
v
v
v
v
v
v
v
v
v
v
v
v
v
s
s
s
s
s
s
s
s
s
s
s
s
s
s
s
s
s
s
s
s
s
s
s
s
s
s
s
s
s
s
a
"}
(47,1,1) = {"
B
B
B
B
B
B
B
B
B
v
v
v
B
B
B
B
w
B
B
B
B
B
v
v
v
v
v
v
v
v
v
v
v
v
v
v
s
s
s
s
s
s
s
s
s
s
s
s
s
s
s
s
s
s
s
s
s
s
s
s
s
s
s
s
s
s
a
"}
(48,1,1) = {"
B
B
B
B
B
B
B
v
v
v
v
v
v
v
v
B
Z
B
B
B
Z
B
v
v
v
v
v
v
v
v
v
v
v
v
v
v
s
s
s
s
s
s
s
s
s
s
s
s
s
s
s
s
s
s
s
s
s
s
s
s
s
s
s
s
s
s
a
"}
(49,1,1) = {"
B
Z
B
B
B
B
v
v
v
v
v
v
v
v
v
v
v
B
B
B
B
B
v
v
v
v
v
v
v
v
v
v
v
v
v
v
s
s
s
s
s
s
s
s
s
s
s
s
s
s
s
s
s
s
s
s
s
s
s
s
s
s
s
s
s
s
a
"}
(50,1,1) = {"
B
B
B
v
v
v
v
v
v
v
v
v
v
v
v
v
v
v
v
B
B
v
v
v
v
v
v
v
v
v
v
v
v
v
v
v
s
s
s
s
s
s
s
s
s
s
s
s
s
s
s
s
s
s
s
s
s
s
s
s
s
s
s
s
s
s
a
"}
(51,1,1) = {"
B
B
B
v
v
v
v
v
v
v
v
v
v
v
v
v
v
v
v
v
v
v
v
v
v
v
v
v
v
v
v
v
v
v
v
v
s
s
s
s
s
s
s
s
s
s
s
s
s
s
s
s
s
s
s
s
s
s
s
s
s
s
s
s
s
s
a
"}
(52,1,1) = {"
v
v
v
v
v
v
v
v
v
v
v
v
v
v
v
v
v
v
v
v
v
v
v
v
v
v
v
v
v
v
v
v
v
v
v
v
s
s
s
s
s
s
s
s
s
s
s
s
s
s
s
s
s
s
s
s
s
s
s
s
s
s
s
s
s
s
a
"}
(53,1,1) = {"
v
v
v
v
v
v
v
v
v
v
v
v
v
v
v
v
v
v
v
v
v
v
v
v
v
v
v
v
v
v
v
v
v
v
v
v
s
s
s
s
s
s
s
s
s
s
s
s
s
s
s
s
s
s
s
s
s
s
s
s
s
s
s
s
s
s
a
"}
(54,1,1) = {"
v
v
v
v
v
v
v
v
v
v
v
v
v
v
v
v
v
v
v
v
v
v
v
v
v
v
v
v
v
v
v
v
v
v
v
v
s
s
s
s
s
s
s
s
s
s
s
s
s
s
s
s
s
s
s
s
s
s
s
s
s
s
s
s
s
s
a
"}
(55,1,1) = {"
v
v
v
v
v
v
v
v
v
v
v
v
v
v
v
v
v
v
v
v
v
v
v
v
v
v
v
v
v
v
v
v
v
v
v
v
s
s
s
s
s
s
s
s
s
s
s
s
s
s
s
s
s
s
s
s
s
s
s
s
s
s
s
s
s
s
a
"}
(56,1,1) = {"
v
v
v
v
v
v
v
v
v
v
v
v
v
v
v
v
v
v
v
v
v
v
v
v
v
v
v
v
v
v
v
v
v
v
v
v
s
s
s
s
s
s
s
s
s
s
s
s
s
s
s
s
s
s
s
s
s
s
s
s
s
s
s
s
s
s
a
"}
(57,1,1) = {"
v
v
v
v
v
v
v
v
v
v
v
v
v
v
v
v
v
v
v
v
v
v
v
v
v
v
v
v
v
v
v
v
v
v
v
v
s
s
s
s
s
s
s
s
s
s
s
s
s
s
s
s
s
s
s
s
s
s
s
s
s
s
s
s
s
s
a
"}
(58,1,1) = {"
v
v
v
v
v
v
v
v
v
v
v
v
v
v
v
v
v
v
v
v
v
v
v
v
v
v
v
v
v
v
v
v
v
v
v
v
s
s
s
s
s
s
s
s
s
s
s
s
s
s
s
s
s
s
s
s
s
s
s
s
s
s
s
s
s
s
a
"}
(59,1,1) = {"
v
v
v
v
v
v
v
v
v
v
v
v
v
v
v
v
v
v
v
v
v
v
v
v
v
v
v
v
v
v
v
v
v
v
v
v
s
s
s
s
s
s
s
s
s
s
s
s
s
s
s
s
s
s
s
s
s
s
s
s
s
s
s
s
s
s
a
"}
(60,1,1) = {"
v
v
v
v
v
v
v
v
v
v
v
v
v
v
v
v
v
v
v
v
v
v
v
v
v
v
v
v
v
v
v
v
v
v
v
v
s
s
s
s
s
s
s
s
s
s
s
s
s
s
s
s
s
s
s
s
s
s
s
s
s
s
s
s
s
s
a
"}
(61,1,1) = {"
v
v
v
v
v
v
v
v
v
v
v
v
v
v
v
v
v
v
v
v
v
v
v
v
v
v
v
v
v
v
v
v
v
v
v
v
s
s
s
s
s
s
s
s
s
s
s
s
s
s
s
s
s
s
s
s
s
s
s
s
s
s
s
s
s
s
a
"}
(62,1,1) = {"
v
v
v
v
v
v
v
v
v
v
v
v
v
v
v
v
v
v
v
v
v
v
v
v
v
v
v
v
v
v
v
v
v
v
v
v
s
s
s
s
s
s
s
s
s
s
s
s
s
s
s
s
s
s
s
s
s
s
s
s
s
s
s
s
s
s
a
"}
(63,1,1) = {"
s
s
s
s
s
s
s
s
s
s
s
s
s
s
s
s
s
s
s
s
s
s
s
s
s
s
s
s
s
s
s
s
s
s
s
s
s
s
s
s
s
s
s
s
s
s
s
s
s
s
s
s
s
s
s
s
s
s
s
s
s
s
s
s
s
s
a
"}
(64,1,1) = {"
s
s
s
s
s
s
s
s
s
s
s
s
s
s
s
s
s
s
s
s
s
s
s
s
s
s
s
s
s
s
s
s
s
s
s
s
s
s
s
s
s
s
s
s
s
s
s
s
s
s
s
s
s
s
s
s
s
s
s
s
s
s
s
s
s
s
a
"}
(65,1,1) = {"
s
s
s
s
s
s
s
s
s
s
s
s
s
s
s
s
s
s
s
s
s
s
s
s
s
s
s
s
s
s
s
s
s
s
s
s
s
s
s
s
s
s
s
s
s
s
s
s
s
s
s
s
s
s
s
s
s
s
s
s
s
s
s
s
s
s
a
"}
(66,1,1) = {"
s
s
s
s
s
s
s
s
s
s
s
s
s
s
s
s
s
s
s
s
s
s
s
s
s
s
s
s
s
s
s
s
s
s
s
s
s
s
s
s
s
s
s
s
s
s
s
s
s
s
s
s
s
s
s
s
s
s
s
s
s
s
s
s
s
s
a
"}
(67,1,1) = {"
s
s
s
s
s
s
s
s
s
s
s
s
s
s
s
s
s
s
s
s
s
s
s
s
s
s
s
s
s
s
s
s
s
s
s
s
s
s
s
s
s
s
s
s
s
s
s
s
s
s
s
s
s
s
s
s
s
s
s
s
s
s
s
s
s
s
a
"}
(68,1,1) = {"
s
s
s
s
s
s
s
s
s
s
s
s
s
s
s
s
s
s
s
s
s
s
s
s
s
s
s
s
s
s
s
s
s
s
s
s
s
s
s
s
s
s
s
s
s
s
s
s
s
s
s
s
s
s
s
s
s
s
s
s
s
s
s
s
s
s
a
"}
(69,1,1) = {"
s
s
s
s
s
s
s
s
s
s
s
s
s
s
s
s
s
s
s
s
s
s
s
s
s
s
s
s
s
s
s
s
s
s
s
s
s
s
s
s
s
s
s
s
s
s
s
s
s
s
s
s
s
s
s
s
s
s
s
s
s
s
s
s
s
s
a
"}
(70,1,1) = {"
s
s
s
s
s
s
s
s
s
s
s
s
s
s
s
s
s
s
s
s
s
s
s
s
s
s
s
s
s
s
s
s
s
s
s
s
s
s
s
s
s
s
s
s
s
s
s
s
s
s
s
s
s
s
s
s
s
s
s
s
s
s
s
s
s
s
a
"}
(71,1,1) = {"
s
s
s
s
s
s
s
s
s
s
s
s
s
s
s
s
s
s
s
s
s
s
s
s
s
s
s
s
s
s
s
s
s
s
s
s
s
s
s
s
s
s
s
s
s
s
s
s
s
s
s
s
s
s
s
s
s
s
s
s
s
s
s
s
s
s
a
"}
