//MAP CONVERTED BY dmm2tgm.py THIS HEADER COMMENT PREVENTS RECONVERSION, DO NOT REMOVE
"a" = (
/obj/structure/cable,
/obj/machinery/atmospherics/pipe/simple/green/hidden{
	dir = 5
	},
/turf/open/floor/marking/asteroidwarning{
	dir = 10
	},
/area/bigredv3/outside/directions/central)
"b" = (
/obj/effect/ai_node,
/turf/open/floor,
/area/bigredv3/inside/secondary/auxstore)
"c" = (
/obj/machinery/atmospherics/pipe/simple/green/hidden{
	dir = 4
	},
/obj/structure/cable,
/obj/machinery/door/airlock/mainship/secure/locked/free_access{
	name = "\improper Emergency Vault"
	},
/turf/open/floor,
/area/bigredv3/inside/secondary/auxstore)
"d" = (
/obj/structure/table/holotable,
/obj/effect/spawner/random/engineering/bomb_supply,
/turf/open/floor,
/area/bigredv3/inside/secondary/auxstore)
"e" = (
/turf/open/floor/marking/asteroidwarning{
	dir = 9
	},
/area/bigredv3/outside/directions/central)
"f" = (
/obj/structure/cable,
/obj/machinery/atmospherics/pipe/simple/green/hidden,
/turf/open/floor/marking/asteroidwarning{
	dir = 8
	},
/area/bigredv3/outside/directions/central)
"g" = (
/obj/structure/cable,
/obj/machinery/power/apc/weak/ntf,
/turf/open/floor,
/area/bigredv3/inside/secondary/auxstore)
"h" = (
/turf/open/floor/marking/asteroidwarning{
	dir = 5
	},
/area/bigredv3/outside/directions/central)
"i" = (
/obj/structure/table/holotable,
/obj/effect/spawner/random/engineering/toolbox,
/obj/machinery/light{
	dir = 1
	},
/turf/open/floor,
/area/bigredv3/inside/secondary/auxstore)
"j" = (
/obj/structure/table/holotable,
/obj/machinery/light{
	dir = 1
	},
/turf/open/floor,
/area/bigredv3/inside/secondary/auxstore)
"k" = (
/obj/structure/table/holotable,
/obj/effect/spawner/random/engineering/powercell,
/obj/structure/sign/securearea,
/turf/open/floor,
/area/bigredv3/inside/secondary/auxstore)
"l" = (
/obj/structure/closet/crate/secure/surgery,
/turf/open/floor,
/area/bigredv3/inside/secondary/auxstore)
"n" = (
/obj/structure/cable,
/turf/open/floor,
/area/bigredv3/inside/secondary/auxstore)
"o" = (
/obj/structure/largecrate/supply/medicine/blood,
/turf/open/floor,
/area/bigredv3/inside/secondary/auxstore)
"p" = (
/obj/structure/table/holotable,
/obj/effect/spawner/random/engineering/powercell,
/turf/open/floor,
/area/bigredv3/inside/secondary/auxstore)
"q" = (
/obj/machinery/atmospherics/pipe/simple/green/hidden{
	dir = 4
	},
/obj/structure/cable,
/turf/open/floor/marking/asteroidwarning,
/area/bigredv3/outside/directions/central)
"r" = (
/obj/machinery/atmospherics/pipe/simple/green/hidden{
	dir = 10
	},
/obj/structure/cable,
/turf/open/floor/asteroidfloor,
/area/bigredv3/outside/directions/central)
"s" = (
/obj/structure/largecrate/supply/medicine/medkits,
/obj/structure/sign/securearea,
/turf/open/floor,
/area/bigredv3/inside/secondary/auxstore)
"u" = (
/obj/machinery/atmospherics/pipe/manifold/green/hidden{
	dir = 1
	},
/obj/structure/cable,
/obj/effect/ai_node,
/turf/open/floor/asteroidfloor,
/area/bigredv3/outside/directions/central)
"v" = (
/obj/machinery/light{
	dir = 1
	},
/turf/open/floor,
/area/bigredv3/inside/secondary/auxstore)
"w" = (
/obj/structure/table/holotable,
/obj/effect/spawner/random/engineering/toolbox,
/turf/open/floor,
/area/bigredv3/inside/secondary/auxstore)
"x" = (
/obj/structure/table/holotable,
/obj/effect/spawner/random/engineering/tool,
/turf/open/floor,
/area/bigredv3/inside/secondary/auxstore)
"y" = (
/turf/open/floor/marking/asteroidwarning{
	dir = 1
	},
/area/bigredv3/outside/directions/central)
"z" = (
/obj/machinery/atmospherics/pipe/simple/green/hidden,
/obj/structure/cable,
/turf/open/floor/asteroidfloor,
/area/bigredv3/outside/directions/central)
"A" = (
/obj/machinery/atmospherics/pipe/simple/green/hidden,
/obj/structure/cable,
/turf/open/floor/marking/asteroidwarning{
	dir = 8
	},
/area/bigredv3/outside/directions/central)
"B" = (
/turf/open/floor,
/area/bigredv3/inside/secondary/auxstore)
"C" = (
/obj/machinery/atmospherics/pipe/simple/green/hidden,
/obj/structure/cable,
/turf/open/floor/marking/asteroidwarning{
	dir = 4
	},
/area/bigredv3/outside/directions/central)
"D" = (
/obj/effect/spawner/random/misc/trash,
/turf/open/floor,
/area/bigredv3/inside/secondary/auxstore)
"E" = (
/obj/structure/largecrate/supply/medicine/iv,
/obj/machinery/light,
/turf/open/floor,
/area/bigredv3/inside/secondary/auxstore)
"F" = (
/turf/open/floor/asteroidfloor,
/area/bigredv3/outside/directions/central)
"G" = (
/obj/structure/cable,
/obj/machinery/atmospherics/pipe/simple/green/hidden{
	dir = 6
	},
/turf/open/floor,
/area/bigredv3/inside/secondary/auxstore)
"H" = (
/turf/closed/wall/r_wall,
/area/bigredv3/inside/wall)
"J" = (
/obj/structure/table/holotable,
/turf/open/floor,
/area/bigredv3/inside/secondary/auxstore)
"K" = (
/obj/structure/largecrate/supply/supplies/water,
/turf/open/floor,
/area/bigredv3/inside/secondary/auxstore)
"L" = (
/turf/open/floor/marking/asteroidwarning{
	dir = 4
	},
/area/bigredv3/outside/directions/central)
"M" = (
/obj/structure/table/holotable,
/obj/effect/spawner/random/engineering/tool,
/obj/machinery/light,
/turf/open/floor,
/area/bigredv3/inside/secondary/auxstore)
"N" = (
/obj/machinery/atmospherics/pipe/simple/green/hidden{
	dir = 9
	},
/obj/structure/cable,
/obj/effect/ai_node,
/turf/open/floor/marking/asteroidwarning{
	dir = 6
	},
/area/bigredv3/outside/directions/central)
"O" = (
/obj/machinery/atmospherics/pipe/manifold/green/hidden{
	dir = 1
	},
/obj/structure/cable,
/turf/open/floor/asteroidfloor,
/area/bigredv3/outside/directions/central)
"P" = (
/turf/open/floor/plating/ground/mars/random/sand,
/area/bigredv3/outside/directions/central)
"Q" = (
/obj/structure/table/holotable,
/obj/effect/spawner/random/engineering/extinguisher/regularweighted,
/turf/open/floor,
/area/bigredv3/inside/secondary/auxstore)
"R" = (
/obj/machinery/atmospherics/pipe/simple/green/hidden{
	dir = 4
	},
/obj/structure/cable,
/obj/effect/spawner/random/misc/trash,
/turf/open/floor,
/area/bigredv3/inside/secondary/auxstore)
"S" = (
/obj/structure/largecrate/supply/floodlights,
/turf/open/floor,
/area/bigredv3/inside/secondary/auxstore)
"T" = (
/obj/structure/table/holotable,
/obj/machinery/atmospherics/components/unary/vent_pump{
	dir = 1;
	on = 1
	},
/obj/effect/spawner/random/engineering/toolbox,
/turf/open/floor,
/area/bigredv3/inside/secondary/auxstore)
"U" = (
/obj/machinery/atmospherics/pipe/simple/green/hidden{
	dir = 4
	},
/obj/structure/cable,
/turf/open/floor/asteroidfloor,
/area/bigredv3/outside/directions/central)
"V" = (
/obj/structure/table/holotable,
/obj/effect/spawner/random/engineering/powercell,
/obj/machinery/light,
/turf/open/floor,
/area/bigredv3/inside/secondary/auxstore)
"W" = (
/turf/open/floor/marking/asteroidwarning{
	dir = 8
	},
/area/bigredv3/outside/directions/central)
"X" = (
/obj/machinery/atmospherics/pipe/simple/green/hidden,
/turf/open/floor,
/area/bigredv3/inside/secondary/auxstore)
"Y" = (
/obj/structure/sign/securearea,
/turf/open/floor/marking/asteroidwarning{
	dir = 1
	},
/area/bigredv3/outside/directions/central)
"Z" = (
/obj/machinery/atmospherics/pipe/simple/green/hidden{
	dir = 4
	},
/obj/structure/cable,
/turf/open/floor,
/area/bigredv3/inside/secondary/auxstore)

(1,1,1) = {"
P
e
W
F
u
r
A
f
a
"}
(2,1,1) = {"
P
y
H
H
H
H
H
H
q
"}
(3,1,1) = {"
P
Y
H
S
S
K
s
H
q
"}
(4,1,1) = {"
P
y
H
S
l
S
o
H
q
"}
(5,1,1) = {"
P
y
H
v
B
B
E
H
q
"}
(6,1,1) = {"
P
y
H
B
B
B
B
H
q
"}
(7,1,1) = {"
P
y
H
J
b
B
x
H
U
"}
(8,1,1) = {"
P
y
H
g
n
B
d
H
O
"}
(9,1,1) = {"
P
y
H
j
n
B
M
H
U
"}
(10,1,1) = {"
P
y
H
x
G
X
T
H
q
"}
(11,1,1) = {"
P
y
H
x
R
B
w
H
q
"}
(12,1,1) = {"
P
y
H
p
Z
B
x
H
q
"}
(13,1,1) = {"
P
y
H
i
Z
D
V
H
q
"}
(14,1,1) = {"
P
Y
H
Q
Z
B
k
H
q
"}
(15,1,1) = {"
P
y
H
H
c
H
H
H
q
"}
(16,1,1) = {"
P
h
L
F
u
z
C
C
N
"}
