//MAP CONVERTED BY dmm2tgm.py THIS HEADER COMMENT PREVENTS RECONVERSION, DO NOT REMOVE
"ah" = (
/obj/structure/cable,
/obj/machinery/atmospherics/pipe/simple/green/hidden,
/obj/effect/ai_node,
/turf/open/floor/asteroidfloor,
/area/bigredv3/outside/directions/nw)
"az" = (
/obj/effect/decal/cleanable/dirt,
/obj/effect/decal/cleanable/dirt,
/turf/open/floor/marking/asteroidwarning{
	dir = 10
	},
/area/bigredv3/outside/directions/nw)
"cj" = (
/obj/machinery/atmospherics/pipe/simple/green/hidden,
/obj/structure/cable,
/obj/effect/ai_node,
/turf/open/floor/marking/asteroidwarning{
	dir = 4
	},
/area/bigredv3/outside/directions/nw)
"cm" = (
/obj/structure/cable,
/turf/open/floor/plating/warning{
	dir = 1
	},
/area/bigredv3/outside/directions/nw)
"cZ" = (
/turf/open/floor/marking/asteroidwarning{
	dir = 1
	},
/area/bigredv3/outside/directions/nw)
"dR" = (
/turf/closed/mineral/smooth/bigred,
/area/bigredv3/caves/rock)
"er" = (
/obj/machinery/light{
	dir = 8
	},
/turf/open/floor/marking/asteroidwarning{
	dir = 1
	},
/area/bigredv3/outside/directions/nw)
"ew" = (
/turf/open/floor/plating/ground/mars/random/sand,
/area/bigredv3/caves/northwest)
"eJ" = (
/obj/structure/fence/standard/xenoproof,
/turf/open/floor/plating/ground/mars/cavetodirt{
	dir = 4
	},
/area/bigredv3/caves/west)
"eP" = (
/obj/machinery/light{
	dir = 1
	},
/obj/structure/cable,
/turf/open/floor/plating,
/area/bigredv3/outside/directions/nw)
"fD" = (
/obj/effect/turf_decal/sandedge{
	dir = 4
	},
/obj/structure/fence/standard/xenoproof,
/turf/open/floor/plating/ground/mars/random/dirt,
/area/bigredv3/caves/northwest)
"fH" = (
/obj/machinery/floodlight/outpost/bigred,
/turf/open/floor/plating/ground/mars/random/sand,
/area/bigredv3/outside/directions/nw)
"fL" = (
/obj/machinery/light{
	dir = 4
	},
/turf/open/floor/marking/asteroidwarning{
	dir = 1
	},
/area/bigredv3/outside/medical/virology)
"gw" = (
/obj/structure/cable,
/obj/machinery/power/apc/weak/ntf{
	dir = 4
	},
/turf/open/floor/plating,
/area/bigredv3/outside/directions/nw)
"gP" = (
/obj/structure/cargo_container/horizontal,
/turf/open/floor/plating,
/area/bigredv3/outside/directions/nw)
"ir" = (
/obj/structure/fence/standard/xenoproof,
/turf/open/floor/plating/ground/mars/dirttosand/autosmooth,
/area/bigredv3/caves/northwest)
"jt" = (
/obj/effect/decal/cleanable/blood,
/turf/open/floor/plating/ground/mars/random/sand,
/area/bigredv3/outside/directions/nw)
"kA" = (
/obj/machinery/light{
	dir = 1
	},
/turf/open/floor/plating,
/area/bigredv3/outside/directions/nw)
"le" = (
/obj/effect/decal/cleanable/dirt,
/obj/effect/ai_node,
/turf/open/floor/marking/asteroidwarning{
	dir = 10
	},
/area/bigredv3/outside/directions/nw)
"ly" = (
/obj/machinery/atmospherics/pipe/simple/green/hidden{
	dir = 4
	},
/obj/structure/cable,
/turf/open/floor/asteroidfloor,
/area/bigredv3/outside/directions/nw)
"mu" = (
/obj/effect/turf_decal/sandedge,
/turf/open/floor/marking/asteroidwarning{
	dir = 5
	},
/area/bigredv3/outside/directions/nw)
"mI" = (
/turf/open/floor/plating/ground/mars/dirttosand/autosmooth,
/area/bigredv3/caves/northwest)
"mR" = (
/turf/open/floor/marking/asteroidwarning{
	dir = 9
	},
/area/bigredv3/outside/directions/nw)
"ob" = (
/turf/open/floor/plating/ground/mars/random/sand,
/area/bigredv3/outside/directions/nw)
"oh" = (
/obj/machinery/atmospherics/pipe/simple/green/hidden{
	dir = 4
	},
/obj/structure/cable,
/obj/machinery/door/airlock/multi_tile/mainship/medidoor{
	dir = 1;
	name = "\improper Medical Clinic"
	},
/turf/open/floor/tile/white,
/area/bigredv3/outside/directions/nw)
"oH" = (
/obj/effect/ai_node,
/turf/open/floor/plating/ground/mars/random/cave/rock,
/area/bigredv3/caves/west)
"pc" = (
/turf/open/floor/plating/ground/mars/random/dirt,
/area/bigredv3/outside/medical/virology)
"pI" = (
/obj/effect/decal/cleanable/dirt,
/obj/effect/decal/cleanable/dirt,
/obj/effect/decal/cleanable/dirt,
/turf/open/floor/marking/asteroidwarning{
	dir = 8
	},
/area/bigredv3/outside/directions/nw)
"qm" = (
/turf/open/floor/marking/asteroidwarning{
	dir = 10
	},
/area/bigredv3/outside/directions/nw)
"qC" = (
/turf/open/floor/asteroidfloor,
/area/bigredv3/outside/directions/nw)
"ri" = (
/turf/open/floor/marking/asteroidwarning{
	dir = 1
	},
/area/bigredv3/outside/medical/virology)
"rs" = (
/obj/effect/ai_node,
/turf/open/floor/plating/ground/mars/random/sand,
/area/bigredv3/outside/medical/virology)
"sk" = (
/obj/effect/decal/cleanable/dirt,
/turf/open/floor/asteroidfloor,
/area/bigredv3/outside/directions/nw)
"sJ" = (
/obj/machinery/atmospherics/pipe/simple/green/hidden{
	dir = 10
	},
/obj/structure/cable,
/turf/open/floor/marking/asteroidwarning{
	dir = 5
	},
/area/bigredv3/outside/directions/nw)
"sU" = (
/obj/structure/cable,
/obj/machinery/atmospherics/pipe/simple/green/hidden{
	dir = 6
	},
/obj/effect/ai_node,
/turf/open/floor/plating,
/area/bigredv3/outside/directions/nw)
"tb" = (
/obj/structure/cable,
/turf/open/floor/marking/asteroidwarning,
/area/bigredv3/outside/directions/nw)
"tm" = (
/obj/machinery/light{
	dir = 4
	},
/turf/open/floor/plating,
/area/bigredv3/outside/directions/nw)
"tS" = (
/obj/effect/decal/cleanable/dirt,
/turf/open/floor/marking/asteroidwarning,
/area/bigredv3/outside/directions/nw)
"uq" = (
/obj/structure/cable,
/obj/machinery/atmospherics/pipe/simple/green/hidden,
/turf/open/floor/marking/asteroidwarning{
	dir = 4
	},
/area/bigredv3/outside/directions/nw)
"uO" = (
/turf/open/floor/plating/ground/mars/random/cave,
/area/bigredv3/caves/northwest)
"vb" = (
/obj/effect/decal/cleanable/dirt,
/turf/open/floor/marking/asteroidwarning{
	dir = 4
	},
/area/bigredv3/outside/directions/nw)
"wi" = (
/obj/structure/cargo_container/horizontal{
	dir = 1
	},
/turf/open/floor/plating,
/area/bigredv3/outside/directions/nw)
"xD" = (
/obj/machinery/atmospherics/pipe/simple/green/hidden,
/turf/open/floor/marking/asteroidwarning{
	dir = 4
	},
/area/bigredv3/outside/directions/nw)
"xF" = (
/obj/effect/ai_node,
/turf/open/floor/plating,
/area/bigredv3/outside/directions/nw)
"xS" = (
/turf/open/floor/marking/asteroidwarning{
	dir = 5
	},
/area/bigredv3/outside/directions/nw)
"xW" = (
/obj/effect/ai_node,
/turf/open/floor/plating/ground/mars/random/cave,
/area/bigredv3/caves/northwest)
"xZ" = (
/obj/structure/cable,
/turf/open/floor/asteroidfloor,
/area/bigredv3/outside/directions/nw)
"zu" = (
/obj/structure/cable,
/obj/machinery/atmospherics/pipe/simple/green/hidden{
	dir = 5
	},
/turf/open/floor/asteroidfloor,
/area/bigredv3/outside/directions/nw)
"Ai" = (
/obj/structure/cable,
/turf/open/floor/marking/asteroidwarning{
	dir = 1
	},
/area/bigredv3/outside/directions/nw)
"BG" = (
/obj/structure/cable,
/obj/machinery/atmospherics/pipe/simple/green/hidden{
	dir = 4
	},
/turf/open/floor/asteroidfloor,
/area/bigredv3/outside/directions/nw)
"Cd" = (
/turf/open/floor/plating/ground/mars/random/sand,
/area/bigredv3/outside/medical/virology)
"Cg" = (
/obj/effect/decal/cleanable/dirt,
/turf/open/floor/marking/asteroidwarning{
	dir = 8
	},
/area/bigredv3/outside/directions/nw)
"Cm" = (
/turf/open/floor/marking/asteroidwarning{
	dir = 5
	},
/area/bigredv3/outside/medical/virology)
"Co" = (
/obj/effect/turf_decal/sandedge,
/turf/open/floor/plating/ground/mars/random/sand,
/area/bigredv3/outside/directions/nw)
"CP" = (
/obj/effect/ai_node,
/turf/open/floor/marking/asteroidwarning{
	dir = 10
	},
/area/bigredv3/outside/directions/nw)
"CY" = (
/turf/open/floor/plating/ground/mars/random/cave/rock,
/area/bigredv3/caves/northwest)
"Db" = (
/turf/open/floor/plating/ground/mars/random/dirt,
/area/bigredv3/caves/west)
"Dd" = (
/obj/machinery/atmospherics/pipe/simple/green/hidden,
/turf/open/floor/plating/warning{
	dir = 1
	},
/area/bigredv3/outside/directions/nw)
"Dm" = (
/turf/open/floor/asteroidfloor,
/area/bigredv3/outside/medical/virology)
"Dt" = (
/obj/structure/cable,
/obj/machinery/atmospherics/pipe/simple/green/hidden{
	dir = 4
	},
/turf/open/floor/plating,
/area/bigredv3/outside/directions/nw)
"DA" = (
/obj/structure/cable,
/obj/machinery/atmospherics/pipe/simple/green/hidden,
/obj/effect/decal/cleanable/dirt,
/turf/open/floor/marking/asteroidwarning{
	dir = 1
	},
/area/bigredv3/outside/directions/nw)
"Eb" = (
/obj/structure/cable,
/obj/machinery/atmospherics/pipe/simple/green/hidden{
	dir = 4
	},
/obj/effect/ai_node,
/turf/open/floor/plating,
/area/bigredv3/outside/directions/nw)
"Fc" = (
/turf/open/floor/plating/warning{
	dir = 8
	},
/area/bigredv3/outside/directions/nw)
"FI" = (
/obj/effect/decal/cleanable/dirt,
/obj/structure/cable,
/turf/open/floor/plating,
/area/bigredv3/outside/directions/nw)
"Gd" = (
/turf/open/floor/marking/asteroidwarning{
	dir = 4
	},
/area/bigredv3/outside/directions/nw)
"Gg" = (
/turf/closed/wall/r_wall,
/area/bigredv3/inside/wall)
"Go" = (
/obj/effect/decal/cleanable/dirt,
/obj/effect/decal/cleanable/dirt,
/obj/effect/decal/cleanable/dirt,
/turf/open/floor/marking/asteroidwarning{
	dir = 9
	},
/area/bigredv3/outside/directions/nw)
"GC" = (
/obj/structure/cable,
/obj/effect/ai_node,
/turf/open/floor/asteroidfloor,
/area/bigredv3/outside/directions/nw)
"Ha" = (
/turf/open/floor/plating/ground/mars/random/dirt,
/area/bigredv3/outside/directions/nw)
"HW" = (
/obj/machinery/atmospherics/pipe/simple/green/hidden,
/obj/structure/cable,
/turf/open/floor/marking/asteroidwarning{
	dir = 4
	},
/area/bigredv3/outside/directions/nw)
"JC" = (
/obj/structure/cable,
/turf/open/floor/plating,
/area/bigredv3/outside/directions/nw)
"JR" = (
/obj/effect/decal/cleanable/dirt,
/turf/open/floor/marking/asteroidwarning{
	dir = 5
	},
/area/bigredv3/outside/directions/nw)
"JY" = (
/obj/machinery/light{
	dir = 8
	},
/turf/open/floor/asteroidfloor,
/area/bigredv3/outside/directions/nw)
"Kp" = (
/obj/effect/ai_node,
/turf/open/floor/plating/ground/mars/dirttosand/autosmooth,
/area/bigredv3/outside/directions/nw)
"KI" = (
/obj/effect/ai_node,
/turf/open/floor/plating/ground/mars/random/sand,
/area/bigredv3/outside/directions/nw)
"Lb" = (
/obj/effect/decal/cleanable/dirt,
/obj/structure/cable,
/turf/open/floor/asteroidfloor,
/area/bigredv3/outside/directions/nw)
"ML" = (
/obj/machinery/atmospherics/pipe/simple/green/hidden{
	dir = 4
	},
/obj/structure/cable,
/turf/open/floor/marking/asteroidwarning{
	dir = 1
	},
/area/bigredv3/outside/directions/nw)
"MX" = (
/turf/open/floor/marking/asteroidwarning,
/area/bigredv3/outside/directions/nw)
"NM" = (
/obj/machinery/light{
	dir = 1
	},
/turf/open/floor/plating/ground/mars/random/dirt,
/area/bigredv3/outside/medical/virology)
"NT" = (
/obj/machinery/atmospherics/pipe/manifold/green/hidden,
/obj/structure/cable,
/turf/open/floor/plating,
/area/bigredv3/outside/directions/nw)
"Om" = (
/turf/open/floor/plating/warning{
	dir = 1
	},
/area/bigredv3/outside/directions/nw)
"On" = (
/turf/open/floor/marking/asteroidwarning{
	dir = 8
	},
/area/bigredv3/outside/directions/nw)
"Ot" = (
/turf/open/floor/plating/ground/mars/dirttosand/autosmooth,
/area/bigredv3/outside/directions/nw)
"OA" = (
/obj/structure/cable,
/obj/machinery/atmospherics/pipe/simple/green/hidden{
	dir = 4
	},
/turf/open/floor/plating/warning{
	dir = 8
	},
/area/bigredv3/outside/directions/nw)
"Pa" = (
/turf/open/floor/marking/asteroidwarning{
	dir = 8
	},
/area/bigredv3/outside/medical/virology)
"Pe" = (
/turf/open/floor/plating,
/area/bigredv3/outside/directions/nw)
"PL" = (
/obj/effect/decal/cleanable/dirt,
/turf/open/floor/plating,
/area/bigredv3/outside/directions/nw)
"Qg" = (
/turf/open/floor/tile/white,
/area/bigredv3/outside/directions/nw)
"QI" = (
/turf/open/floor/marking/asteroidwarning{
	dir = 4
	},
/area/bigredv3/outside/medical/virology)
"QR" = (
/turf/closed/mineral/smooth/bigred/indestructible,
/area/space)
"Ri" = (
/obj/machinery/atmospherics/pipe/simple/green/hidden,
/turf/open/floor/plating,
/area/bigredv3/outside/directions/nw)
"RB" = (
/turf/open/floor/plating/ground/mars/cavetodirt{
	dir = 6
	},
/area/bigredv3/caves/west)
"Sj" = (
/obj/effect/decal/cleanable/dirt,
/turf/open/floor/marking/asteroidwarning{
	dir = 1
	},
/area/bigredv3/outside/directions/nw)
"SI" = (
/turf/open/floor/plating/ground/mars/random/cave,
/area/bigredv3/caves/west)
"SK" = (
/obj/machinery/light{
	dir = 1
	},
/turf/open/floor/plating/ground/mars/dirttosand/autosmooth,
/area/bigredv3/outside/medical/virology)
"Tb" = (
/turf/open/floor/plating/ground/mars/random/cave/rock,
/area/bigredv3/caves/west)
"Te" = (
/obj/structure/cable,
/obj/machinery/atmospherics/pipe/simple/green/hidden,
/turf/open/floor/plating,
/area/bigredv3/outside/directions/nw)
"Tv" = (
/turf/open/floor/marking/asteroidwarning{
	dir = 9
	},
/area/bigredv3/outside/medical/virology)
"TR" = (
/obj/effect/decal/cleanable/dirt,
/obj/structure/cable,
/obj/effect/decal/cleanable/dirt,
/turf/open/floor/marking/asteroidwarning,
/area/bigredv3/outside/directions/nw)
"UG" = (
/obj/effect/decal/cleanable/dirt,
/obj/effect/ai_node,
/turf/open/floor/marking/asteroidwarning{
	dir = 8
	},
/area/bigredv3/outside/directions/nw)
"UW" = (
/obj/machinery/light,
/turf/open/floor/plating,
/area/bigredv3/outside/directions/nw)
"WP" = (
/obj/structure/fence/standard/xenoproof,
/turf/open/floor/plating/ground/mars/random/cave,
/area/bigredv3/caves/west)
"WW" = (
/obj/structure/cargo_container/horizontal{
	dir = 4
	},
/turf/open/floor/plating,
/area/bigredv3/outside/directions/nw)
"Xr" = (
/obj/machinery/light,
/obj/effect/ai_node,
/turf/open/floor/plating,
/area/bigredv3/outside/directions/nw)
"Xv" = (
/obj/effect/ai_node,
/turf/open/floor/plating/ground/mars/random/cave,
/area/bigredv3/caves/west)
"XM" = (
/obj/machinery/atmospherics/pipe/simple/green/hidden,
/turf/open/floor/marking/asteroidwarning{
	dir = 1
	},
/area/bigredv3/outside/directions/nw)
"XR" = (
/obj/effect/decal/cleanable/dirt,
/turf/open/floor/marking/asteroidwarning{
	dir = 6
	},
/area/bigredv3/outside/directions/nw)
"Yn" = (
/obj/machinery/atmospherics/pipe/simple/green/hidden{
	dir = 4
	},
/obj/structure/cable,
/turf/open/floor/plating,
/area/bigredv3/outside/directions/nw)
"Yw" = (
/obj/effect/ai_node,
/turf/open/floor/plating/ground/mars/random/dirt,
/area/bigredv3/outside/medical/virology)
"YI" = (
/turf/open/floor/plating/ground/mars/dirttosand/autosmooth,
/area/bigredv3/outside/medical/virology)
"Zu" = (
/obj/structure/cable,
/turf/closed/mineral/smooth/bigred,
/area/bigredv3/caves/rock)
"ZC" = (
/obj/machinery/light{
	dir = 8
	},
/turf/open/floor/plating,
/area/bigredv3/outside/directions/nw)
"ZD" = (
/obj/effect/turf_decal/sandedge,
/turf/open/floor/marking/asteroidwarning{
	dir = 9
	},
/area/bigredv3/outside/directions/nw)
"ZO" = (
/obj/effect/ai_node,
/turf/open/floor/asteroidfloor,
/area/bigredv3/outside/directions/nw)

(1,1,1) = {"
QR
QR
QR
QR
QR
QR
QR
QR
QR
QR
QR
QR
QR
QR
QR
QR
QR
QR
QR
QR
QR
QR
"}
(2,1,1) = {"
dR
dR
dR
dR
dR
dR
dR
dR
dR
dR
dR
dR
dR
dR
dR
dR
dR
dR
dR
dR
dR
dR
"}
(3,1,1) = {"
dR
dR
dR
dR
dR
dR
dR
dR
dR
dR
dR
dR
dR
dR
dR
dR
Tb
Tb
Tb
Tb
dR
dR
"}
(4,1,1) = {"
dR
dR
dR
dR
dR
dR
dR
dR
dR
dR
dR
dR
dR
dR
dR
Tb
SI
SI
SI
SI
Tb
dR
"}
(5,1,1) = {"
dR
dR
dR
dR
dR
dR
dR
dR
dR
dR
dR
dR
dR
dR
Tb
SI
SI
SI
SI
SI
SI
Tb
"}
(6,1,1) = {"
dR
dR
dR
dR
dR
dR
dR
dR
dR
dR
dR
dR
dR
dR
SI
SI
SI
SI
SI
SI
SI
SI
"}
(7,1,1) = {"
dR
dR
dR
dR
dR
dR
dR
dR
dR
dR
dR
dR
dR
CY
SI
SI
SI
SI
SI
SI
Tb
SI
"}
(8,1,1) = {"
dR
dR
dR
dR
dR
dR
dR
dR
uO
uO
uO
uO
uO
xW
SI
SI
SI
SI
SI
SI
oH
SI
"}
(9,1,1) = {"
dR
uO
uO
uO
uO
uO
uO
uO
uO
uO
uO
uO
uO
uO
SI
SI
SI
SI
SI
SI
Tb
SI
"}
(10,1,1) = {"
uO
uO
uO
uO
uO
uO
uO
uO
uO
uO
uO
uO
CY
uO
SI
SI
SI
SI
SI
SI
Tb
SI
"}
(11,1,1) = {"
uO
uO
uO
uO
uO
CY
uO
uO
uO
uO
uO
uO
uO
uO
SI
SI
SI
SI
SI
SI
Tb
dR
"}
(12,1,1) = {"
uO
uO
CY
CY
uO
uO
xW
uO
uO
uO
uO
xW
uO
xW
SI
SI
SI
SI
SI
SI
oH
dR
"}
(13,1,1) = {"
CY
uO
uO
uO
uO
uO
uO
uO
uO
uO
uO
CY
uO
uO
SI
SI
SI
SI
SI
SI
SI
Tb
"}
(14,1,1) = {"
uO
uO
uO
uO
uO
uO
dR
dR
dR
ir
fD
fD
fD
ir
dR
dR
dR
SI
SI
SI
Xv
Tb
"}
(15,1,1) = {"
uO
uO
uO
uO
uO
dR
dR
dR
dR
mI
mI
mI
mI
ew
dR
dR
dR
SI
dR
dR
WP
eJ
"}
(16,1,1) = {"
uO
uO
uO
dR
dR
dR
dR
dR
dR
Gg
Gg
Gg
Gg
Gg
dR
dR
dR
dR
dR
dR
RB
Db
"}
(17,1,1) = {"
uO
uO
dR
dR
dR
dR
dR
dR
dR
ew
ew
ew
ew
ew
dR
dR
dR
dR
dR
dR
Gg
Gg
"}
(18,1,1) = {"
dR
dR
dR
dR
dR
dR
dR
Gg
Gg
Gg
Gg
Gg
Gg
Gg
Gg
dR
dR
dR
dR
Gg
Gg
Yw
"}
(19,1,1) = {"
dR
dR
dR
dR
dR
dR
dR
Gg
Pe
ZC
Pe
Pe
Pe
ZC
Gg
Gg
Gg
Gg
Gg
Gg
pc
pc
"}
(20,1,1) = {"
dR
dR
dR
dR
dR
dR
dR
Gg
kA
Pe
Pe
xF
Pe
Pe
Pe
wi
WW
gP
Gg
pc
pc
Tv
"}
(21,1,1) = {"
dR
dR
dR
dR
dR
dR
dR
Gg
Pe
Pe
Pe
Pe
xF
Pe
Pe
Pe
Pe
Pe
Gg
SK
pc
ri
"}
(22,1,1) = {"
dR
dR
dR
dR
dR
dR
dR
Gg
Pe
Pe
Pe
Pe
Pe
xF
Pe
Pe
Pe
Xr
Gg
rs
YI
ri
"}
(23,1,1) = {"
dR
dR
dR
dR
dR
dR
dR
Gg
Pe
wi
WW
gP
Pe
Pe
Pe
Pe
Pe
Pe
Gg
Cd
Cd
ri
"}
(24,1,1) = {"
dR
dR
dR
dR
dR
dR
dR
Gg
Pe
Pe
Pe
Pe
Pe
Pe
Pe
Pe
Pe
Pe
Tv
Pa
Pa
Dm
"}
(25,1,1) = {"
dR
dR
dR
ob
ob
ob
ob
Gg
Pe
Pe
Pe
Pe
Pe
Pe
Pe
Pe
Pe
xF
ri
Dm
Dm
Dm
"}
(26,1,1) = {"
dR
ob
ob
ob
ob
ob
ob
Gg
Pe
Pe
Pe
Pe
Pe
Pe
Pe
Pe
xF
Pe
Cm
QI
QI
Dm
"}
(27,1,1) = {"
Co
ob
ob
ob
ob
ob
Gg
Gg
Pe
Pe
Pe
Pe
Pe
Pe
Pe
Pe
Pe
Pe
Gg
pc
pc
ri
"}
(28,1,1) = {"
ZD
On
CP
ob
fH
ob
Gg
gw
Pe
Pe
xF
Pe
xF
Pe
Pe
Pe
Pe
Pe
Gg
pc
pc
ri
"}
(29,1,1) = {"
mu
qC
MX
ob
ob
ob
Gg
JC
Pe
Pe
Pe
Pe
Pe
Pe
Pe
Pe
Pe
Pe
Gg
NM
Yw
ri
"}
(30,1,1) = {"
Zu
Ai
tb
ob
ob
ob
Gg
eP
Pe
Pe
Pe
wi
WW
gP
Pe
Pe
Pe
UW
Gg
pc
pc
ri
"}
(31,1,1) = {"
dR
cZ
TR
ob
ob
Ot
Gg
JC
Pe
Pe
Pe
Pe
Pe
Pe
Pe
Pe
Pe
Pe
Gg
pc
Tv
Pa
"}
(32,1,1) = {"
ob
cZ
tb
Ot
Ot
Ha
Gg
JC
Pe
Pe
Pe
Pe
Pe
Pe
Pe
Pe
Pe
Pe
Gg
pc
fL
Dm
"}
(33,1,1) = {"
ob
cZ
xZ
Cg
On
Cg
qm
FI
PL
Pe
Pe
Pe
Pe
Pe
PL
Go
pI
az
Gg
Gg
Gg
Dm
"}
(34,1,1) = {"
ob
cZ
GC
Lb
Lb
Lb
tb
JC
FI
JC
sU
Te
Te
Te
Te
DA
ah
zu
le
Ha
er
qC
"}
(35,1,1) = {"
Ot
cZ
qC
qC
qC
Gd
XR
Pe
Pe
Pe
Yn
Pe
Pe
Pe
Pe
Sj
sk
ly
tS
Ha
xS
Gd
"}
(36,1,1) = {"
Ot
cZ
sk
sk
XR
Ha
Gg
Pe
tm
PL
Yn
PL
tm
Pe
Pe
JR
vb
BG
tS
Ha
Ha
cZ
"}
(37,1,1) = {"
Ot
Sj
qC
tS
Ha
Ot
Gg
Gg
Gg
Fc
OA
Fc
Gg
Gg
Gg
Gg
Ha
ML
tS
Ha
Ha
cZ
"}
(38,1,1) = {"
Ot
cZ
qC
tS
Ot
ob
Gg
Pe
ZC
Pe
Dt
Pe
ZC
Pe
Pe
Gg
Ha
ML
MX
Ha
Ha
cZ
"}
(39,1,1) = {"
Ot
cZ
qC
MX
Ot
ob
Gg
kA
Pe
Pe
Dt
Pe
wi
WW
gP
Gg
Ha
ML
qC
Cg
On
qC
"}
(40,1,1) = {"
UG
qC
ZO
tS
Kp
fH
Gg
Pe
Pe
Pe
Eb
Pe
Pe
Pe
Pe
Gg
Ha
sJ
cj
HW
HW
uq
"}
(41,1,1) = {"
sk
qC
sk
MX
Ot
ob
Gg
Pe
Pe
Pe
Dt
Pe
Pe
Pe
Pe
Gg
Ot
Ot
Ot
Ot
Ha
Ha
"}
(42,1,1) = {"
Gd
Gd
vb
XR
Ot
ob
Gg
Pe
Pe
Pe
Dt
Pe
wi
WW
gP
Gg
ob
ob
ob
ob
Ot
Ot
"}
(43,1,1) = {"
Ha
Ha
Ha
Ha
Ot
ob
Gg
Pe
Pe
Pe
Dt
Pe
Pe
Pe
Pe
Gg
ob
fH
ob
ob
ob
ob
"}
(44,1,1) = {"
Ha
Ha
Ha
Ha
Ha
mR
Gg
kA
Pe
Pe
Dt
Pe
Pe
Pe
UW
Gg
ob
ob
ob
ob
ob
ob
"}
(45,1,1) = {"
On
On
On
On
On
cZ
Om
Pe
Pe
Pe
Dt
Pe
Pe
Pe
Pe
Gg
ob
ob
KI
ob
ob
ob
"}
(46,1,1) = {"
xZ
xZ
xZ
xZ
GC
Ai
cm
JC
JC
JC
Eb
Pe
Pe
Pe
xF
Gg
ob
ob
ob
ob
ob
ob
"}
(47,1,1) = {"
xD
xD
xD
xD
xD
XM
Dd
Ri
Ri
Ri
NT
Pe
Pe
Pe
Pe
Gg
ob
ob
ob
ob
ob
ob
"}
(48,1,1) = {"
Ot
Ot
Ha
Ha
Ha
xS
Gg
Pe
Pe
Pe
Yn
Pe
Pe
Pe
Pe
Gg
ob
ob
ob
ob
ob
ob
"}
(49,1,1) = {"
ob
ob
Ot
Ot
Ot
Ot
Gg
kA
Pe
Pe
Yn
Pe
Pe
Pe
UW
Gg
ob
fH
ob
ob
ob
ob
"}
(50,1,1) = {"
ob
ob
fH
ob
ob
ob
Gg
Pe
Pe
Pe
Yn
Pe
Pe
Pe
Pe
Gg
ob
ob
ob
ob
ob
ob
"}
(51,1,1) = {"
ob
ob
ob
ob
ob
ob
Gg
Pe
Pe
Pe
Yn
Pe
wi
WW
gP
Gg
ob
ob
ob
ob
ob
ob
"}
(52,1,1) = {"
ob
ob
ob
ob
ob
ob
Gg
Pe
tm
Pe
Yn
tm
Pe
Pe
Pe
Gg
ob
ob
ob
ob
ob
jt
"}
(53,1,1) = {"
ob
ob
ob
ob
ob
ob
Gg
Gg
Gg
Qg
oh
Gg
Gg
Gg
Gg
Gg
ob
ob
ob
ob
ob
ob
"}
(54,1,1) = {"
ob
ob
ob
ob
ob
ob
cZ
JY
qC
qC
ly
qC
qC
JY
qC
MX
ob
ob
KI
ob
ob
ob
"}
