//MAP CONVERTED BY dmm2tgm.py THIS HEADER COMMENT PREVENTS RECONVERSION, DO NOT REMOVE
"aL" = (
/obj/structure/table,
/obj/effect/spawner/random/engineering/technology_scanner,
/turf/open/floor/tile/dark/red2/corner{
	dir = 8
	},
/area/bigredv2/outside/nanotrasen_lab/inside)
"cG" = (
/obj/structure/closet/l3closet/scientist,
/turf/open/floor/tile/darkgreen/darkgreen2{
	dir = 9
	},
/area/bigredv2/outside/nanotrasen_lab/inside)
"cQ" = (
/obj/structure/xenoautopsy/tank/broken,
/turf/open/floor/tile/dark/red2/corner{
	dir = 8
	},
/area/bigredv2/outside/nanotrasen_lab/inside)
"eI" = (
/obj/structure/bed/chair{
	dir = 4
	},
/obj/effect/turf_decal/sandedge/corner2{
	dir = 4
	},
/turf/open/floor/tile/dark/red2{
	dir = 4
	},
/area/bigredv2/outside/nanotrasen_lab/inside)
"fd" = (
/obj/machinery/atmospherics/pipe/simple/green/hidden{
	dir = 4
	},
/obj/effect/ai_node,
/turf/open/floor/tile/dark,
/area/bigredv2/outside/nanotrasen_lab/inside)
"fR" = (
/obj/effect/ai_node,
/turf/open/floor/tile/dark,
/area/bigredv2/outside/nanotrasen_lab/inside)
"ht" = (
/obj/structure/table,
/obj/machinery/light,
/obj/effect/spawner/random/engineering/technology_scanner,
/obj/item/xenos_claw,
/turf/open/floor/tile/dark/red2/corner{
	dir = 8
	},
/area/bigredv2/outside/nanotrasen_lab/inside)
"hR" = (
/obj/structure/table,
/obj/item/paper,
/turf/open/floor/tile/dark/red2/corner,
/area/bigredv2/outside/nanotrasen_lab/inside)
"ja" = (
/turf/open/floor/tile/dark/red2/corner{
	dir = 8
	},
/area/bigredv2/outside/nanotrasen_lab/inside)
"jr" = (
/obj/structure/cable,
/obj/effect/ai_node,
/turf/open/floor/plating,
/area/bigredv2/outside/nanotrasen_lab/inside)
"kg" = (
/turf/closed/wall,
/area/bigredv2/outside/nanotrasen_lab/inside)
"kF" = (
/obj/effect/landmark/lv624/fog_blocker/xeno_spawn,
/turf/closed/mineral/smooth/bigred,
/area/bigredv2/caves/rock)
"kJ" = (
/obj/machinery/door/airlock/mainship/research/glass/free_access{
	dir = 1;
	name = "\improper Eta Lab Cell"
	},
/turf/open/floor/tile/dark,
/area/bigredv2/outside/nanotrasen_lab/inside)
"lX" = (
/turf/open/floor/tile/dark/red2{
	dir = 1
	},
/area/bigredv2/outside/nanotrasen_lab/inside)
"nj" = (
/obj/machinery/miner/damaged/platinum,
/turf/open/floor/plating/ground/mars/random/cave/rock,
/area/bigredv2/caves/south)
"ok" = (
/obj/machinery/light{
	dir = 4
	},
/turf/open/ground/jungle/clear,
/area/bigredv2/outside/nanotrasen_lab/inside)
"or" = (
/obj/structure/cable,
/obj/machinery/power/apc/high/ntf{
	dir = 1
	},
/turf/open/floor/plating,
/area/bigredv2/outside/nanotrasen_lab/inside)
"oL" = (
/obj/structure/closet/crate/secure,
/turf/open/floor/tile/dark/red2/corner,
/area/bigredv2/outside/nanotrasen_lab/inside)
"pY" = (
/turf/open/ground/jungle/clear,
/area/bigredv2/outside/nanotrasen_lab/inside)
"qc" = (
/turf/open/floor/tile/dark/red2/corner,
/area/bigredv2/outside/nanotrasen_lab/inside)
"rS" = (
/obj/effect/decal/cleanable/dirt,
/turf/open/floor/tile/dark/red2/corner,
/area/bigredv2/outside/nanotrasen_lab/inside)
"sp" = (
/obj/effect/landmark/excavation_site_spawner,
/turf/open/floor/plating/ground/mars/random/cave,
/area/bigredv2/caves/south)
"tk" = (
/turf/open/floor/plating/ground/mars/random/sand,
/area/bigredv2/outside/nanotrasen_lab/inside)
"tq" = (
/obj/structure/fence/standard/xenoproof,
/turf/open/floor/plating/ground/mars/random/cave,
/area/bigredv2/caves/south)
"tu" = (
/obj/effect/ai_node,
/obj/effect/landmark/lv624/fog_blocker/xeno_spawn,
/turf/open/floor/plating/ground/mars/random/cave,
/area/bigredv2/caves/south)
"tB" = (
/obj/effect/decal/cleanable/blood/xeno,
/turf/open/floor/tile/dark/red2/corner{
	dir = 4
	},
/area/bigredv2/outside/nanotrasen_lab/inside)
"tM" = (
/obj/machinery/door/airlock/mainship/research/glass/free_access{
	name = "\improper Eta Lab Cell"
	},
/turf/open/floor/tile/dark,
/area/bigredv2/outside/nanotrasen_lab/inside)
"un" = (
/turf/open/floor/tile/dark/red2{
	dir = 4
	},
/area/bigredv2/outside/nanotrasen_lab/inside)
"ux" = (
/obj/machinery/light,
/turf/open/floor/tile/darkgreen/darkgreen2,
/area/bigredv2/outside/nanotrasen_lab/inside)
"vX" = (
/obj/structure/cable,
/turf/open/floor/plating,
/area/bigredv2/outside/nanotrasen_lab/inside)
"vY" = (
/turf/closed/mineral/smooth/bigred/indestructible,
/area/space)
"wH" = (
/obj/effect/decal/cleanable/blood/oil,
/turf/open/floor/tile/dark,
/area/bigredv2/outside/nanotrasen_lab/inside)
"xw" = (
/obj/machinery/light{
	dir = 8
	},
/turf/open/floor/tile/dark/red2/corner{
	dir = 8
	},
/area/bigredv2/outside/nanotrasen_lab/inside)
"xB" = (
/turf/closed/wall/r_wall,
/area/bigredv2/outside/nanotrasen_lab/inside)
"xJ" = (
/turf/open/floor/tile/darkgreen/darkgreen2{
	dir = 6
	},
/area/bigredv2/outside/nanotrasen_lab/inside)
"xQ" = (
/turf/open/floor/tile/dark,
/area/bigredv2/outside/nanotrasen_lab/inside)
"yR" = (
/obj/machinery/atmospherics/components/unary/vent_pump{
	dir = 4;
	on = 1
	},
/turf/open/floor/tile/dark,
/area/bigredv2/outside/nanotrasen_lab/inside)
"zb" = (
/obj/effect/landmark/xeno_silo_spawn,
/turf/open/floor/plating/ground/mars/random/cave,
/area/bigredv2/caves/south)
"zD" = (
/turf/open/floor/tile/dark/red2{
	dir = 6
	},
/area/bigredv2/outside/nanotrasen_lab/inside)
"zQ" = (
/obj/structure/closet/l3closet/scientist,
/turf/open/floor/tile/darkgreen/darkgreen2{
	dir = 1
	},
/area/bigredv2/outside/nanotrasen_lab/inside)
"Am" = (
/turf/open/floor/tile/dark/red2{
	dir = 8
	},
/area/bigredv2/outside/nanotrasen_lab/inside)
"Ay" = (
/obj/structure/closet/toolcloset,
/turf/open/floor/plating,
/area/bigredv2/outside/nanotrasen_lab/inside)
"Bc" = (
/turf/open/floor/tile/dark/red2,
/area/bigredv2/outside/nanotrasen_lab/inside)
"By" = (
/obj/structure/closet/firecloset,
/turf/open/floor/plating,
/area/bigredv2/outside/nanotrasen_lab/inside)
"BK" = (
/obj/machinery/computer/security,
/turf/open/floor/tile/dark/red2/corner{
	dir = 4
	},
/area/bigredv2/outside/nanotrasen_lab/inside)
"DG" = (
/obj/machinery/light{
	dir = 1
	},
/turf/open/floor/tile/dark/red2{
	dir = 9
	},
/area/bigredv2/outside/nanotrasen_lab/inside)
"DM" = (
/turf/open/floor/plating/ground/mars/random/cave/rock,
/area/bigredv2/caves/south)
"EH" = (
/obj/machinery/light{
	dir = 8
	},
/turf/open/floor/plating/ground/mars/random/sand,
/area/bigredv2/outside/nanotrasen_lab/inside)
"Fi" = (
/obj/structure/table,
/obj/effect/spawner/random/engineering/technology_scanner,
/turf/open/floor/tile/dark/red2/corner{
	dir = 4
	},
/area/bigredv2/outside/nanotrasen_lab/inside)
"Gc" = (
/turf/open/floor/tile/darkgreen/darkgreen2{
	dir = 4
	},
/area/bigredv2/outside/nanotrasen_lab/inside)
"Gi" = (
/obj/structure/bed/chair{
	dir = 8
	},
/turf/open/floor/tile/dark/red2{
	dir = 8
	},
/area/bigredv2/outside/nanotrasen_lab/inside)
"Gt" = (
/obj/effect/landmark/lv624/fog_blocker,
/turf/closed/wall/r_wall,
/turf/open/floor/plating/ground/mars/random/cave,
/area/bigredv2/outside/nanotrasen_lab/inside)
"GY" = (
/obj/effect/landmark/lv624/fog_blocker,
/turf/closed/wall/r_wall,
/turf/open/floor/plating/ground/mars/cavetodirt{
	dir = 1
	},
/area/bigredv2/outside/nanotrasen_lab/inside)
"He" = (
/obj/structure/closet/l3closet/scientist,
/turf/open/floor/tile/darkgreen/darkgreen2{
	dir = 5
	},
/area/bigredv2/outside/nanotrasen_lab/inside)
"IP" = (
/obj/effect/decal/cleanable/blood/gibs,
/turf/open/floor/plating/ground/mars/random/cave,
/area/bigredv2/caves/south)
"IU" = (
/turf/open/floor/plating,
/area/bigredv2/outside/nanotrasen_lab/inside)
"IZ" = (
/obj/effect/landmark/lv624/fog_blocker,
/turf/closed/mineral/smooth/bigred,
/area/bigredv2/caves/rock)
"JF" = (
/obj/structure/window/framed/colony,
/turf/open/floor/plating,
/area/bigredv2/outside/nanotrasen_lab/inside)
"JJ" = (
/obj/structure/bed/chair{
	dir = 4
	},
/turf/open/floor/tile/dark/red2{
	dir = 4
	},
/area/bigredv2/outside/nanotrasen_lab/inside)
"JW" = (
/obj/effect/decal/cleanable/dirt,
/turf/open/floor/tile/dark,
/area/bigredv2/outside/nanotrasen_lab/inside)
"KC" = (
/obj/effect/landmark/lv624/fog_blocker/xeno_spawn,
/turf/open/floor/plating/ground/mars/random/cave,
/area/bigredv2/caves/south)
"KG" = (
/obj/structure/bed/chair{
	dir = 4
	},
/obj/effect/landmark/excavation_site_spawner,
/turf/open/floor/tile/dark/red2{
	dir = 4
	},
/area/bigredv2/outside/nanotrasen_lab/inside)
"KR" = (
/obj/effect/spawner/random/engineering/structure/tank/fuelweighted,
/turf/open/floor/plating,
/area/bigredv2/outside/nanotrasen_lab/inside)
"Mz" = (
/obj/machinery/light{
	dir = 4
	},
/obj/effect/decal/cleanable/dirt,
/obj/effect/ai_node,
/turf/open/floor/tile/dark/red2/corner,
/area/bigredv2/outside/nanotrasen_lab/inside)
"MG" = (
/obj/structure/cable,
/obj/machinery/door/airlock/mainship/maint/free_access{
	name = "\improper Eta Lab Maintenance Storage"
	},
/turf/open/floor/tile/dark,
/area/bigredv2/outside/nanotrasen_lab/inside)
"NX" = (
/turf/open/floor/tile/darkgreen/darkgreen2{
	dir = 8
	},
/area/bigredv2/outside/nanotrasen_lab/inside)
"Ok" = (
/obj/effect/decal/cleanable/blood,
/turf/open/floor/tile/dark,
/area/bigredv2/outside/nanotrasen_lab/inside)
"Op" = (
/obj/effect/turf_decal/sandedge/corner2{
	dir = 8
	},
/turf/open/floor/tile/dark,
/area/bigredv2/outside/nanotrasen_lab/inside)
"Or" = (
/obj/structure/table,
/obj/structure/xenoautopsy,
/turf/open/floor/tile/dark/red2/corner{
	dir = 4
	},
/area/bigredv2/outside/nanotrasen_lab/inside)
"Pg" = (
/obj/effect/ai_node,
/turf/open/floor/plating/ground/mars/random/cave/rock,
/area/bigredv2/caves/south)
"Px" = (
/obj/effect/turf_decal/sandedge{
	dir = 1
	},
/turf/open/floor/tile/dark/red2/corner,
/area/bigredv2/outside/nanotrasen_lab/inside)
"PG" = (
/obj/structure/xenoautopsy/tank,
/turf/open/floor/tile/dark/red2/corner{
	dir = 8
	},
/area/bigredv2/outside/nanotrasen_lab/inside)
"PY" = (
/obj/structure/xenoautopsy/tank/hugger,
/turf/open/floor/tile/dark/red2/corner{
	dir = 8
	},
/area/bigredv2/outside/nanotrasen_lab/inside)
"QX" = (
/turf/open/floor/tile/darkgreen/darkgreen2{
	dir = 10
	},
/area/bigredv2/outside/nanotrasen_lab/inside)
"Rr" = (
/turf/closed/mineral/smooth/bigred,
/area/bigredv2/caves/rock)
"RJ" = (
/obj/effect/ai_node,
/turf/open/floor/plating/ground/mars/random/cave,
/area/bigredv2/caves/south)
"SV" = (
/obj/machinery/atmospherics/pipe/simple/green/hidden{
	dir = 4
	},
/obj/machinery/door/airlock/mainship/research/glass/free_access{
	name = "\improper Eta Lab Xenobiology Lab"
	},
/turf/open/floor/tile/dark,
/area/bigredv2/outside/nanotrasen_lab/inside)
"Tc" = (
/obj/structure/fence/standard/xenoproof,
/turf/open/floor/plating/ground/mars/random/cave/rock,
/area/bigredv2/caves/south)
"Tp" = (
/obj/machinery/atmospherics/pipe/simple/green/hidden{
	dir = 4
	},
/turf/open/floor/tile/dark,
/area/bigredv2/outside/nanotrasen_lab/inside)
"TH" = (
/obj/item/target,
/turf/open/floor/tile/dark/red2{
	dir = 1
	},
/area/bigredv2/outside/nanotrasen_lab/inside)
"Uk" = (
/turf/open/floor/tile/dark/red2{
	dir = 10
	},
/area/bigredv2/outside/nanotrasen_lab/inside)
"UT" = (
/obj/structure/table,
/obj/item/alienjar,
/turf/open/floor/tile/dark/red2/corner{
	dir = 4
	},
/area/bigredv2/outside/nanotrasen_lab/inside)
"Vk" = (
/obj/machinery/atmospherics/pipe/manifold/green/hidden{
	dir = 1
	},
/obj/effect/ai_node,
/turf/open/floor/tile/dark,
/area/bigredv2/outside/nanotrasen_lab/inside)
"Ww" = (
/obj/structure/table,
/obj/item/tool/pen,
/turf/open/floor/tile/dark/red2/corner{
	dir = 4
	},
/area/bigredv2/outside/nanotrasen_lab/inside)
"WD" = (
/obj/machinery/atmospherics/components/unary/vent_pump{
	dir = 1;
	on = 1
	},
/turf/open/floor/tile/dark,
/area/bigredv2/outside/nanotrasen_lab/inside)
"WV" = (
/turf/open/floor/plating/ground/mars/random/cave,
/area/bigredv2/caves/south)
"Xq" = (
/obj/effect/landmark/lv624/fog_blocker,
/turf/closed/wall/r_wall,
/area/bigredv2/outside/nanotrasen_lab/inside)
"YW" = (
/obj/machinery/light{
	dir = 1
	},
/turf/open/floor/tile/dark/red2{
	dir = 5
	},
/area/bigredv2/outside/nanotrasen_lab/inside)
"ZO" = (
/obj/structure/window/framed/colony/reinforced,
/turf/open/floor/plating,
/area/bigredv2/outside/nanotrasen_lab/inside)

(1,1,1) = {"
vY
vY
vY
vY
vY
vY
vY
vY
vY
vY
vY
vY
vY
vY
vY
vY
vY
vY
vY
vY
vY
vY
vY
vY
vY
vY
vY
vY
vY
vY
vY
vY
vY
vY
vY
vY
vY
vY
"}
(2,1,1) = {"
vY
vY
vY
vY
vY
vY
vY
vY
vY
vY
vY
vY
vY
vY
vY
vY
vY
vY
vY
vY
vY
vY
vY
vY
vY
vY
vY
vY
vY
vY
vY
vY
vY
vY
vY
vY
vY
vY
"}
(3,1,1) = {"
vY
vY
vY
vY
vY
vY
vY
vY
vY
vY
vY
vY
vY
vY
vY
vY
vY
vY
vY
vY
vY
vY
vY
vY
vY
vY
vY
vY
vY
vY
vY
vY
vY
vY
vY
vY
vY
vY
"}
(4,1,1) = {"
vY
vY
vY
vY
vY
vY
vY
vY
vY
vY
vY
vY
vY
vY
vY
vY
vY
vY
vY
vY
vY
vY
vY
vY
vY
vY
vY
vY
vY
vY
vY
vY
vY
vY
vY
vY
vY
vY
"}
(5,1,1) = {"
vY
vY
vY
vY
vY
vY
vY
vY
vY
vY
vY
vY
vY
vY
vY
vY
vY
vY
vY
vY
vY
vY
vY
vY
vY
vY
vY
vY
vY
vY
vY
vY
vY
vY
vY
vY
vY
vY
"}
(6,1,1) = {"
vY
vY
vY
vY
vY
vY
vY
vY
vY
vY
vY
vY
vY
vY
vY
vY
vY
vY
vY
vY
vY
vY
vY
vY
vY
vY
vY
vY
vY
vY
vY
vY
vY
vY
vY
vY
vY
vY
"}
(7,1,1) = {"
vY
vY
vY
vY
vY
vY
vY
vY
vY
vY
vY
vY
vY
vY
vY
vY
vY
vY
vY
vY
vY
vY
vY
vY
vY
vY
vY
vY
vY
vY
vY
vY
vY
vY
vY
vY
vY
vY
"}
(8,1,1) = {"
vY
vY
vY
vY
vY
vY
vY
vY
vY
vY
vY
vY
vY
vY
vY
vY
vY
vY
vY
vY
vY
vY
vY
vY
vY
vY
vY
vY
vY
vY
vY
vY
vY
vY
vY
vY
vY
vY
"}
(9,1,1) = {"
vY
vY
vY
vY
vY
vY
vY
vY
vY
vY
vY
vY
vY
vY
vY
vY
vY
vY
vY
vY
vY
vY
vY
vY
vY
vY
vY
vY
vY
vY
vY
vY
vY
vY
vY
vY
vY
vY
"}
(10,1,1) = {"
vY
vY
vY
vY
vY
vY
vY
vY
vY
vY
vY
vY
vY
vY
vY
vY
vY
vY
vY
vY
vY
vY
vY
vY
vY
vY
vY
vY
vY
vY
vY
vY
vY
vY
vY
vY
vY
vY
"}
(11,1,1) = {"
vY
vY
vY
vY
vY
vY
vY
vY
vY
vY
vY
vY
vY
vY
vY
vY
vY
vY
vY
vY
vY
vY
vY
vY
vY
vY
vY
vY
vY
vY
vY
vY
vY
vY
vY
vY
vY
vY
"}
(12,1,1) = {"
vY
vY
vY
vY
vY
vY
vY
vY
vY
vY
vY
vY
vY
vY
vY
vY
vY
vY
vY
vY
vY
vY
vY
vY
vY
vY
vY
vY
vY
vY
vY
vY
vY
vY
vY
vY
vY
vY
"}
(13,1,1) = {"
vY
vY
vY
vY
vY
vY
vY
vY
vY
vY
vY
vY
vY
vY
vY
vY
vY
vY
vY
vY
vY
vY
vY
vY
vY
vY
vY
vY
vY
vY
vY
vY
vY
vY
vY
vY
vY
vY
"}
(14,1,1) = {"
vY
vY
vY
vY
vY
vY
vY
vY
vY
vY
vY
vY
vY
vY
vY
vY
vY
vY
vY
vY
vY
vY
vY
vY
vY
vY
vY
vY
vY
vY
vY
vY
vY
vY
vY
vY
vY
vY
"}
(15,1,1) = {"
vY
vY
vY
vY
vY
vY
vY
vY
vY
vY
vY
vY
vY
vY
vY
vY
vY
vY
vY
vY
vY
vY
vY
vY
vY
vY
vY
vY
vY
vY
vY
vY
vY
vY
vY
vY
vY
vY
"}
(16,1,1) = {"
vY
vY
vY
vY
vY
vY
vY
vY
vY
vY
vY
vY
vY
vY
vY
vY
vY
vY
vY
vY
vY
vY
vY
vY
vY
vY
vY
vY
vY
vY
vY
vY
vY
vY
vY
vY
vY
vY
"}
(17,1,1) = {"
vY
vY
vY
vY
vY
vY
vY
vY
vY
vY
vY
vY
vY
vY
vY
vY
vY
vY
vY
vY
vY
vY
vY
vY
vY
vY
vY
vY
vY
vY
vY
vY
vY
vY
vY
vY
vY
vY
"}
(18,1,1) = {"
vY
vY
vY
vY
vY
vY
vY
vY
vY
vY
vY
vY
vY
vY
vY
vY
vY
vY
vY
vY
vY
vY
vY
vY
vY
vY
vY
vY
vY
vY
vY
vY
vY
vY
vY
vY
vY
vY
"}
(19,1,1) = {"
vY
vY
vY
vY
vY
vY
vY
vY
vY
vY
vY
vY
vY
vY
vY
vY
vY
vY
vY
vY
vY
vY
vY
vY
vY
vY
vY
vY
vY
vY
vY
vY
vY
vY
vY
vY
vY
vY
"}
(20,1,1) = {"
vY
vY
vY
vY
vY
vY
vY
vY
vY
vY
vY
vY
vY
vY
vY
vY
vY
vY
vY
vY
vY
vY
vY
vY
vY
vY
vY
vY
vY
vY
vY
vY
vY
vY
vY
vY
vY
vY
"}
(21,1,1) = {"
vY
vY
vY
vY
vY
vY
vY
vY
vY
vY
vY
vY
vY
vY
vY
vY
vY
vY
vY
vY
vY
vY
vY
vY
vY
vY
vY
vY
vY
vY
vY
vY
vY
vY
vY
vY
vY
vY
"}
(22,1,1) = {"
vY
vY
vY
vY
vY
vY
vY
vY
vY
vY
vY
vY
vY
vY
vY
vY
vY
vY
vY
vY
vY
vY
vY
vY
vY
vY
vY
vY
vY
vY
vY
vY
vY
vY
vY
vY
vY
vY
"}
(23,1,1) = {"
vY
vY
vY
vY
vY
vY
vY
vY
vY
vY
vY
vY
vY
vY
vY
vY
vY
vY
vY
vY
vY
vY
vY
vY
vY
vY
vY
vY
vY
vY
vY
vY
vY
vY
vY
vY
vY
vY
"}
(24,1,1) = {"
vY
vY
vY
vY
vY
vY
vY
vY
vY
vY
vY
vY
vY
vY
vY
vY
vY
vY
vY
vY
vY
vY
vY
vY
vY
vY
vY
vY
vY
vY
vY
vY
vY
vY
vY
vY
vY
vY
"}
(25,1,1) = {"
vY
vY
vY
vY
vY
vY
vY
vY
vY
vY
vY
vY
vY
vY
vY
vY
vY
vY
vY
vY
vY
vY
vY
vY
vY
vY
vY
vY
vY
vY
vY
vY
vY
vY
vY
vY
vY
vY
"}
(26,1,1) = {"
Rr
Rr
Rr
Rr
Rr
Rr
Rr
Rr
Rr
Rr
Rr
Rr
Rr
Rr
Rr
Rr
Rr
Rr
Rr
Rr
Rr
Rr
Rr
Rr
Rr
Rr
Rr
Rr
Rr
Rr
Rr
Rr
Rr
Rr
Rr
Rr
Rr
vY
"}
(27,1,1) = {"
Rr
Rr
Rr
Rr
Rr
Rr
Rr
Rr
Rr
Rr
Rr
Rr
Rr
Rr
Rr
Rr
Rr
Rr
Rr
Rr
Rr
Rr
Rr
Rr
Rr
Rr
Rr
Rr
Rr
Rr
Rr
Rr
Rr
Rr
Rr
Rr
Rr
vY
"}
(28,1,1) = {"
Rr
Rr
Rr
Rr
Rr
Rr
Rr
Rr
Rr
Rr
Rr
Rr
Rr
Rr
Rr
Rr
Rr
Rr
Rr
Rr
Rr
Rr
Rr
Rr
Rr
Rr
Rr
Rr
Rr
Rr
Rr
Rr
Rr
Rr
Rr
Rr
Rr
vY
"}
(29,1,1) = {"
Rr
Rr
Rr
Rr
Rr
Rr
Rr
Rr
Rr
Rr
Rr
Rr
Rr
Rr
Rr
Rr
Rr
Rr
Rr
Rr
Rr
Rr
kF
kF
kF
kF
kF
kF
kF
kF
kF
kF
kF
kF
kF
kF
Rr
vY
"}
(30,1,1) = {"
Rr
Rr
Rr
Rr
Rr
Rr
Rr
Rr
Rr
Rr
Rr
Rr
Rr
Rr
Rr
Rr
Rr
Rr
Rr
Rr
Rr
Rr
kF
Rr
Rr
Rr
Rr
Rr
Rr
Rr
Rr
Rr
Rr
Rr
Rr
kF
Rr
vY
"}
(31,1,1) = {"
Rr
Rr
Rr
Rr
Rr
Rr
Rr
Rr
Rr
Rr
Rr
Rr
Rr
Rr
Rr
Rr
Rr
Rr
Rr
Rr
Rr
Rr
kF
Rr
Rr
Rr
WV
WV
RJ
WV
WV
Rr
Rr
Rr
Rr
kF
Rr
vY
"}
(32,1,1) = {"
Rr
Rr
Rr
Rr
Rr
Rr
Rr
Rr
Rr
Rr
Rr
Rr
Rr
Rr
Rr
Rr
Rr
Rr
Rr
Rr
Rr
Rr
kF
Rr
RJ
WV
WV
WV
WV
WV
WV
WV
Rr
Rr
Rr
kF
Rr
vY
"}
(33,1,1) = {"
Rr
Rr
Rr
Rr
Rr
Rr
Rr
Rr
Rr
Rr
Rr
DM
WV
Rr
Rr
Rr
Rr
Rr
Rr
Rr
Rr
Rr
kF
Rr
WV
WV
WV
WV
WV
zb
WV
Rr
Rr
Rr
Rr
kF
Rr
vY
"}
(34,1,1) = {"
Rr
Rr
Rr
Rr
Rr
Rr
Rr
DM
WV
WV
WV
WV
WV
WV
RJ
WV
Rr
Rr
Rr
Rr
Rr
Rr
KC
WV
WV
WV
WV
WV
WV
WV
WV
WV
Rr
Rr
Rr
kF
Rr
vY
"}
(35,1,1) = {"
Rr
Rr
Rr
Rr
Rr
Rr
WV
WV
WV
WV
WV
WV
WV
WV
WV
WV
WV
Rr
Rr
Rr
Rr
Rr
KC
WV
WV
WV
WV
WV
WV
WV
WV
WV
WV
Rr
Rr
kF
Rr
vY
"}
(36,1,1) = {"
Rr
Rr
Rr
Rr
WV
WV
WV
WV
WV
RJ
WV
WV
WV
WV
RJ
WV
WV
WV
WV
WV
RJ
WV
KC
WV
RJ
WV
WV
WV
RJ
WV
WV
WV
WV
Rr
Rr
kF
Rr
vY
"}
(37,1,1) = {"
Rr
Rr
WV
RJ
WV
WV
WV
WV
RJ
WV
WV
WV
WV
WV
WV
WV
WV
WV
WV
WV
WV
WV
KC
WV
WV
WV
WV
WV
WV
WV
WV
WV
WV
Rr
Rr
kF
Rr
vY
"}
(38,1,1) = {"
Rr
WV
WV
WV
WV
WV
WV
sp
WV
WV
WV
WV
WV
WV
WV
WV
WV
WV
WV
WV
WV
WV
KC
WV
WV
WV
WV
WV
WV
WV
WV
WV
WV
Rr
Rr
kF
Rr
vY
"}
(39,1,1) = {"
WV
WV
WV
WV
WV
WV
WV
WV
WV
WV
WV
WV
WV
WV
WV
WV
WV
WV
WV
WV
WV
WV
KC
WV
WV
WV
WV
WV
RJ
WV
WV
WV
RJ
WV
Rr
kF
Rr
vY
"}
(40,1,1) = {"
WV
DM
WV
WV
DM
DM
WV
WV
WV
WV
WV
DM
WV
WV
WV
WV
WV
WV
WV
WV
WV
WV
KC
WV
WV
WV
WV
WV
WV
WV
WV
WV
WV
WV
Rr
kF
Rr
vY
"}
(41,1,1) = {"
WV
WV
WV
RJ
WV
WV
WV
WV
WV
RJ
WV
WV
DM
DM
DM
DM
DM
DM
WV
DM
Pg
DM
KC
KC
KC
tu
KC
KC
KC
KC
KC
KC
KC
KC
kF
kF
Rr
vY
"}
(42,1,1) = {"
WV
WV
WV
WV
WV
WV
WV
WV
WV
WV
WV
WV
WV
WV
WV
WV
WV
WV
WV
WV
WV
WV
DM
WV
WV
WV
WV
WV
WV
WV
sp
WV
WV
WV
Rr
Rr
Rr
vY
"}
(43,1,1) = {"
WV
Rr
Rr
Rr
Rr
Rr
Rr
DM
WV
WV
WV
WV
WV
WV
WV
WV
WV
WV
WV
WV
WV
WV
WV
WV
WV
WV
WV
WV
WV
WV
WV
WV
WV
WV
Rr
Rr
Rr
vY
"}
(44,1,1) = {"
Rr
Rr
Rr
Rr
Rr
Rr
Rr
Rr
Rr
Rr
Rr
Rr
Rr
Rr
Rr
Rr
Rr
WV
Rr
Rr
DM
DM
Rr
DM
WV
WV
WV
WV
WV
WV
WV
WV
WV
WV
Rr
Rr
Rr
vY
"}
(45,1,1) = {"
Rr
Rr
Rr
Rr
Rr
Rr
Rr
Rr
Rr
Rr
Rr
Rr
Rr
Rr
Rr
Rr
Rr
Rr
Rr
Rr
Rr
Rr
Rr
Rr
WV
WV
WV
WV
WV
WV
WV
WV
WV
WV
Rr
Rr
Rr
vY
"}
(46,1,1) = {"
IZ
IZ
IZ
IZ
IZ
IZ
IZ
IZ
IZ
IZ
IZ
IZ
IZ
IZ
IZ
IZ
IZ
IZ
IZ
IZ
IZ
IZ
Rr
Rr
DM
WV
WV
WV
WV
WV
WV
WV
WV
Rr
Rr
Rr
Rr
vY
"}
(47,1,1) = {"
xB
xB
xB
xB
xB
xB
xB
xB
xB
xB
xB
xB
xB
xB
xB
xB
xB
xB
xB
xB
xB
xB
Xq
Rr
WV
WV
WV
WV
WV
WV
WV
WV
WV
Rr
Rr
Rr
Rr
vY
"}
(48,1,1) = {"
DG
Am
Am
Uk
xB
PG
cQ
PY
PY
PY
xB
tk
EH
tk
xB
tk
EH
tk
xB
tk
EH
tk
Xq
Rr
tq
RJ
WV
sp
RJ
WV
WV
WV
RJ
Rr
Rr
Rr
Rr
vY
"}
(49,1,1) = {"
lX
fR
xQ
xQ
kJ
xQ
xQ
fR
xQ
ja
xB
tk
tk
tk
xB
tk
tk
tk
xB
tk
tk
tk
GY
DM
Tc
WV
WV
WV
WV
WV
WV
WV
WV
WV
Rr
Rr
Rr
vY
"}
(50,1,1) = {"
lX
xQ
xQ
Bc
xB
tB
JW
JW
xQ
aL
xB
tk
tk
tk
xB
tk
tk
tk
xB
tk
tk
tk
Xq
WV
tq
WV
WV
WV
WV
WV
WV
WV
WV
WV
Rr
Rr
Rr
vY
"}
(51,1,1) = {"
TH
xQ
xQ
Bc
ZO
BK
JW
JW
xQ
ht
xB
ZO
tM
ZO
xB
ZO
tM
ZO
xB
ZO
tM
ZO
Xq
WV
tq
WV
WV
DM
WV
WV
WV
WV
WV
WV
Rr
Rr
Rr
vY
"}
(52,1,1) = {"
lX
xQ
xQ
Bc
ZO
Fi
JW
JW
xQ
ja
kg
Gi
xQ
Gi
kg
Gi
xQ
Gi
kg
Gi
xQ
Gi
Xq
WV
tq
WV
WV
nj
WV
WV
WV
WV
WV
WV
WV
Rr
Rr
vY
"}
(53,1,1) = {"
TH
xQ
xQ
Bc
ZO
UT
xQ
JW
JW
xQ
ja
ja
xQ
ja
xw
ja
xQ
ja
ja
ja
JW
ja
Xq
WV
tq
WV
WV
DM
WV
WV
WV
WV
WV
WV
WV
Rr
Rr
vY
"}
(54,1,1) = {"
lX
fR
xQ
Bc
ZO
Or
xQ
yR
JW
JW
Ok
JW
JW
JW
xQ
JW
JW
JW
xQ
JW
xQ
Op
Xq
WV
tq
WV
WV
DM
WV
WV
WV
WV
WV
WV
WV
Rr
Rr
vY
"}
(55,1,1) = {"
lX
xQ
xQ
Bc
ZO
Ww
wH
fd
JW
JW
Mz
rS
JW
rS
rS
rS
JW
rS
Mz
qc
xQ
Px
Gt
WV
tq
RJ
WV
WV
WV
RJ
WV
WV
RJ
WV
WV
Rr
Rr
vY
"}
(56,1,1) = {"
YW
un
un
zD
ZO
hR
qc
Tp
qc
oL
kg
JJ
xQ
KG
kg
JJ
xQ
JJ
kg
JJ
xQ
eI
Xq
Rr
Tc
WV
WV
WV
WV
WV
WV
WV
WV
WV
WV
Rr
Rr
vY
"}
(57,1,1) = {"
xB
xB
xB
xB
xB
kg
JF
SV
JF
kg
xB
ZO
tM
ZO
xB
ZO
tM
ZO
xB
ZO
tM
ZO
Xq
Rr
Rr
Rr
Rr
WV
WV
WV
WV
WV
WV
WV
WV
Rr
Rr
vY
"}
(58,1,1) = {"
KR
vX
vX
or
kg
cG
NX
Tp
NX
QX
xB
pY
pY
pY
xB
pY
pY
pY
xB
pY
pY
pY
Xq
Rr
Rr
Rr
Rr
WV
Rr
Rr
WV
WV
WV
WV
WV
Rr
Rr
vY
"}
(59,1,1) = {"
KR
jr
IU
By
kg
zQ
xQ
Vk
WD
ux
xB
pY
pY
pY
xB
pY
pY
pY
xB
pY
pY
pY
Xq
Rr
Rr
Rr
Rr
Rr
Rr
Rr
Rr
WV
WV
WV
WV
Rr
Rr
vY
"}
(60,1,1) = {"
KR
vX
IU
Ay
kg
He
Gc
Tp
Gc
xJ
xB
pY
ok
pY
xB
pY
ok
pY
xB
pY
ok
pY
Xq
IZ
IZ
IZ
IZ
IZ
IZ
IZ
Rr
WV
RJ
IP
WV
Rr
Rr
vY
"}
(61,1,1) = {"
kg
MG
kg
kg
kg
kg
JF
SV
JF
kg
xB
xB
xB
xB
xB
xB
xB
xB
xB
xB
xB
xB
xB
xB
xB
xB
xB
xB
xB
IZ
Rr
WV
WV
WV
WV
Rr
Rr
vY
"}
