//MAP CONVERTED BY dmm2tgm.py THIS HEADER COMMENT PREVENTS RECONVERSION, DO NOT REMOVE
"b" = (
/turf/closed/mineral/smooth/bigred,
/area/bigredv3/caves/rock)
"e" = (
/obj/effect/landmark/lv624/fog_blocker,
/turf/closed/mineral/smooth/bigred,
/area/bigredv3/caves/rock)
"h" = (
/turf/open/floor/plating/ground/mars/random/cave,
/area/bigredv3/caves/northeast/garbledradio)
"p" = (
/obj/effect/ai_node,
/turf/open/floor/plating/ground/mars/random/cave,
/area/bigredv3/caves/east/garbledradio)
"r" = (
/turf/open/floor/plating/ground/mars/random/cave,
/area/bigredv3/caves/east/garbledradio)
"t" = (
/obj/effect/landmark/lv624/fog_blocker,
/obj/effect/ai_node,
/turf/open/floor/plating/ground/mars/random/cave,
/area/bigredv3/caves/east/garbledradio)
"z" = (
/turf/open/floor/plating/ground/mars/random/cave/rock,
/area/bigredv3/caves/east/garbledradio)
"U" = (
/obj/effect/ai_node,
/turf/open/floor/plating/ground/mars/random/cave,
/area/bigredv3/caves/northeast/garbledradio)
"X" = (
/obj/effect/landmark/lv624/fog_blocker,
/turf/open/floor/plating/ground/mars/random/cave,
/area/bigredv3/caves/east/garbledradio)

(1,1,1) = {"
b
b
b
b
b
b
b
b
b
b
b
"}
(2,1,1) = {"
b
b
b
b
b
b
b
b
b
b
b
"}
(3,1,1) = {"
b
b
b
b
b
b
b
b
b
b
b
"}
(4,1,1) = {"
b
b
b
b
b
b
b
b
b
b
b
"}
(5,1,1) = {"
b
b
b
b
b
b
b
b
b
b
b
"}
(6,1,1) = {"
h
b
b
r
r
r
p
r
b
b
b
"}
(7,1,1) = {"
h
r
r
r
r
r
r
r
r
z
z
"}
(8,1,1) = {"
U
r
r
p
r
r
p
r
r
p
X
"}
(9,1,1) = {"
h
r
r
r
b
b
b
b
r
X
p
"}
(10,1,1) = {"
U
r
r
r
b
b
b
b
b
t
r
"}
(11,1,1) = {"
h
r
r
r
r
b
r
e
e
r
r
"}
(12,1,1) = {"
h
r
r
r
r
r
X
z
r
r
p
"}
(13,1,1) = {"
U
r
r
p
r
X
r
r
r
p
b
"}
(14,1,1) = {"
b
r
r
b
r
X
b
b
r
b
b
"}
(15,1,1) = {"
b
b
b
b
b
e
b
b
b
b
b
"}
(16,1,1) = {"
b
b
b
b
b
e
b
b
b
b
b
"}
(17,1,1) = {"
b
b
b
b
b
e
b
b
b
b
b
"}
(18,1,1) = {"
b
b
b
b
b
e
b
b
b
b
b
"}
(19,1,1) = {"
b
b
b
b
b
e
b
b
b
b
b
"}
(20,1,1) = {"
b
b
b
b
b
e
b
b
b
b
b
"}
(21,1,1) = {"
b
b
b
b
b
e
b
b
b
b
b
"}
(22,1,1) = {"
e
e
e
e
e
b
b
b
b
b
b
"}
