//MAP CONVERTED BY dmm2tgm.py THIS HEADER COMMENT PREVENTS RECONVERSION, DO NOT REMOVE
"a" = (
/turf/open/space/basic,
/area/space)
"d" = (
/obj/effect/landmark/lv624/fog_blocker/xeno_spawn,
/turf/closed/mineral/smooth/bigred,
/area/bigredv2/caves/rock)
"j" = (
/obj/effect/landmark/lv624/fog_blocker/xeno_spawn,
/turf/open/floor/plating/ground/mars/random/cave,
/area/bigredv2/caves/southeast)
"k" = (
/turf/closed/mineral/smooth/bigred/indestructible,
/area/bigredv2/caves/rock)
"m" = (
/turf/open/floor/plating/ground/mars/random/cave,
/area/bigredv2/caves/southeast/garbledradio)
"v" = (
/turf/closed/mineral/smooth/bigred/indestructible,
/area/space)
"y" = (
/turf/open/floor/plating/ground/mars/random/cave,
/area/bigredv2/caves/east)
"E" = (
/obj/effect/ai_node,
/turf/open/floor/plating/ground/mars/random/cave,
/area/bigredv2/caves/southeast/garbledradio)
"F" = (
/obj/effect/ai_node,
/turf/open/floor/plating/ground/mars/random/cave,
/area/bigredv2/caves/southeast)
"G" = (
/obj/effect/ai_node,
/turf/open/floor/plating/ground/mars/random/cave/rock,
/area/bigredv2/caves/southeast/garbledradio)
"O" = (
/turf/open/floor/plating/ground/mars/random/cave,
/area/bigredv2/caves/southeast)
"R" = (
/obj/effect/landmark/xeno_silo_spawn,
/turf/open/floor/plating/ground/mars/random/cave,
/area/bigredv2/caves/southeast)
"V" = (
/turf/closed/mineral/smooth/bigred,
/area/bigredv2/caves/rock)
"W" = (
/turf/open/floor/plating/ground/mars/random/cave/rock,
/area/bigredv2/caves/southeast)
"X" = (
/turf/open/floor/plating/ground/mars/random/cave/rock,
/area/bigredv2/caves/southeast/garbledradio)

(1,1,1) = {"
V
V
V
V
V
V
V
V
V
V
V
V
V
V
V
V
m
m
m
m
m
m
X
V
V
V
V
V
V
V
V
O
O
O
O
O
O
V
V
V
V
V
V
V
V
V
V
V
V
V
O
O
O
O
V
V
V
V
V
V
V
V
V
V
v
v
a
"}
(2,1,1) = {"
y
V
V
V
V
V
V
V
V
V
V
V
V
V
X
X
m
m
m
V
m
m
X
V
V
V
V
V
V
V
V
O
O
O
O
O
V
V
V
V
V
V
V
V
V
V
V
V
V
V
O
O
O
O
V
V
V
V
V
V
V
V
V
V
V
v
a
"}
(3,1,1) = {"
V
V
V
V
V
V
V
V
V
V
V
V
V
V
m
m
m
m
m
V
X
m
X
V
V
V
V
V
V
V
V
O
O
O
O
O
V
V
V
V
V
V
V
V
V
V
V
V
V
V
O
O
O
O
V
V
V
V
V
V
V
V
V
V
V
v
a
"}
(4,1,1) = {"
V
V
V
V
V
V
V
V
V
V
V
V
V
G
m
m
E
m
V
V
V
O
X
V
V
V
V
V
V
V
V
O
O
O
O
O
V
V
V
V
V
V
V
V
V
V
V
V
V
V
O
O
O
O
V
V
V
V
V
V
V
V
V
V
V
v
a
"}
(5,1,1) = {"
V
V
V
V
V
V
V
V
V
V
V
V
V
m
m
X
m
m
V
V
V
O
X
V
V
V
V
V
V
V
V
O
O
O
O
O
V
V
V
V
V
V
V
V
V
V
V
V
V
V
O
O
F
O
V
V
V
V
V
V
V
V
V
V
V
v
a
"}
(6,1,1) = {"
V
V
V
V
V
V
V
V
V
V
V
X
X
m
m
X
m
m
V
V
V
O
X
V
V
V
V
V
V
V
V
O
O
O
O
O
V
V
V
V
V
V
V
V
V
V
V
V
V
V
O
O
O
O
V
V
V
V
V
V
V
V
V
V
V
v
a
"}
(7,1,1) = {"
V
V
V
V
V
V
V
V
V
V
V
m
m
m
X
m
m
V
V
V
V
O
X
V
V
V
V
V
V
V
V
O
O
O
O
O
V
V
V
V
V
V
V
V
V
V
V
V
V
V
O
O
O
O
V
V
V
V
V
V
V
V
V
V
V
v
a
"}
(8,1,1) = {"
V
V
V
V
V
V
V
V
V
V
V
m
m
E
m
V
V
V
V
V
V
O
X
V
V
V
V
V
V
V
V
O
O
O
O
O
V
V
V
V
V
V
V
V
V
V
V
V
V
V
O
O
O
O
V
V
V
V
V
V
V
V
V
V
V
v
a
"}
(9,1,1) = {"
V
V
V
V
V
V
V
V
V
V
V
m
G
m
m
V
V
V
V
V
V
O
X
V
V
V
V
V
V
V
V
O
O
O
O
O
V
V
V
V
V
V
V
V
V
V
V
V
V
V
O
O
O
O
V
V
V
V
V
V
V
V
V
V
V
v
a
"}
(10,1,1) = {"
V
V
V
V
V
V
V
V
V
V
X
m
X
m
m
V
V
V
V
m
m
E
X
V
V
V
V
V
V
V
O
O
O
O
O
O
V
V
V
V
V
V
V
V
V
V
V
V
V
V
O
O
O
O
V
V
V
V
V
V
V
V
V
V
V
v
a
"}
(11,1,1) = {"
V
V
V
V
V
V
V
V
V
V
m
m
X
m
X
X
X
X
X
m
m
m
X
V
V
V
V
V
V
O
O
O
O
F
O
O
O
V
V
V
V
V
V
V
V
V
V
V
V
V
O
O
O
O
V
V
V
V
V
V
V
V
V
V
V
v
a
"}
(12,1,1) = {"
V
V
V
V
V
V
V
V
V
V
m
m
m
X
m
m
m
m
X
m
m
m
V
V
V
V
V
O
F
O
O
O
F
O
O
O
O
V
V
V
V
V
V
V
V
V
V
V
V
V
O
O
O
V
V
V
V
V
V
V
V
V
V
V
V
v
a
"}
(13,1,1) = {"
V
V
V
V
V
V
V
V
V
V
m
m
m
m
m
m
E
m
m
m
m
m
V
V
V
V
V
O
O
O
O
O
O
O
O
O
O
V
V
V
V
V
V
V
V
V
V
V
V
O
O
O
O
V
V
V
V
V
V
V
V
V
V
V
V
v
a
"}
(14,1,1) = {"
X
m
V
V
V
V
V
V
V
X
m
m
m
m
m
m
m
m
m
m
m
X
V
V
V
V
V
O
O
O
O
O
O
O
O
O
O
O
O
V
V
V
V
V
V
V
V
V
V
O
O
O
F
V
V
V
V
V
V
V
V
V
V
V
V
v
a
"}
(15,1,1) = {"
X
V
V
V
V
V
V
V
V
m
E
m
E
m
m
m
E
m
m
X
V
V
V
V
V
O
O
O
O
O
O
O
O
O
O
O
O
O
O
O
O
V
V
V
V
V
V
V
O
O
O
F
O
V
V
V
V
V
V
V
V
V
V
V
V
v
a
"}
(16,1,1) = {"
X
V
V
V
V
V
V
X
X
m
X
m
m
m
m
m
m
m
m
m
m
V
V
V
V
O
O
O
O
O
O
O
O
O
O
O
O
O
O
O
O
O
O
O
O
V
V
V
O
O
O
O
O
V
V
V
V
V
V
V
V
V
V
V
V
v
a
"}
(17,1,1) = {"
m
V
V
V
V
V
V
m
m
m
X
m
m
m
V
V
V
W
O
O
O
V
V
V
V
O
O
O
O
O
O
O
O
O
O
O
O
O
O
O
O
O
O
O
O
O
O
O
O
O
O
O
V
V
V
V
V
V
V
V
V
V
V
V
V
v
a
"}
(18,1,1) = {"
m
V
V
V
V
V
V
X
m
X
m
m
m
V
V
V
V
V
m
m
E
m
O
O
O
O
O
O
O
O
O
O
O
O
O
O
O
O
O
O
O
O
O
O
O
O
O
O
O
O
O
O
V
V
V
V
V
V
V
V
V
V
V
V
V
v
a
"}
(19,1,1) = {"
m
V
V
V
V
V
m
m
m
X
m
V
V
V
V
V
V
V
V
V
m
O
O
O
O
O
O
O
F
O
O
O
O
F
O
O
O
O
O
O
O
O
F
O
O
O
O
O
O
F
O
F
V
V
V
V
V
V
V
V
V
V
V
V
V
k
a
"}
(20,1,1) = {"
m
V
V
m
m
m
E
m
m
m
E
V
V
V
V
V
V
V
V
V
O
O
O
O
O
O
O
O
O
O
O
O
O
O
O
O
O
O
O
O
O
O
O
O
O
O
O
O
O
O
O
O
V
V
V
V
V
V
V
V
V
V
V
V
V
k
a
"}
(21,1,1) = {"
m
m
m
m
m
m
m
m
X
m
V
V
V
V
V
V
V
V
V
V
F
O
O
O
F
O
O
O
F
O
O
O
O
O
O
V
V
O
O
O
O
O
O
O
O
O
O
O
O
O
O
V
V
V
V
V
V
V
V
V
V
V
V
V
V
k
a
"}
(22,1,1) = {"
m
m
m
m
X
X
m
m
m
m
V
V
V
V
V
V
V
V
V
V
V
O
O
O
O
O
O
O
O
O
O
O
O
O
V
V
V
V
V
O
O
O
O
O
O
O
O
O
O
O
O
V
V
V
V
V
V
V
V
V
V
V
V
V
V
k
a
"}
(23,1,1) = {"
m
E
m
X
m
m
E
m
m
V
V
V
V
V
V
V
V
V
V
V
V
V
V
V
V
V
V
V
O
O
O
O
O
V
V
V
V
V
V
V
O
O
O
O
O
O
O
O
O
O
O
V
V
V
V
V
V
V
V
V
V
V
V
V
V
k
a
"}
(24,1,1) = {"
m
X
X
m
m
m
m
X
V
V
V
V
V
V
V
V
V
V
V
V
V
V
V
V
V
V
V
V
V
V
V
V
V
V
V
V
V
V
V
V
O
O
O
O
O
O
O
O
O
O
O
O
V
V
V
V
V
V
V
V
V
V
V
V
V
k
a
"}
(25,1,1) = {"
X
m
m
X
V
V
V
V
V
V
V
V
V
V
V
V
V
V
V
V
V
V
V
V
V
V
V
V
V
V
V
V
V
V
V
V
V
V
V
V
O
O
O
O
O
O
O
O
O
O
O
O
V
V
V
V
V
V
V
V
V
V
V
V
V
k
a
"}
(26,1,1) = {"
m
m
m
X
V
V
V
V
V
V
V
V
V
V
V
V
V
V
V
V
V
V
V
V
V
V
V
V
V
V
V
V
V
V
V
V
V
V
V
V
O
O
O
O
O
O
O
O
O
O
O
O
V
V
V
V
V
V
V
V
V
V
V
V
V
k
a
"}
(27,1,1) = {"
V
V
V
V
V
V
V
V
V
V
V
V
V
V
V
V
V
V
V
V
V
V
V
V
V
V
V
V
V
V
V
V
V
V
V
V
V
V
V
O
O
O
O
O
O
O
O
O
O
O
O
O
V
V
V
V
V
V
V
V
V
V
V
V
V
k
a
"}
(28,1,1) = {"
V
V
V
V
V
V
V
V
V
V
V
V
V
V
V
V
V
V
V
V
V
V
V
V
V
V
V
V
V
V
V
V
V
V
V
V
V
V
O
O
O
O
O
O
O
O
O
O
O
V
V
V
V
V
V
V
V
V
V
V
V
V
V
V
V
k
a
"}
(29,1,1) = {"
V
V
V
V
V
V
V
V
V
V
V
V
V
V
V
V
V
V
V
V
V
V
V
V
V
V
V
V
V
V
V
V
V
V
V
V
V
O
O
O
O
O
O
O
O
O
O
O
V
V
V
V
V
V
V
V
V
V
V
V
V
V
V
V
V
k
a
"}
(30,1,1) = {"
V
V
V
V
V
V
V
V
V
V
V
V
V
V
V
V
V
V
V
V
V
V
V
V
V
V
V
V
V
V
V
V
V
V
V
V
O
O
O
O
O
O
O
O
O
O
O
O
V
V
V
V
V
V
V
V
V
V
V
V
V
V
V
V
V
k
a
"}
(31,1,1) = {"
V
V
V
V
V
V
V
V
V
V
V
V
V
V
V
V
V
V
V
V
V
V
V
V
V
V
V
V
V
V
V
V
V
V
V
V
O
O
O
O
O
O
O
O
O
O
O
O
V
V
V
V
V
V
V
V
V
V
V
V
V
V
V
V
V
k
a
"}
(32,1,1) = {"
O
O
V
V
V
V
V
V
V
V
V
V
V
V
V
V
V
V
V
V
V
V
V
V
V
V
V
V
V
V
V
V
V
O
O
O
O
O
O
O
j
j
j
j
j
j
j
j
d
d
d
d
V
V
V
V
V
V
V
V
V
V
V
V
V
k
a
"}
(33,1,1) = {"
O
O
O
O
F
O
O
V
V
V
V
V
V
V
V
V
V
V
V
V
V
V
V
V
V
V
V
V
V
V
V
V
O
O
O
O
O
O
O
O
j
O
O
O
O
O
O
O
O
V
V
d
V
V
V
V
V
V
V
V
V
V
V
V
V
k
a
"}
(34,1,1) = {"
O
O
O
O
O
O
O
O
O
V
V
V
V
V
V
V
V
V
V
V
V
V
V
V
V
V
V
V
V
V
V
O
O
O
O
O
O
O
O
O
j
O
O
O
O
O
O
O
O
V
V
d
V
V
V
V
V
V
V
V
V
V
V
V
V
k
a
"}
(35,1,1) = {"
O
O
O
O
O
O
O
O
O
O
O
V
V
V
V
V
V
V
V
V
V
V
V
V
V
V
V
V
V
O
O
O
O
O
O
O
O
O
O
O
j
O
O
O
O
O
O
O
O
O
V
d
V
V
V
V
V
V
V
V
V
V
V
V
V
k
a
"}
(36,1,1) = {"
O
O
O
O
O
O
O
O
O
O
O
O
O
O
V
V
V
V
V
V
V
V
V
V
V
V
V
O
O
O
O
O
O
O
O
O
O
O
O
O
j
O
O
O
O
O
O
O
O
O
V
d
V
V
V
V
V
V
V
V
V
V
V
V
V
k
a
"}
(37,1,1) = {"
O
O
O
O
F
O
O
F
O
O
O
O
O
O
O
O
O
O
V
V
V
V
V
V
V
O
O
O
O
O
O
O
O
O
O
O
O
O
O
O
j
O
O
O
O
O
O
O
O
O
O
d
V
V
V
V
V
V
V
V
V
V
V
V
V
k
a
"}
(38,1,1) = {"
V
V
O
O
O
O
O
O
O
O
O
O
O
O
O
O
O
O
O
O
V
V
V
O
O
O
O
O
O
O
O
O
O
O
O
O
O
O
O
O
j
O
O
O
O
O
O
O
O
O
O
d
V
V
V
V
V
V
V
V
V
V
V
v
v
v
a
"}
(39,1,1) = {"
V
V
O
O
O
O
O
F
O
O
O
O
O
O
F
O
O
O
O
O
O
V
O
O
O
O
O
O
O
O
O
O
O
O
O
O
O
O
O
O
j
O
O
O
O
O
O
O
R
O
O
d
V
V
V
V
V
V
V
V
V
V
V
v
v
v
a
"}
(40,1,1) = {"
V
V
O
O
O
O
O
O
O
O
O
O
O
O
O
O
O
O
O
O
O
O
O
O
O
O
O
O
O
O
O
O
O
O
O
O
O
O
O
O
j
O
O
O
O
O
O
O
O
O
O
d
V
V
V
V
V
V
V
V
V
V
V
v
v
v
a
"}
(41,1,1) = {"
O
O
O
O
O
O
O
O
O
O
O
O
O
O
O
O
O
O
O
O
O
O
O
O
O
O
O
O
O
O
O
O
O
O
O
O
O
O
O
O
j
O
V
O
O
O
O
O
O
O
O
d
V
V
V
V
V
V
V
V
V
V
V
v
v
v
a
"}
(42,1,1) = {"
O
O
O
O
O
O
O
O
O
O
O
O
O
O
O
O
O
O
O
O
O
O
O
O
O
O
O
O
O
O
O
O
O
O
O
O
O
O
O
O
d
V
V
V
O
O
F
O
F
O
O
d
V
V
V
V
V
V
V
V
V
V
V
v
v
v
a
"}
(43,1,1) = {"
O
O
O
O
O
O
O
O
O
O
O
O
O
O
O
O
O
O
O
O
O
O
O
O
O
O
O
O
O
O
O
O
O
O
O
O
O
O
V
V
d
V
V
V
O
O
O
O
O
O
V
d
V
V
V
V
V
V
V
V
V
V
V
v
v
v
a
"}
(44,1,1) = {"
O
O
O
O
O
O
O
O
O
O
O
O
O
O
O
O
O
O
O
O
O
O
O
O
O
O
O
O
O
O
O
O
O
O
O
O
V
V
V
V
d
V
V
V
O
O
O
O
O
V
V
d
V
V
V
V
V
V
V
V
V
V
V
v
v
v
a
"}
(45,1,1) = {"
O
F
O
O
O
O
O
F
O
O
O
O
O
O
F
O
O
O
O
O
O
O
O
O
O
O
O
O
O
O
O
O
O
O
V
V
V
V
V
V
d
V
V
V
V
O
O
O
V
V
V
d
V
V
V
V
V
V
V
V
V
V
V
v
v
v
a
"}
(46,1,1) = {"
O
O
O
O
O
O
O
O
O
O
O
O
O
O
O
O
O
O
O
O
O
O
O
O
O
O
O
O
O
O
O
O
O
O
V
V
V
V
V
V
d
V
V
V
V
V
V
V
V
V
V
d
V
V
V
V
V
V
V
V
V
V
V
v
v
v
a
"}
(47,1,1) = {"
O
O
O
O
O
O
O
O
O
O
O
O
O
O
O
O
O
O
O
O
O
O
O
O
O
O
O
O
O
O
O
O
O
O
V
V
V
V
V
V
d
V
V
V
V
V
V
V
V
V
V
d
V
V
V
V
V
V
V
V
V
V
V
v
v
v
a
"}
(48,1,1) = {"
O
O
O
O
O
O
O
O
O
O
O
O
O
O
O
O
O
O
O
O
O
O
O
O
O
O
O
O
O
O
O
O
O
V
V
V
V
V
V
V
d
d
d
d
d
d
d
d
d
d
d
d
V
V
V
V
V
V
V
V
V
V
V
v
v
v
a
"}
(49,1,1) = {"
O
F
O
O
O
O
O
O
V
V
V
V
V
V
V
O
O
O
O
O
O
O
O
O
O
O
O
O
O
O
O
O
O
V
V
V
V
V
V
V
V
V
V
V
V
V
V
V
V
V
V
V
V
V
V
V
V
V
V
V
V
V
V
v
v
v
a
"}
(50,1,1) = {"
O
O
O
V
V
V
V
V
V
V
V
V
V
V
V
V
V
O
O
O
O
O
O
O
O
O
O
O
O
O
O
V
V
V
V
V
V
V
V
V
V
V
V
V
V
V
V
V
V
V
V
V
V
V
V
V
V
V
V
V
V
V
V
v
v
v
a
"}
(51,1,1) = {"
O
O
O
V
V
V
V
V
V
V
V
V
V
V
V
V
V
V
V
O
O
O
O
O
O
O
O
O
O
O
V
V
V
V
V
V
V
V
V
V
V
V
V
V
V
V
V
V
V
V
V
V
V
V
V
V
V
V
V
V
V
V
V
v
v
v
a
"}
(52,1,1) = {"
V
V
V
V
V
V
V
V
V
V
V
V
V
V
V
V
V
V
V
V
V
V
V
V
V
V
V
V
V
V
V
V
V
V
V
V
V
V
V
V
V
V
V
V
V
V
V
V
V
V
V
V
V
V
V
V
V
V
V
V
V
V
V
v
v
v
a
"}
(53,1,1) = {"
V
V
V
V
V
V
V
V
V
V
V
V
V
V
V
V
V
V
V
V
V
V
V
V
V
V
V
V
V
V
V
V
V
V
V
V
V
V
V
V
V
V
V
V
V
V
V
V
V
V
V
V
V
V
V
V
V
V
V
V
V
V
V
v
v
v
a
"}
(54,1,1) = {"
V
V
V
V
V
V
V
V
V
V
V
V
V
V
V
V
V
V
V
V
V
V
V
V
V
V
V
V
V
V
V
V
V
V
V
V
V
V
V
V
V
V
V
V
V
V
V
V
V
V
V
V
V
V
V
V
V
V
V
V
V
V
V
v
v
v
a
"}
(55,1,1) = {"
V
V
V
V
V
V
V
V
V
V
V
V
V
V
V
V
V
V
V
V
V
V
V
V
V
V
V
V
V
V
V
V
V
V
V
V
V
V
V
V
V
V
V
V
V
V
V
V
V
V
V
V
V
V
V
V
V
V
V
V
V
V
V
v
v
v
a
"}
(56,1,1) = {"
V
V
V
V
V
V
V
V
V
V
V
V
V
V
V
V
V
V
V
V
V
V
V
V
V
V
V
V
V
V
V
V
V
V
V
V
V
V
V
V
V
V
V
V
V
V
V
V
V
V
V
V
V
V
V
V
V
V
V
V
V
V
V
v
v
v
a
"}
(57,1,1) = {"
V
V
V
V
V
V
V
V
V
V
V
V
V
V
V
V
V
V
V
V
V
V
V
V
V
V
V
V
V
V
V
V
V
V
V
V
V
V
V
V
V
V
V
V
V
V
V
V
V
V
V
V
V
V
V
V
V
V
V
V
V
V
V
v
v
v
a
"}
(58,1,1) = {"
V
V
V
V
V
V
V
V
V
V
V
V
V
V
V
V
V
V
V
V
V
V
V
V
V
V
V
V
V
V
V
V
V
V
V
V
V
V
V
V
V
V
V
V
V
V
V
V
V
V
V
V
V
V
V
V
V
V
V
V
V
V
V
v
v
v
a
"}
(59,1,1) = {"
V
V
V
V
V
V
V
V
V
V
V
V
V
V
V
V
V
V
V
V
V
V
V
V
V
V
V
V
V
V
V
V
V
V
V
V
V
V
V
V
V
V
V
V
V
V
V
V
V
V
V
V
V
V
V
V
V
V
V
V
V
V
V
v
v
v
a
"}
(60,1,1) = {"
V
V
V
V
V
V
V
V
V
V
V
V
V
V
V
V
V
V
V
V
V
V
V
V
V
V
V
V
V
V
V
V
V
V
V
V
V
V
V
V
V
V
V
V
V
V
V
V
V
V
V
V
V
V
V
V
V
V
V
V
V
V
V
v
v
v
a
"}
(61,1,1) = {"
V
V
V
V
V
V
V
V
V
V
V
V
V
V
V
V
V
V
V
V
V
V
V
V
V
V
V
V
V
V
V
V
V
V
V
V
V
V
V
V
V
V
V
V
V
V
V
V
V
V
V
V
V
V
V
V
V
V
V
V
V
V
V
v
v
v
a
"}
(62,1,1) = {"
V
V
V
V
V
V
V
V
V
V
V
V
V
V
V
V
V
V
V
V
V
V
V
V
V
V
V
V
V
V
V
V
V
V
V
V
V
V
V
V
V
V
V
V
V
V
V
V
V
V
V
V
V
V
V
V
V
V
V
V
V
V
V
v
v
v
a
"}
(63,1,1) = {"
v
v
v
v
v
v
v
v
v
v
v
v
v
v
v
v
v
v
v
v
v
v
v
v
v
v
v
v
v
v
v
v
v
v
v
v
v
v
v
v
v
v
v
v
v
v
v
v
v
v
v
v
v
v
v
v
v
v
v
v
v
v
v
v
v
v
a
"}
(64,1,1) = {"
v
v
v
v
v
v
v
v
v
v
v
v
v
v
v
v
v
v
v
v
v
v
v
v
v
v
v
v
v
v
v
v
v
v
v
v
v
v
v
v
v
v
v
v
v
v
v
v
v
v
v
v
v
v
v
v
v
v
v
v
v
v
v
v
v
v
a
"}
(65,1,1) = {"
v
v
v
v
v
v
v
v
v
v
v
v
v
v
v
v
v
v
v
v
v
v
v
v
v
v
v
v
v
v
v
v
v
v
v
v
v
v
v
v
v
v
v
v
v
v
v
v
v
v
v
v
v
v
v
v
v
v
v
v
v
v
v
v
v
v
a
"}
(66,1,1) = {"
v
v
v
v
v
v
v
v
v
v
v
v
v
v
v
v
v
v
v
v
v
v
v
v
v
v
v
v
v
v
v
v
v
v
v
v
v
v
v
v
v
v
v
v
v
v
v
v
v
v
v
v
v
v
v
v
v
v
v
v
v
v
v
v
v
v
a
"}
(67,1,1) = {"
v
v
v
v
v
v
v
v
v
v
v
v
v
v
v
v
v
v
v
v
v
v
v
v
v
v
v
v
v
v
v
v
v
v
v
v
v
v
v
v
v
v
v
v
v
v
v
v
v
v
v
v
v
v
v
v
v
v
v
v
v
v
v
v
v
v
a
"}
(68,1,1) = {"
v
v
v
v
v
v
v
v
v
v
v
v
v
v
v
v
v
v
v
v
v
v
v
v
v
v
v
v
v
v
v
v
v
v
v
v
v
v
v
v
v
v
v
v
v
v
v
v
v
v
v
v
v
v
v
v
v
v
v
v
v
v
v
v
v
v
a
"}
(69,1,1) = {"
v
v
v
v
v
v
v
v
v
v
v
v
v
v
v
v
v
v
v
v
v
v
v
v
v
v
v
v
v
v
v
v
v
v
v
v
v
v
v
v
v
v
v
v
v
v
v
v
v
v
v
v
v
v
v
v
v
v
v
v
v
v
v
v
v
v
a
"}
(70,1,1) = {"
v
v
v
v
v
v
v
v
v
v
v
v
v
v
v
v
v
v
v
v
v
v
v
v
v
v
v
v
v
v
v
v
v
v
v
v
v
v
v
v
v
v
v
v
v
v
v
v
v
v
v
v
v
v
v
v
v
v
v
v
v
v
v
v
v
v
a
"}
(71,1,1) = {"
v
v
v
v
v
v
v
v
v
v
v
v
v
v
v
v
v
v
v
v
v
v
v
v
v
v
v
v
v
v
v
v
v
v
v
v
v
v
v
v
v
v
v
v
v
v
v
v
v
v
v
v
v
v
v
v
v
v
v
v
v
v
v
v
v
v
a
"}
