//MAP CONVERTED BY dmm2tgm.py THIS HEADER COMMENT PREVENTS RECONVERSION, DO NOT REMOVE
"ab" = (
/obj/structure/cable,
/obj/machinery/atmospherics/pipe/simple/green/hidden,
/obj/effect/decal/cleanable/dirt,
/turf/open/floor/marking/asteroidwarning{
	dir = 1
	},
/area/bigredv3/outside/directions/nw)
"aj" = (
/obj/effect/turf_decal/sandedge,
/turf/open/floor/marking/asteroidwarning{
	dir = 9
	},
/area/bigredv3/outside/directions/nw)
"ap" = (
/turf/open/floor/plating/ground/mars/random/sand,
/area/bigredv3/outside/medical/virology)
"be" = (
/obj/structure/cable,
/obj/machinery/power/apc/weak/ntf{
	dir = 4
	},
/turf/open/floor/plating,
/area/bigredv3/outside/directions/nw)
"bl" = (
/turf/open/floor/marking/asteroidwarning{
	dir = 1
	},
/area/bigredv3/outside/medical/virology)
"cd" = (
/obj/machinery/light{
	dir = 1
	},
/turf/open/floor/plating/ground/mars/dirttosand/autosmooth{
	dir = 5
	},
/area/bigredv3/outside/medical/virology)
"cf" = (
/obj/effect/decal/cleanable/dirt,
/obj/structure/cable,
/obj/effect/decal/cleanable/dirt,
/turf/open/floor/plating,
/area/bigredv3/outside/directions/nw)
"cM" = (
/turf/open/floor/plating/ground/mars/random/dirt,
/area/bigredv3/outside/medical/virology)
"dn" = (
/turf/open/floor/tile/white,
/area/bigredv3/outside/directions/nw)
"dr" = (
/turf/open/floor/plating/ground/mars/dirttosand/autosmooth{
	dir = 4
	},
/area/bigredv3/caves/northwest)
"dY" = (
/obj/structure/cable,
/obj/effect/decal/cleanable/dirt,
/turf/open/floor/plating,
/area/bigredv3/outside/directions/nw)
"fw" = (
/obj/effect/decal/cleanable/dirt,
/turf/open/floor/marking/asteroidwarning{
	dir = 8
	},
/area/bigredv3/outside/directions/nw)
"fA" = (
/obj/effect/spawner/random/engineering/structure/tank/fuelweighted,
/turf/open/floor/plating,
/area/bigredv3/outside/directions/nw)
"fF" = (
/obj/machinery/light,
/turf/open/floor/plating,
/area/bigredv3/outside/directions/nw)
"fS" = (
/turf/open/floor/marking/asteroidwarning,
/area/bigredv3/outside/directions/nw)
"fW" = (
/obj/machinery/floodlight/outpost/bigred,
/turf/open/floor/plating/ground/mars/random/sand,
/area/bigredv3/outside/directions/nw)
"go" = (
/obj/structure/cable,
/turf/open/floor/marking/asteroidwarning,
/area/bigredv3/outside/directions/nw)
"gC" = (
/turf/open/floor/marking/asteroidwarning{
	dir = 4
	},
/area/bigredv3/outside/medical/virology)
"gK" = (
/obj/machinery/light{
	dir = 4
	},
/turf/open/floor/marking/asteroidwarning{
	dir = 1
	},
/area/bigredv3/outside/medical/virology)
"hl" = (
/obj/structure/cable,
/obj/machinery/atmospherics/pipe/simple/green/hidden,
/turf/open/floor/plating,
/area/bigredv3/outside/directions/nw)
"iV" = (
/obj/machinery/light{
	dir = 8
	},
/turf/open/floor/asteroidfloor,
/area/bigredv3/outside/directions/nw)
"ko" = (
/obj/effect/decal/cleanable/dirt,
/obj/structure/cable,
/obj/effect/decal/cleanable/dirt,
/turf/open/floor/marking/asteroidwarning,
/area/bigredv3/outside/directions/nw)
"kx" = (
/obj/machinery/atmospherics/pipe/simple/green/hidden,
/turf/open/floor/marking/asteroidwarning{
	dir = 4
	},
/area/bigredv3/outside/directions/nw)
"kP" = (
/turf/open/floor/marking/asteroidwarning{
	dir = 9
	},
/area/bigredv3/outside/directions/nw)
"kU" = (
/turf/open/floor/marking/asteroidwarning{
	dir = 5
	},
/area/bigredv3/outside/medical/virology)
"lf" = (
/obj/structure/cable,
/obj/machinery/atmospherics/pipe/simple/green/hidden,
/turf/open/floor/marking/asteroidwarning{
	dir = 4
	},
/area/bigredv3/outside/directions/nw)
"lv" = (
/obj/effect/ai_node,
/turf/open/floor/plating/ground/mars/random/dirt,
/area/bigredv3/outside/medical/virology)
"mj" = (
/obj/structure/cable,
/turf/closed/mineral/smooth/bigred,
/area/bigredv3/caves/rock)
"mm" = (
/obj/effect/ai_node,
/turf/open/floor/plating/ground/mars/random/cave/rock,
/area/bigredv3/caves/west)
"mz" = (
/turf/open/floor/plating/ground/mars/dirttosand/autosmooth{
	dir = 6
	},
/area/bigredv3/caves/northwest)
"mK" = (
/obj/effect/turf_decal/sandedge,
/turf/open/floor/marking/asteroidwarning{
	dir = 5
	},
/area/bigredv3/outside/directions/nw)
"nq" = (
/obj/machinery/atmospherics/pipe/manifold/green/hidden,
/obj/structure/cable,
/turf/open/floor/plating,
/area/bigredv3/outside/directions/nw)
"of" = (
/turf/open/floor/marking/asteroidwarning{
	dir = 1
	},
/area/bigredv3/outside/directions/nw)
"ol" = (
/turf/open/floor/plating/ground/mars/random/cave/rock,
/area/bigredv3/caves/northwest)
"oo" = (
/obj/structure/cable,
/obj/machinery/atmospherics/pipe/simple/green/hidden{
	dir = 4
	},
/turf/open/floor/asteroidfloor,
/area/bigredv3/outside/directions/nw)
"oz" = (
/obj/effect/decal/cleanable/dirt,
/obj/effect/ai_node,
/turf/open/floor/marking/asteroidwarning{
	dir = 10
	},
/area/bigredv3/outside/directions/nw)
"oC" = (
/obj/machinery/atmospherics/pipe/simple/green/hidden,
/turf/open/floor/plating/warning{
	dir = 1
	},
/area/bigredv3/outside/directions/nw)
"pT" = (
/obj/effect/decal/cleanable/dirt,
/obj/effect/decal/cleanable/dirt,
/obj/effect/decal/cleanable/dirt,
/turf/open/floor/marking/asteroidwarning{
	dir = 8
	},
/area/bigredv3/outside/directions/nw)
"rl" = (
/turf/open/floor/plating/ground/mars/cavetodirt{
	dir = 6
	},
/area/bigredv3/caves/west)
"ry" = (
/obj/structure/fence/standard/xenoproof,
/turf/open/floor/plating/ground/mars/random/cave,
/area/bigredv3/caves/west)
"rH" = (
/obj/structure/cable,
/turf/open/floor/plating,
/area/bigredv3/outside/directions/nw)
"sB" = (
/obj/machinery/atmospherics/pipe/simple/green/hidden{
	dir = 4
	},
/obj/structure/cable,
/turf/open/floor/asteroidfloor,
/area/bigredv3/outside/directions/nw)
"sS" = (
/obj/machinery/light,
/obj/effect/ai_node,
/turf/open/floor/plating,
/area/bigredv3/outside/directions/nw)
"tb" = (
/obj/machinery/light,
/obj/effect/spawner/random/engineering/structure/tank/fuelweighted,
/turf/open/floor/plating,
/area/bigredv3/outside/directions/nw)
"tc" = (
/obj/effect/decal/cleanable/dirt,
/obj/structure/cable,
/turf/open/floor/plating,
/area/bigredv3/outside/directions/nw)
"th" = (
/obj/structure/cable,
/obj/machinery/atmospherics/pipe/simple/green/hidden{
	dir = 5
	},
/turf/open/floor/asteroidfloor,
/area/bigredv3/outside/directions/nw)
"tm" = (
/turf/open/floor/marking/asteroidwarning{
	dir = 4
	},
/area/bigredv3/outside/directions/nw)
"to" = (
/obj/effect/decal/cleanable/dirt,
/obj/effect/decal/cleanable/dirt,
/turf/open/floor/marking/asteroidwarning{
	dir = 10
	},
/area/bigredv3/outside/directions/nw)
"tZ" = (
/obj/machinery/light{
	dir = 1
	},
/turf/open/floor/plating,
/area/bigredv3/outside/directions/nw)
"ur" = (
/obj/structure/fence/standard/xenoproof,
/turf/open/floor/plating/ground/mars/cavetodirt{
	dir = 4
	},
/area/bigredv3/caves/west)
"wx" = (
/obj/effect/ai_node,
/turf/open/floor/plating,
/area/bigredv3/outside/directions/nw)
"xS" = (
/turf/open/floor/marking/asteroidwarning{
	dir = 5
	},
/area/bigredv3/outside/directions/nw)
"xY" = (
/obj/machinery/light{
	dir = 8
	},
/turf/open/floor/marking/asteroidwarning{
	dir = 1
	},
/area/bigredv3/outside/directions/nw)
"xZ" = (
/obj/machinery/atmospherics/pipe/simple/green/hidden,
/obj/structure/cable,
/turf/open/floor/marking/asteroidwarning{
	dir = 4
	},
/area/bigredv3/outside/directions/nw)
"yi" = (
/turf/open/floor/plating/ground/mars/random/sand,
/area/bigredv3/outside/directions/nw)
"ys" = (
/obj/machinery/light{
	dir = 1
	},
/obj/structure/cable,
/turf/open/floor/plating,
/area/bigredv3/outside/directions/nw)
"yD" = (
/turf/open/floor/marking/asteroidwarning{
	dir = 10
	},
/area/bigredv3/outside/directions/nw)
"yL" = (
/obj/structure/cable,
/turf/open/floor/marking/asteroidwarning{
	dir = 1
	},
/area/bigredv3/outside/directions/nw)
"yN" = (
/obj/structure/cargo_container/horizontal{
	dir = 4
	},
/turf/open/floor/plating,
/area/bigredv3/outside/directions/nw)
"yR" = (
/obj/structure/largecrate/random/case/double,
/turf/open/floor/plating,
/area/bigredv3/outside/directions/nw)
"zm" = (
/turf/open/floor/marking/asteroidwarning{
	dir = 8
	},
/area/bigredv3/outside/directions/nw)
"zL" = (
/obj/effect/decal/cleanable/blood,
/turf/open/floor/plating/ground/mars/random/sand,
/area/bigredv3/outside/directions/nw)
"As" = (
/obj/machinery/atmospherics/pipe/simple/green/hidden{
	dir = 4
	},
/obj/structure/cable,
/turf/open/floor/marking/asteroidwarning{
	dir = 1
	},
/area/bigredv3/outside/directions/nw)
"AF" = (
/obj/structure/cable,
/obj/machinery/atmospherics/pipe/simple/green/hidden{
	dir = 6
	},
/obj/effect/ai_node,
/turf/open/floor/plating,
/area/bigredv3/outside/directions/nw)
"AL" = (
/turf/open/floor/marking/asteroidwarning{
	dir = 8
	},
/area/bigredv3/outside/medical/virology)
"AW" = (
/obj/effect/ai_node,
/turf/open/floor/marking/asteroidwarning{
	dir = 4
	},
/area/bigredv3/outside/medical/virology)
"Bu" = (
/obj/machinery/atmospherics/pipe/simple/green/hidden{
	dir = 4
	},
/obj/structure/cable,
/obj/effect/decal/cleanable/dirt,
/turf/open/floor/plating,
/area/bigredv3/outside/directions/nw)
"Bz" = (
/turf/closed/mineral/smooth/bigred,
/area/bigredv3/caves/rock)
"BS" = (
/turf/open/floor/plating/ground/mars/dirttosand/autosmooth{
	dir = 5
	},
/area/bigredv3/outside/medical/virology)
"BU" = (
/obj/effect/decal/cleanable/dirt,
/turf/open/floor/marking/asteroidwarning{
	dir = 4
	},
/area/bigredv3/outside/directions/nw)
"BW" = (
/obj/machinery/atmospherics/pipe/simple/green/hidden,
/obj/structure/cable,
/obj/effect/ai_node,
/turf/open/floor/marking/asteroidwarning{
	dir = 4
	},
/area/bigredv3/outside/directions/nw)
"Cp" = (
/obj/effect/decal/cleanable/dirt,
/turf/open/floor/plating,
/area/bigredv3/outside/directions/nw)
"CN" = (
/turf/open/floor/plating/ground/mars/dirttosand/autosmooth,
/area/bigredv3/outside/directions/nw)
"CU" = (
/turf/closed/mineral/smooth/bigred/indestructible,
/area/space)
"Dy" = (
/obj/machinery/light{
	dir = 8
	},
/turf/open/floor/plating,
/area/bigredv3/outside/directions/nw)
"DB" = (
/obj/effect/turf_decal/sandedge{
	dir = 4
	},
/obj/structure/fence/standard/xenoproof,
/turf/open/floor/plating/ground/mars/random/dirt,
/area/bigredv3/caves/northwest)
"Eg" = (
/obj/structure/cargo_container/horizontal{
	dir = 1
	},
/turf/open/floor/plating,
/area/bigredv3/outside/directions/nw)
"EE" = (
/obj/machinery/atmospherics/pipe/simple/green/hidden{
	dir = 4
	},
/obj/structure/cable,
/obj/effect/ai_node,
/turf/open/floor/plating,
/area/bigredv3/outside/directions/nw)
"EY" = (
/turf/open/floor/plating/ground/mars/dirttosand/autosmooth{
	dir = 5
	},
/area/bigredv3/caves/northwest)
"Fn" = (
/obj/machinery/atmospherics/pipe/simple/green/hidden{
	dir = 4
	},
/obj/structure/cable,
/turf/open/floor/plating,
/area/bigredv3/outside/directions/nw)
"FC" = (
/obj/effect/decal/cleanable/dirt,
/turf/open/floor/marking/asteroidwarning{
	dir = 5
	},
/area/bigredv3/outside/directions/nw)
"FL" = (
/turf/open/floor/plating/ground/mars/random/cave/rock,
/area/bigredv3/caves/west)
"FZ" = (
/turf/open/floor/plating/ground/mars/random/cave,
/area/bigredv3/caves/west)
"Gx" = (
/turf/open/floor/marking/asteroidwarning{
	dir = 9
	},
/area/bigredv3/outside/medical/virology)
"GQ" = (
/turf/open/floor/plating/ground/mars/random/cave,
/area/bigredv3/caves/northwest)
"HK" = (
/obj/structure/cable,
/turf/open/floor/asteroidfloor,
/area/bigredv3/outside/directions/nw)
"HY" = (
/obj/machinery/atmospherics/pipe/simple/green/hidden{
	dir = 4
	},
/obj/structure/cable,
/obj/machinery/door/airlock/multi_tile/mainship/medidoor{
	dir = 1;
	name = "\improper Medical Clinic"
	},
/turf/open/floor/tile/white,
/area/bigredv3/outside/directions/nw)
"IA" = (
/turf/open/floor/plating/ground/mars/dirttosand/autosmooth{
	dir = 4
	},
/area/bigredv3/outside/directions/nw)
"Js" = (
/obj/machinery/light{
	dir = 1
	},
/obj/structure/largecrate/random/case/small,
/turf/open/floor/plating,
/area/bigredv3/outside/directions/nw)
"JA" = (
/obj/machinery/atmospherics/pipe/simple/green/hidden{
	dir = 10
	},
/obj/structure/cable,
/turf/open/floor/marking/asteroidwarning{
	dir = 5
	},
/area/bigredv3/outside/directions/nw)
"JV" = (
/obj/effect/ai_node,
/turf/open/floor/marking/asteroidwarning{
	dir = 10
	},
/area/bigredv3/outside/directions/nw)
"KT" = (
/turf/open/floor/plating/warning{
	dir = 8
	},
/area/bigredv3/outside/directions/nw)
"Mr" = (
/turf/open/floor/asteroidfloor,
/area/bigredv3/outside/directions/nw)
"Mz" = (
/turf/open/floor/plating/ground/mars/random/dirt,
/area/bigredv3/outside/directions/nw)
"ME" = (
/turf/open/floor/plating/ground/mars/dirttosand/autosmooth{
	dir = 5
	},
/area/bigredv3/outside/directions/nw)
"MH" = (
/obj/effect/ai_node,
/turf/open/floor/plating/ground/mars/random/sand,
/area/bigredv3/outside/directions/nw)
"MV" = (
/turf/open/floor/plating/ground/mars/random/dirt,
/area/bigredv3/caves/west)
"Ng" = (
/obj/effect/ai_node,
/turf/open/floor/asteroidfloor,
/area/bigredv3/outside/directions/nw)
"NE" = (
/obj/effect/decal/cleanable/dirt,
/obj/structure/cable,
/turf/open/floor/asteroidfloor,
/area/bigredv3/outside/directions/nw)
"NF" = (
/obj/structure/fence/standard/xenoproof,
/obj/effect/turf_decal/sandedge{
	dir = 4
	},
/obj/effect/turf_decal/sandedge{
	dir = 4
	},
/turf/open/floor/plating/ground/mars/random/cave,
/area/bigredv3/caves/northwest)
"OD" = (
/obj/effect/ai_node,
/turf/open/floor/plating/ground/mars/random/cave,
/area/bigredv3/caves/northwest)
"Po" = (
/obj/effect/turf_decal/sandedge,
/turf/open/floor/plating/ground/mars/random/sand,
/area/bigredv3/outside/directions/nw)
"PU" = (
/obj/structure/cable,
/obj/machinery/atmospherics/pipe/simple/green/hidden{
	dir = 4
	},
/turf/open/floor/plating/warning{
	dir = 8
	},
/area/bigredv3/outside/directions/nw)
"QF" = (
/turf/open/floor/plating/ground/mars/dirttosand/autosmooth{
	dir = 8
	},
/area/bigredv3/outside/directions/nw)
"QH" = (
/turf/open/floor/plating/ground/mars/dirttosand/autosmooth{
	dir = 1
	},
/area/bigredv3/outside/directions/nw)
"QI" = (
/obj/effect/decal/cleanable/dirt,
/turf/open/floor/marking/asteroidwarning,
/area/bigredv3/outside/directions/nw)
"Rp" = (
/obj/effect/decal/cleanable/dirt,
/turf/open/floor/marking/asteroidwarning{
	dir = 1
	},
/area/bigredv3/outside/directions/nw)
"Sc" = (
/obj/effect/ai_node,
/turf/open/floor/plating/ground/mars/random/cave,
/area/bigredv3/caves/west)
"Se" = (
/obj/structure/cargo_container/horizontal,
/turf/open/floor/plating,
/area/bigredv3/outside/directions/nw)
"SI" = (
/obj/machinery/light{
	dir = 1
	},
/turf/open/floor/plating/ground/mars/random/dirt,
/area/bigredv3/outside/medical/virology)
"SJ" = (
/turf/open/floor/plating/ground/mars/dirttosand/autosmooth{
	dir = 9
	},
/area/bigredv3/outside/directions/nw)
"Uk" = (
/obj/effect/decal/cleanable/dirt,
/turf/open/floor/asteroidfloor,
/area/bigredv3/outside/directions/nw)
"Vv" = (
/obj/machinery/atmospherics/pipe/simple/green/hidden,
/obj/structure/cable,
/turf/open/floor/plating,
/area/bigredv3/outside/directions/nw)
"Wh" = (
/turf/open/floor/asteroidfloor,
/area/bigredv3/outside/medical/virology)
"Wk" = (
/obj/structure/cable,
/obj/machinery/atmospherics/pipe/simple/green/hidden,
/obj/effect/ai_node,
/turf/open/floor/asteroidfloor,
/area/bigredv3/outside/directions/nw)
"Wp" = (
/turf/open/floor/plating/warning{
	dir = 1
	},
/area/bigredv3/outside/directions/nw)
"Wu" = (
/obj/structure/fence/standard/xenoproof,
/obj/effect/turf_decal/sandedge{
	dir = 4
	},
/turf/open/floor/plating/ground/mars/random/cave,
/area/bigredv3/caves/northwest)
"Wx" = (
/obj/effect/decal/cleanable/dirt,
/turf/open/floor/marking/asteroidwarning{
	dir = 6
	},
/area/bigredv3/outside/directions/nw)
"WF" = (
/obj/structure/rack,
/turf/open/floor/plating,
/area/bigredv3/outside/directions/nw)
"WG" = (
/turf/open/floor/plating,
/area/bigredv3/outside/directions/nw)
"WI" = (
/turf/closed/wall/r_wall,
/area/bigredv3/inside/wall)
"XK" = (
/obj/effect/decal/cleanable/dirt,
/obj/effect/decal/cleanable/dirt,
/obj/effect/decal/cleanable/dirt,
/turf/open/floor/marking/asteroidwarning{
	dir = 9
	},
/area/bigredv3/outside/directions/nw)
"YI" = (
/obj/machinery/atmospherics/pipe/simple/green/hidden,
/turf/open/floor/marking/asteroidwarning{
	dir = 1
	},
/area/bigredv3/outside/directions/nw)
"Zd" = (
/turf/open/floor/plating/ground/mars/random/sand,
/area/bigredv3/caves/northwest)
"Zk" = (
/obj/structure/cable,
/turf/open/floor/plating/warning{
	dir = 1
	},
/area/bigredv3/outside/directions/nw)
"Zq" = (
/obj/effect/decal/cleanable/dirt,
/obj/effect/ai_node,
/turf/open/floor/marking/asteroidwarning{
	dir = 8
	},
/area/bigredv3/outside/directions/nw)
"ZQ" = (
/obj/structure/cable,
/obj/effect/ai_node,
/turf/open/floor/asteroidfloor,
/area/bigredv3/outside/directions/nw)

(1,1,1) = {"
CU
CU
CU
CU
CU
CU
CU
CU
CU
CU
CU
CU
CU
CU
CU
CU
CU
CU
CU
CU
CU
CU
"}
(2,1,1) = {"
Bz
Bz
Bz
Bz
Bz
Bz
Bz
Bz
Bz
Bz
Bz
Bz
Bz
Bz
Bz
Bz
Bz
Bz
Bz
Bz
Bz
Bz
"}
(3,1,1) = {"
Bz
Bz
Bz
Bz
Bz
Bz
Bz
Bz
Bz
Bz
Bz
Bz
Bz
Bz
Bz
Bz
FL
FL
FL
FL
Bz
Bz
"}
(4,1,1) = {"
Bz
Bz
Bz
Bz
Bz
Bz
Bz
Bz
Bz
Bz
Bz
Bz
Bz
Bz
Bz
FL
FZ
FZ
FZ
FZ
FL
Bz
"}
(5,1,1) = {"
Bz
Bz
Bz
Bz
Bz
Bz
Bz
Bz
Bz
Bz
Bz
Bz
Bz
Bz
FL
FZ
FZ
FZ
FZ
FZ
FZ
FL
"}
(6,1,1) = {"
Bz
Bz
Bz
Bz
Bz
Bz
Bz
Bz
Bz
Bz
Bz
Bz
Bz
Bz
FZ
FZ
FZ
FZ
FZ
FZ
FZ
FZ
"}
(7,1,1) = {"
Bz
Bz
Bz
Bz
Bz
Bz
Bz
Bz
Bz
Bz
Bz
Bz
Bz
ol
FZ
FZ
FZ
FZ
FZ
FZ
FL
FZ
"}
(8,1,1) = {"
Bz
Bz
Bz
Bz
Bz
Bz
Bz
Bz
GQ
GQ
GQ
GQ
GQ
OD
FZ
FZ
FZ
FZ
FZ
FZ
mm
FZ
"}
(9,1,1) = {"
Bz
GQ
GQ
GQ
GQ
GQ
GQ
GQ
GQ
GQ
GQ
GQ
GQ
GQ
FZ
FZ
FZ
FZ
FZ
FZ
FL
FZ
"}
(10,1,1) = {"
GQ
GQ
GQ
GQ
GQ
GQ
GQ
GQ
GQ
GQ
GQ
GQ
ol
GQ
FZ
FZ
FZ
FZ
FZ
FZ
FL
FZ
"}
(11,1,1) = {"
GQ
GQ
GQ
GQ
GQ
ol
GQ
GQ
GQ
GQ
GQ
GQ
GQ
GQ
FZ
FZ
FZ
FZ
FZ
FZ
FL
Bz
"}
(12,1,1) = {"
GQ
GQ
ol
ol
GQ
GQ
OD
GQ
GQ
GQ
GQ
OD
GQ
OD
FZ
FZ
FZ
FZ
FZ
FZ
mm
Bz
"}
(13,1,1) = {"
ol
GQ
GQ
GQ
GQ
GQ
GQ
GQ
GQ
GQ
GQ
ol
GQ
GQ
FZ
FZ
FZ
FZ
FZ
FZ
FZ
FL
"}
(14,1,1) = {"
GQ
GQ
GQ
GQ
GQ
GQ
Bz
Bz
Bz
NF
DB
DB
DB
Wu
Bz
Bz
Bz
FZ
FZ
FZ
Sc
FL
"}
(15,1,1) = {"
GQ
GQ
GQ
GQ
GQ
Bz
Bz
Bz
Bz
EY
dr
dr
mz
EY
Bz
Bz
Bz
FZ
Bz
Bz
ry
ur
"}
(16,1,1) = {"
GQ
GQ
GQ
Bz
Bz
Bz
Bz
Bz
Bz
WI
WI
WI
WI
WI
Bz
Bz
Bz
Bz
Bz
Bz
rl
MV
"}
(17,1,1) = {"
GQ
GQ
Bz
Bz
Bz
Bz
Bz
Bz
Bz
Zd
Zd
Zd
Zd
Zd
Bz
Bz
Bz
Bz
WI
WI
WI
WI
"}
(18,1,1) = {"
Bz
Bz
Bz
Bz
Bz
Bz
Bz
WI
WI
WI
WI
WI
WI
WI
WI
Bz
Bz
Bz
WI
cM
cM
cM
"}
(19,1,1) = {"
Bz
Bz
Bz
Bz
Bz
Bz
Bz
WI
WG
WG
WG
WG
WG
WG
WI
WI
WI
WI
WI
cM
cM
cM
"}
(20,1,1) = {"
Bz
Bz
Bz
Bz
Bz
Bz
Bz
WI
tZ
WG
WG
wx
WG
WG
WG
Eg
yN
Se
WI
cM
lv
Gx
"}
(21,1,1) = {"
Bz
Bz
Bz
Bz
Bz
Bz
Bz
WI
WG
WG
WG
WG
wx
WG
WG
WG
WG
WG
WI
cd
cM
bl
"}
(22,1,1) = {"
Bz
Bz
Bz
Bz
Bz
Bz
Bz
WI
WG
WG
WG
WG
WG
wx
WG
WG
WG
sS
WI
ap
BS
bl
"}
(23,1,1) = {"
Bz
Bz
Bz
Bz
Bz
Bz
Bz
WI
WG
Eg
yN
Se
WG
WG
WG
WG
WG
WG
WI
ap
ap
bl
"}
(24,1,1) = {"
Bz
Bz
Bz
Bz
Bz
Bz
Bz
WI
WG
WG
WG
WG
WG
WG
WG
WG
WG
WG
Gx
AL
AL
Wh
"}
(25,1,1) = {"
Bz
Bz
Bz
yi
yi
yi
yi
WI
WG
WG
WG
WG
WG
WG
WG
WG
WG
wx
bl
Wh
Wh
Wh
"}
(26,1,1) = {"
Bz
yi
yi
yi
yi
yi
yi
WI
WG
WG
WG
WG
WG
WG
WG
WG
wx
WG
kU
gC
AW
Wh
"}
(27,1,1) = {"
Po
yi
yi
yi
fW
yi
WI
WI
WG
WG
WG
WG
WG
WG
WG
WG
WG
WG
WI
cM
cM
bl
"}
(28,1,1) = {"
aj
zm
JV
yi
yi
yi
WI
be
WG
WG
wx
WG
wx
WG
WG
WG
WG
WG
WI
cM
cM
bl
"}
(29,1,1) = {"
mK
Mr
fS
yi
yi
yi
WI
rH
WG
WG
WG
WG
WG
WG
WG
WG
WG
WG
WI
SI
cM
bl
"}
(30,1,1) = {"
mj
yL
go
yi
yi
yi
WI
ys
WG
WG
WG
Eg
yN
Se
WG
WG
WG
fF
WI
cM
cM
bl
"}
(31,1,1) = {"
Bz
of
ko
yi
yi
SJ
WI
rH
WG
WG
WG
WG
WG
WG
WG
WG
WG
WG
WI
cM
Gx
AL
"}
(32,1,1) = {"
yi
of
go
QF
QF
Mz
WI
rH
WG
WG
WG
WG
WG
WG
WG
WG
WG
WG
WI
cM
gK
Wh
"}
(33,1,1) = {"
yi
of
HK
fw
zm
fw
yD
tc
Cp
WG
WG
WG
WG
WG
Cp
XK
pT
to
WI
WI
WI
Wh
"}
(34,1,1) = {"
yi
of
ZQ
NE
NE
NE
go
dY
cf
rH
AF
hl
hl
hl
hl
ab
Wk
th
oz
Mz
xY
Mr
"}
(35,1,1) = {"
SJ
of
Mr
Mr
Mr
tm
Wx
WG
WG
WG
Bu
WG
WG
WG
WG
Rp
Uk
sB
QI
Mz
xS
tm
"}
(36,1,1) = {"
QH
of
Uk
Uk
Wx
Mz
WI
WG
WG
Cp
Fn
Cp
WG
WG
WG
FC
BU
oo
QI
Mz
Mz
of
"}
(37,1,1) = {"
QH
Rp
Mr
QI
Mz
IA
WI
WI
WI
KT
PU
KT
WI
WI
WI
WI
Mz
As
QI
Mz
Mz
of
"}
(38,1,1) = {"
QH
of
Mr
QI
CN
yi
WI
fA
WG
WG
Fn
WG
Dy
WG
WG
WI
Mz
As
fS
Mz
Mz
of
"}
(39,1,1) = {"
QH
of
Mr
fS
CN
yi
WI
Js
WG
WG
Fn
WG
Eg
yN
Se
WI
Mz
As
Mr
fw
zm
Mr
"}
(40,1,1) = {"
Zq
Mr
Ng
QI
CN
fW
WI
WG
WG
WG
Fn
WG
WG
WG
WG
WI
Mz
JA
BW
xZ
xZ
lf
"}
(41,1,1) = {"
Uk
Mr
Uk
fS
CN
yi
WI
WG
WG
WG
EE
WG
Eg
yN
Se
WI
IA
IA
IA
IA
Mz
Mz
"}
(42,1,1) = {"
tm
tm
BU
Wx
CN
yi
WI
WG
WG
WG
Fn
WG
WG
WG
WG
WI
yi
yi
yi
yi
ME
IA
"}
(43,1,1) = {"
Mz
Mz
Mz
Mz
Mz
yi
WI
WG
WG
WG
Fn
WG
WG
WG
WG
WI
yi
fW
yi
yi
yi
yi
"}
(44,1,1) = {"
Mz
Mz
Mz
Mz
Mz
kP
WI
tZ
WG
WG
Fn
WG
WG
WG
tb
WI
yi
yi
yi
yi
yi
yi
"}
(45,1,1) = {"
zm
zm
zm
zm
zm
of
Wp
WG
WG
WG
Fn
WG
WG
WG
WG
WI
yi
yi
MH
yi
yi
yi
"}
(46,1,1) = {"
HK
HK
ZQ
HK
ZQ
yL
Zk
WG
WG
WG
EE
WG
WG
WG
WG
WI
yi
yi
yi
yi
yi
yi
"}
(47,1,1) = {"
kx
kx
kx
kx
kx
YI
oC
Vv
Vv
Vv
nq
WG
WG
WG
WF
WI
yi
yi
yi
yi
yi
yi
"}
(48,1,1) = {"
IA
IA
Mz
Mz
Mz
xS
WI
yR
WG
WG
Fn
WG
WG
WG
WG
WI
yi
yi
yi
yi
yi
yi
"}
(49,1,1) = {"
yi
yi
ME
IA
IA
IA
WI
Js
WG
WG
Fn
WG
WG
WG
fF
WI
yi
fW
yi
yi
yi
yi
"}
(50,1,1) = {"
yi
yi
fW
yi
yi
yi
WI
yR
WG
WG
Fn
WG
Eg
yN
Se
WI
yi
yi
yi
yi
yi
yi
"}
(51,1,1) = {"
yi
yi
yi
yi
yi
yi
WI
WG
WG
WG
Fn
WG
WG
WG
WG
WI
yi
yi
yi
yi
yi
yi
"}
(52,1,1) = {"
yi
yi
yi
yi
yi
yi
WI
WG
WG
WG
EE
WG
WG
WG
WG
WI
yi
yi
yi
yi
yi
zL
"}
(53,1,1) = {"
yi
yi
yi
yi
yi
yi
WI
WI
WI
dn
HY
WI
WI
WI
WI
WI
yi
yi
yi
yi
yi
yi
"}
(54,1,1) = {"
yi
yi
yi
yi
yi
yi
of
iV
Mr
Mr
sB
Mr
Mr
iV
Mr
fS
yi
yi
MH
yi
yi
yi
"}
