//MAP CONVERTED BY dmm2tgm.py THIS HEADER COMMENT PREVENTS RECONVERSION, DO NOT REMOVE
"a" = (
/turf/open/floor/asteroidfloor,
/area/bigredv2/caves/northeast)
"p" = (
/obj/structure/cable,
/turf/open/floor/asteroidfloor,
/area/bigredv2/caves/northeast)

(1,1,1) = {"
a
p
"}
