//MAP CONVERTED BY dmm2tgm.py THIS HEADER COMMENT PREVENTS RECONVERSION, DO NOT REMOVE
"e" = (
/turf/open/floor/plating/ground/mars/random/cave,
/area/bigredv2/caves/south)
"h" = (
/turf/open/floor/plating/ground/mars/random/cave/rock,
/area/bigredv2/caves/southwest)
"j" = (
/obj/effect/ai_node,
/turf/open/floor/plating/ground/mars/random/cave/rock,
/area/bigredv2/caves/southwest)
"l" = (
/obj/effect/landmark/lv624/fog_blocker,
/turf/open/floor/plating/ground/mars/random/cave,
/area/bigredv2/caves/southwest)
"p" = (
/obj/effect/landmark/lv624/fog_blocker,
/turf/open/floor/plating/ground/mars/random/cave,
/area/bigredv2/caves/south/garbledradio)
"q" = (
/obj/effect/landmark/excavation_site_spawner,
/turf/open/floor/plating/ground/mars/random/cave,
/area/bigredv2/caves/south/garbledradio)
"s" = (
/turf/open/floor/plating/ground/mars/random/cave/rock,
/area/bigredv2/caves/south/garbledradio)
"u" = (
/turf/open/floor/plating/ground/mars/random/cave,
/area/bigredv2/caves/south/garbledradio)
"x" = (
/obj/effect/landmark/lv624/fog_blocker,
/turf/closed/mineral/smooth/bigred,
/area/bigredv2/caves/rock)
"B" = (
/obj/effect/ai_node,
/turf/open/floor/plating/ground/mars/random/cave,
/area/bigredv2/caves/southwest)
"H" = (
/turf/open/floor/plating/ground/mars/random/cave,
/area/bigredv2/caves/southwest)
"Q" = (
/obj/effect/ai_node,
/turf/open/floor/plating/ground/mars/random/cave,
/area/bigredv2/caves/south/garbledradio)
"T" = (
/obj/effect/ai_node,
/turf/open/floor/plating/ground/mars/random/cave,
/area/bigredv2/caves/south)
"U" = (
/turf/closed/mineral/smooth/bigred,
/area/bigredv2/caves/rock)
"Y" = (
/obj/effect/landmark/lv624/fog_blocker,
/turf/open/floor/plating/ground/mars/random/cave/rock,
/area/bigredv2/caves/southwest)

(1,1,1) = {"
x
U
U
U
U
U
h
H
H
H
h
U
U
U
U
H
H
U
U
U
U
U
"}
(2,1,1) = {"
l
U
U
U
U
U
U
H
B
H
h
U
U
U
U
H
H
H
U
U
U
U
"}
(3,1,1) = {"
l
U
U
U
U
U
U
H
H
H
h
U
U
U
h
H
H
U
U
U
U
U
"}
(4,1,1) = {"
l
U
U
U
U
U
H
H
H
H
h
U
U
U
h
H
H
U
U
U
U
U
"}
(5,1,1) = {"
l
h
U
U
U
U
H
H
H
H
H
U
U
h
H
H
H
U
U
U
U
U
"}
(6,1,1) = {"
l
h
U
U
h
h
H
H
H
H
H
U
U
H
H
B
U
U
U
U
U
U
"}
(7,1,1) = {"
l
H
h
j
H
H
H
H
B
H
U
U
U
H
B
U
U
U
U
U
U
U
"}
(8,1,1) = {"
l
H
H
h
H
H
H
H
H
U
U
U
H
H
H
U
U
U
U
U
U
U
"}
(9,1,1) = {"
l
h
H
H
H
H
H
U
U
U
U
U
H
H
H
U
U
U
U
U
U
U
"}
(10,1,1) = {"
Y
H
H
B
U
U
U
U
U
U
U
U
H
H
H
U
U
U
U
U
U
U
"}
(11,1,1) = {"
x
U
U
U
U
U
U
U
U
U
U
U
H
H
H
H
U
U
U
U
U
U
"}
(12,1,1) = {"
U
x
U
U
U
U
U
U
U
U
U
H
H
H
H
H
U
U
U
U
U
U
"}
(13,1,1) = {"
U
U
x
x
U
U
U
U
U
U
U
H
H
H
H
H
U
U
U
U
U
U
"}
(14,1,1) = {"
U
U
U
U
x
U
U
U
U
U
U
H
H
H
H
H
U
U
U
U
U
U
"}
(15,1,1) = {"
U
U
U
U
U
x
U
U
U
U
H
H
H
H
H
h
U
U
U
U
U
U
"}
(16,1,1) = {"
U
U
U
U
U
U
x
U
U
U
B
H
H
H
B
h
h
U
U
U
U
U
"}
(17,1,1) = {"
H
U
U
U
U
U
x
U
U
U
H
H
H
H
h
h
U
U
U
U
U
U
"}
(18,1,1) = {"
H
B
U
U
U
U
x
U
U
U
H
H
H
H
H
H
U
U
U
U
U
U
"}
(19,1,1) = {"
H
H
U
U
U
U
x
U
U
U
H
H
H
H
H
H
H
U
U
U
U
U
"}
(20,1,1) = {"
h
H
U
U
U
U
x
U
U
H
H
H
H
H
H
h
H
U
U
U
U
U
"}
(21,1,1) = {"
h
H
H
U
U
U
x
U
U
H
H
H
H
H
H
h
H
U
U
U
U
U
"}
(22,1,1) = {"
H
B
H
H
B
U
x
U
U
H
H
H
H
H
H
U
U
U
U
U
U
U
"}
(23,1,1) = {"
H
H
H
H
H
U
x
U
U
H
B
H
H
H
B
U
U
U
U
U
U
U
"}
(24,1,1) = {"
H
H
H
H
H
U
x
U
U
U
H
H
H
H
H
U
U
U
U
U
U
U
"}
(25,1,1) = {"
H
H
H
H
H
U
x
U
U
H
H
h
H
H
H
U
U
U
U
U
U
U
"}
(26,1,1) = {"
u
u
u
u
u
U
x
U
U
u
u
u
u
s
u
U
U
U
U
U
U
U
"}
(27,1,1) = {"
u
Q
u
u
u
U
x
U
U
U
u
u
u
u
u
U
U
U
U
U
U
U
"}
(28,1,1) = {"
s
u
u
u
u
U
x
U
U
U
u
u
u
u
u
u
U
U
U
U
U
U
"}
(29,1,1) = {"
s
u
u
u
u
U
x
U
U
U
Q
u
u
u
Q
s
U
U
U
U
U
U
"}
(30,1,1) = {"
u
u
u
u
u
U
x
U
U
U
u
u
u
u
u
u
u
U
U
U
U
U
"}
(31,1,1) = {"
u
u
u
u
u
U
x
U
U
U
u
u
u
u
u
u
u
U
U
U
U
U
"}
(32,1,1) = {"
u
u
u
u
u
U
x
U
U
u
u
u
u
u
u
u
u
u
U
U
U
U
"}
(33,1,1) = {"
u
u
u
u
u
u
p
u
u
u
u
u
u
u
u
u
u
u
U
U
U
U
"}
(34,1,1) = {"
s
u
u
u
u
u
p
u
u
u
u
u
u
u
u
u
u
Q
U
U
U
U
"}
(35,1,1) = {"
s
Q
u
u
Q
u
p
u
u
u
Q
u
u
u
u
u
Q
u
U
U
U
U
"}
(36,1,1) = {"
s
u
u
u
u
u
p
u
u
u
U
U
U
u
u
Q
u
u
u
U
U
U
"}
(37,1,1) = {"
u
u
u
u
u
u
p
u
U
U
U
U
U
U
u
u
u
u
u
u
e
U
"}
(38,1,1) = {"
u
Q
u
u
u
u
x
U
U
U
U
U
U
U
u
u
u
u
u
u
u
e
"}
(39,1,1) = {"
u
u
u
U
U
U
x
U
U
U
U
U
U
U
u
Q
u
u
u
u
u
T
"}
(40,1,1) = {"
u
u
u
U
U
U
x
U
U
U
U
U
U
U
u
u
u
u
u
u
T
e
"}
(41,1,1) = {"
u
u
u
U
U
U
x
U
U
U
U
U
U
u
u
u
u
u
s
u
u
e
"}
(42,1,1) = {"
u
u
U
U
U
U
x
U
U
U
U
U
u
u
u
u
u
u
u
q
e
e
"}
(43,1,1) = {"
u
U
U
U
U
U
x
U
U
U
U
u
Q
u
s
Q
u
u
Q
s
U
U
"}
(44,1,1) = {"
U
U
U
U
U
U
x
U
U
U
U
U
u
s
u
u
u
s
U
U
U
U
"}
