//MAP CONVERTED BY dmm2tgm.py THIS HEADER COMMENT PREVENTS RECONVERSION, DO NOT REMOVE
"ae" = (
/turf/closed/mineral/smooth/bigred/indestructible,
/area/space)
"ah" = (
/turf/open/floor/plating/ground/mars/random/cave/rock,
/area/bigredv3/caves/east/garbledradio)
"aj" = (
/obj/effect/landmark/lv624/fog_blocker,
/turf/closed/mineral/smooth/bigred,
/area/bigredv3/caves/rock)
"ak" = (
/obj/effect/landmark/lv624/fog_blocker,
/turf/closed/wall/r_wall,
/area/bigredv3/caves/east/garbledradio)
"am" = (
/turf/open/floor/plating/ground/mars/random/cave,
/area/bigredv3/caves/east/garbledradio)
"ao" = (
/turf/open/floor/plating/ground/mars/random/sand,
/area/bigredv3/outside/directions/se)
"aq" = (
/obj/effect/landmark/lv624/fog_blocker/xeno_spawn,
/obj/effect/landmark/lv624/fog_blocker/xeno_spawn,
/turf/closed/mineral/smooth/bigred,
/area/bigredv3/caves/rock)
"at" = (
/obj/effect/landmark/lv624/fog_blocker/xeno_spawn,
/turf/closed/mineral/smooth/bigred,
/area/bigredv3/caves/rock)
"az" = (
/obj/effect/landmark/lv624/fog_blocker/xeno_spawn,
/turf/open/floor/plating/ground/mars/random/cave/rock,
/area/bigredv3/caves/east/garbledradio)
"aF" = (
/turf/closed/mineral/smooth/bigred,
/area/bigredv3/caves/rock)
"aG" = (
/obj/effect/ai_node,
/turf/open/floor/plating/ground/mars/random/cave,
/area/bigredv3/caves/east)
"aK" = (
/obj/effect/landmark/lv624/fog_blocker/xeno_spawn,
/obj/effect/ai_node,
/turf/open/floor/plating/ground/mars/random/cave,
/area/bigredv3/caves/east/garbledradio)
"aM" = (
/obj/effect/landmark/xeno_silo_spawn,
/turf/open/floor/plating/ground/mars/random/cave,
/area/bigredv3/caves/east/garbledradio)
"aP" = (
/turf/open/floor/plating/ground/mars/random/cave/rock,
/area/bigredv3/caves/east)
"aR" = (
/turf/open/floor/plating/ground/mars/random/cave,
/area/bigredv3/caves/east)
"aV" = (
/obj/effect/ai_node,
/turf/open/floor/plating/ground/mars/random/cave,
/area/bigredv3/caves/east/garbledradio)
"aX" = (
/obj/effect/landmark/lv624/fog_blocker/xeno_spawn,
/turf/open/floor/plating/ground/mars/random/cave,
/area/bigredv3/caves/east/garbledradio)
"aY" = (
/obj/effect/landmark/lv624/fog_blocker/xeno_spawn,
/obj/effect/landmark/lv624/fog_blocker/xeno_spawn,
/turf/open/floor/plating/ground/mars/random/cave,
/area/bigredv3/caves/east/garbledradio)
"aZ" = (
/obj/effect/ai_node,
/turf/open/floor/plating/ground/mars/random/cave/rock,
/area/bigredv3/caves/east/garbledradio)
"hm" = (
/obj/structure/fence/standard/xenoproof,
/turf/open/floor/plating/ground/mars/random/cave,
/area/bigredv3/caves/east/garbledradio)
"hE" = (
/obj/effect/ai_node,
/turf/open/floor/plating/ground/mars/random/sand,
/area/bigredv3/outside/directions/se)
"GC" = (
/obj/effect/landmark/xeno_tunnel_spawn,
/turf/open/floor/plating/ground/mars/random/cave/rock,
/area/bigredv3/caves/east/garbledradio)
"Hg" = (
/obj/effect/landmark/xeno_tunnel_spawn,
/turf/open/floor/plating/ground/mars/random/cave,
/area/bigredv3/caves/east/garbledradio)

(1,1,1) = {"
ao
ao
ao
ao
ao
ao
ao
ao
ao
ao
ao
aF
aF
aF
ak
hm
hm
am
am
am
am
am
am
am
am
am
am
am
aF
aF
aF
aF
aF
aF
aF
aF
aF
am
am
am
am
am
"}
(2,1,1) = {"
ao
ao
ao
ao
ao
ao
ao
ao
ao
ao
ao
aF
aF
aF
aj
am
am
am
am
am
am
am
am
am
am
am
am
am
aF
aF
aF
aF
aF
aF
aF
aF
aF
aF
am
am
aV
am
"}
(3,1,1) = {"
ao
ao
ao
ao
ao
ao
ao
ao
ao
ao
ao
aF
aF
aF
aj
am
am
am
am
am
am
aF
aF
aF
aF
aF
am
am
am
aF
aF
aF
aF
aF
aF
aF
aF
aF
am
am
am
am
"}
(4,1,1) = {"
ao
aF
aF
aF
aF
ao
ao
ao
ao
ao
ao
ao
aF
aF
aj
am
am
am
am
am
am
aF
aF
aF
aF
aF
ah
am
am
am
am
am
am
am
am
aF
ah
ah
am
am
am
am
"}
(5,1,1) = {"
ao
aF
aF
aF
aF
aF
aF
ao
ao
ao
ao
ao
ao
aF
aj
aF
am
aY
aX
aX
at
at
at
at
at
at
aX
az
aY
am
am
am
am
am
am
ah
am
am
am
am
am
am
"}
(6,1,1) = {"
ao
ao
aF
aF
aF
aF
aF
aF
ao
ao
ao
ao
ao
aF
aj
aF
aF
aX
am
aF
aF
aF
aF
aF
aF
am
am
am
az
ah
aV
am
am
am
am
am
am
am
am
am
aV
ah
"}
(7,1,1) = {"
ao
ao
ao
ao
ao
ao
ao
ao
ao
ao
ao
ao
ao
aF
aj
aF
aF
aX
am
am
am
aF
am
aF
aF
am
aV
am
aX
aV
am
am
am
am
am
am
am
am
am
am
am
ah
"}
(8,1,1) = {"
ao
ao
ao
ao
ao
ao
ao
ao
ao
ao
ao
ao
ao
aF
aj
aF
aF
at
am
am
am
aV
am
am
aV
aV
am
am
aX
am
am
am
am
am
am
am
ah
am
am
am
ah
aF
"}
(9,1,1) = {"
ao
ao
ao
ao
ao
hE
ao
ao
ao
hE
ao
ao
ao
aF
aj
aF
aF
at
am
am
am
am
am
am
am
am
am
aF
at
aF
aF
aF
am
am
am
am
am
ah
am
am
am
ah
"}
(10,1,1) = {"
ao
ao
ao
ao
ao
ao
ao
ao
ao
ao
ao
ao
aF
aF
aj
aF
aF
at
aF
aF
am
am
am
am
am
aF
aF
aF
at
aF
aF
aF
aF
aF
aF
aF
am
am
am
am
am
ah
"}
(11,1,1) = {"
ao
ao
aF
ao
ao
ao
ao
ao
ao
ao
ao
aF
aF
aF
aj
aF
aF
at
aF
am
am
am
am
am
am
am
aF
aF
at
aF
aF
aF
aF
aF
aF
aF
am
am
am
am
am
ah
"}
(12,1,1) = {"
ao
aF
aF
ao
ao
ao
ao
ao
ao
aF
aF
aF
aF
aF
aj
aF
aF
at
am
ah
am
am
ah
am
am
am
aF
aF
at
aF
aF
aF
aF
aF
aF
aF
am
am
am
am
am
ah
"}
(13,1,1) = {"
aF
aF
aF
ao
ao
ao
ao
ao
ao
aF
aF
aF
aF
aF
aj
aF
aF
at
am
am
am
am
am
am
am
am
aF
aF
at
aF
aF
aF
aF
aF
aF
aF
ah
am
am
am
ah
aF
"}
(14,1,1) = {"
aF
aF
ao
ao
ao
ao
ao
ao
ao
aF
aF
aF
aF
aF
aj
aF
aF
at
am
am
am
aV
aM
am
am
am
am
aF
at
aF
aF
aF
aF
aF
aF
aF
am
am
am
am
aV
ah
"}
(15,1,1) = {"
aF
ao
ao
ao
ao
ao
aF
aF
aF
aF
aF
aF
aF
aF
aj
aF
aF
at
Hg
am
am
am
am
am
am
am
aF
aF
at
aF
aF
aF
aF
aF
aF
aF
aF
ah
am
am
am
ah
"}
(16,1,1) = {"
ao
ao
ao
ao
ao
hE
aF
aF
aF
aF
aF
aF
aF
aF
aj
aF
aF
at
aF
aF
aF
am
am
am
am
aF
aF
aF
at
aF
aF
aF
aF
aF
aF
aF
aF
aF
am
am
am
am
"}
(17,1,1) = {"
ao
ao
ao
ao
ao
ao
aF
aF
aF
aF
aF
aF
aF
aF
aj
aF
aF
at
aF
aF
aF
aF
aF
aF
aF
aF
aF
aF
at
aF
aF
aF
aF
aF
aF
aF
aF
aF
am
am
am
am
"}
(18,1,1) = {"
aF
aF
aF
aF
aF
aF
aF
aF
aF
aF
aF
aF
aF
aF
aj
aF
aF
aq
at
at
at
at
at
at
at
at
at
at
aq
aF
aF
aF
aF
aF
aF
aF
am
am
am
am
am
am
"}
(19,1,1) = {"
aj
aj
aj
aj
aj
aj
aj
aj
aj
aj
aj
aj
aj
aj
aj
aF
aF
aF
aF
aF
aF
aF
aF
aF
aF
aF
aF
aF
aF
aF
aF
aF
aF
aF
aF
am
am
am
am
am
am
am
"}
(20,1,1) = {"
aF
aF
aF
aF
aF
aF
aF
aF
aF
aF
aF
aF
aF
aF
aF
aF
aF
aF
aF
aF
aF
aF
aF
aF
aF
aF
aF
aF
aF
aF
aF
aF
aF
aF
am
am
am
am
am
am
am
am
"}
(21,1,1) = {"
aF
aF
aF
aF
aF
aF
aF
aF
aF
aF
aF
aF
aF
aF
aF
aF
aF
aF
aF
aF
aF
aF
aF
aF
aF
aF
aF
aF
aF
aF
aF
aF
am
am
am
am
am
am
am
ah
am
am
"}
(22,1,1) = {"
aF
ah
ah
ah
ah
ah
aF
aF
aF
aF
aF
aF
aF
aF
aF
aF
aF
aF
aF
aF
aF
aF
ah
ah
ah
ah
ah
aF
aF
aF
am
am
am
aV
am
am
am
am
am
am
aV
am
"}
(23,1,1) = {"
aF
aV
am
am
am
am
aZ
aF
aF
aF
aF
aF
aF
aF
aF
aF
aF
aF
aZ
ah
ah
ah
am
am
aV
am
am
ah
ah
am
am
am
aV
am
am
am
ah
aF
aF
am
am
am
"}
(24,1,1) = {"
aF
ah
am
am
am
am
ah
aF
aF
aF
aF
aF
aF
aF
aF
aF
aF
aF
am
am
am
am
am
am
am
am
am
am
am
am
ah
am
am
ah
am
am
ah
aF
aF
am
am
am
"}
(25,1,1) = {"
aF
aF
aF
ah
am
am
ah
am
am
am
am
aF
aF
aF
aF
aF
aF
ah
am
am
am
am
am
am
am
am
am
am
am
am
am
am
ah
am
am
ah
aF
aF
aF
am
am
am
"}
(26,1,1) = {"
aF
aF
aF
aF
aF
am
ah
am
am
am
am
aF
aF
aF
aF
ah
ah
am
am
am
am
am
am
am
am
am
am
am
am
am
am
am
am
am
ah
aF
aF
aF
aF
am
aV
am
"}
(27,1,1) = {"
ah
ah
ah
ah
ah
am
ah
am
am
am
am
am
am
am
am
am
am
am
am
am
am
am
am
am
am
am
am
am
am
am
am
am
am
am
am
ah
aF
ah
ah
am
am
am
"}
(28,1,1) = {"
am
am
am
am
am
am
aV
ah
ah
ah
ah
ah
ah
ah
am
am
aZ
am
aV
am
am
am
am
am
am
am
am
am
am
am
am
am
am
am
am
am
ah
am
am
am
am
am
"}
(29,1,1) = {"
am
am
am
am
am
am
am
am
am
am
am
am
am
am
am
am
ah
am
am
ah
am
am
am
am
am
am
am
am
am
am
am
am
am
am
am
am
am
am
am
am
am
am
"}
(30,1,1) = {"
am
am
am
am
am
am
am
am
am
am
am
am
am
am
am
am
aZ
am
am
am
am
am
am
am
aV
ah
am
am
am
am
am
am
am
aV
am
am
am
am
am
am
aZ
aF
"}
(31,1,1) = {"
am
am
am
am
am
am
am
am
am
am
am
ah
aF
aF
am
am
ah
aX
aX
aX
aX
aX
aX
aX
aX
aK
aX
aX
aX
am
am
am
am
am
am
am
am
am
am
am
ah
aF
"}
(32,1,1) = {"
ah
am
am
am
am
am
am
aF
aF
aF
aF
aF
aF
aF
aF
am
ah
aX
am
am
am
am
am
am
am
am
am
am
aX
am
am
am
am
am
am
am
am
am
am
ah
am
aF
"}
(33,1,1) = {"
am
am
am
am
am
am
am
aF
aF
aF
aF
aF
aF
aF
aF
am
ah
aX
am
am
aV
am
am
am
am
am
am
am
at
aF
aF
aF
aF
aF
am
am
am
am
ah
am
am
am
"}
(34,1,1) = {"
ah
am
am
ah
am
am
am
aF
aF
aF
aF
aF
aF
aF
ah
am
am
aX
am
am
am
am
am
am
am
am
am
aF
at
aF
aF
aF
aF
aF
am
am
am
am
ah
am
am
am
"}
(35,1,1) = {"
aF
ah
am
am
am
am
am
am
aF
aF
aF
aF
aF
ah
am
am
am
aX
am
am
am
am
aM
am
am
am
am
ah
at
aF
aF
aF
aF
aF
aF
aF
aF
aF
aF
am
am
am
"}
(36,1,1) = {"
aF
aF
aF
am
am
ah
am
am
am
aF
aF
aF
ah
am
am
am
am
aX
am
am
am
am
am
am
am
am
am
ah
at
aF
aF
aF
aF
aF
aF
aF
aF
aF
aF
aF
aV
am
"}
(37,1,1) = {"
aF
aF
aF
am
am
ah
aV
am
am
ah
am
am
am
am
am
am
aZ
at
aF
am
am
am
am
am
am
am
am
ah
at
aF
aF
aF
aF
aF
aF
aF
aF
aF
aF
aF
am
am
"}
(38,1,1) = {"
aF
aF
aF
am
am
am
am
am
am
am
am
am
am
am
am
ah
ah
at
aF
am
aV
am
am
am
am
aV
ah
aF
at
aF
aF
aF
aF
aF
aF
aF
aF
aF
aF
aF
aF
am
"}
(39,1,1) = {"
aF
aF
aF
aF
am
am
am
am
am
am
am
am
am
am
am
aF
aF
at
aF
aF
ah
am
am
am
am
GC
aF
aF
at
aF
aF
aF
aF
aF
aF
aF
aF
aF
aF
aF
aF
aF
"}
(40,1,1) = {"
aF
aF
aF
aF
am
am
am
am
am
am
am
am
am
am
am
aF
aF
at
at
at
aF
aF
aF
aF
aF
aF
aF
at
at
aF
aF
aF
aF
aF
aF
aF
aF
aF
aF
aF
aF
aF
"}
(41,1,1) = {"
aF
aF
aF
am
am
am
am
am
am
am
am
am
am
am
aF
aF
aF
aF
aF
aF
at
at
at
at
at
at
at
aF
aF
aF
aF
aF
aF
aF
aF
aF
aF
aF
aF
aF
aF
aF
"}
(42,1,1) = {"
aF
aF
aF
am
am
am
am
am
am
aF
aF
aF
aF
aF
aF
aF
aF
aF
aF
aF
aF
aF
aF
aF
aF
aF
aF
aF
aF
aF
aF
aF
aF
aF
aF
aF
aF
aF
aF
aF
aF
aF
"}
(43,1,1) = {"
aF
aF
am
am
am
am
am
am
am
aF
aF
aF
aF
aF
aF
aF
aF
aF
aF
aF
aF
aF
aF
aF
aF
aF
aF
aF
aF
aF
aF
aF
aF
aF
aF
aF
aF
aF
aF
aF
aF
aF
"}
(44,1,1) = {"
aF
aF
aR
aR
aR
aR
aR
aR
aF
aF
aF
aF
aF
aF
aF
aF
aF
aF
aF
aF
aF
aF
aF
aF
aF
aF
aF
aF
aF
aF
aF
aF
aF
aF
aF
aF
aF
aF
aF
aF
aF
aF
"}
(45,1,1) = {"
aF
aF
aR
aR
aR
aR
aR
aR
aF
aF
aF
aF
aF
aF
aF
aF
aF
aF
aF
aF
aF
aF
aF
aF
aF
aF
aF
aF
aF
aF
aF
aF
aF
aF
aF
aF
aF
aF
aF
aF
aF
aF
"}
(46,1,1) = {"
aR
aR
aR
aR
aR
aR
aR
aR
aF
aF
aF
aF
aF
aF
aF
aF
aF
aF
aF
aF
aF
aF
aF
aF
aF
aF
aF
aF
aF
aF
aF
aF
aF
aF
aR
aR
aR
aR
aR
aR
aR
aR
"}
(47,1,1) = {"
aR
aR
aG
aR
aR
aR
aG
aF
aF
aF
aF
aF
aF
aF
aF
aF
aF
aF
aF
aF
aF
aF
aF
aF
aF
aF
aF
aF
aF
aF
aF
aF
aF
aF
aR
aR
aR
aR
aR
aR
aR
aR
"}
(48,1,1) = {"
aR
aR
aR
aR
aR
aR
aR
aF
aF
aF
aF
aF
aF
aF
aF
aF
aF
aF
aF
aF
aF
aF
aF
aF
aF
aF
aF
aF
aF
aF
aF
aF
aF
aR
aR
aR
aR
aR
aR
aG
aR
aR
"}
(49,1,1) = {"
aR
aR
aG
aR
aR
aR
aF
aF
aF
aF
aF
aF
aF
aF
aF
aF
aF
aF
aF
aF
aF
aF
aF
aF
aF
aF
aF
aF
aF
aF
aF
aF
aF
aR
aR
aR
aR
aR
aR
aR
aR
aR
"}
(50,1,1) = {"
aR
aR
aR
aR
aR
aR
aF
aF
aF
aF
aF
aF
aF
aF
aF
aF
aF
aF
aF
aF
aR
aR
aR
aR
aR
aR
aR
aR
aR
aR
aR
aR
aR
aR
aR
aR
aR
aR
aR
aR
aR
aR
"}
(51,1,1) = {"
aR
aR
aR
aR
aR
aR
aF
aF
aF
aF
aF
aF
aF
aF
aF
aF
aF
aF
aF
aF
aR
aR
aR
aR
aR
aR
aR
aR
aR
aR
aR
aR
aR
aR
aR
aR
aR
aR
aR
aR
aR
aR
"}
(52,1,1) = {"
aR
aP
aR
aR
aR
aR
aF
aF
aF
aR
aR
aR
aR
aR
aR
aR
aR
aR
aR
aR
aR
aR
aR
aR
aR
aR
aR
aR
aR
aR
aG
aR
aR
aR
aR
aR
aR
aR
aR
aG
aR
aR
"}
(53,1,1) = {"
aR
aR
aR
aR
aR
aR
aF
aF
aF
aR
aR
aR
aR
aR
aR
aR
aR
aR
aR
aR
aR
aR
aR
aP
aR
aR
aR
aR
aR
aR
aR
aR
aR
aR
aP
aR
aR
aR
aR
aR
aR
aR
"}
(54,1,1) = {"
aR
aR
aR
aR
aR
aR
aR
aR
aR
aR
aR
aR
aR
aR
aR
aR
aR
aR
aR
aR
aR
aR
aR
aR
aR
aR
aR
aR
aR
aR
aR
aR
aR
aR
aR
aR
aR
aR
aR
aR
aR
aR
"}
(55,1,1) = {"
aR
aR
aG
aR
aR
aR
aR
aR
aR
aR
aR
aR
aG
aR
aR
aR
aR
aR
aR
aR
aG
aR
aR
aR
aR
aR
aR
aR
aR
aR
aG
aR
aR
aR
aR
aR
aR
aR
aR
aR
aR
aR
"}
(56,1,1) = {"
aR
aR
aR
aR
aR
aR
aR
aR
aR
aR
aR
aP
aR
aR
aR
aR
aR
aR
aR
aR
aR
aR
aR
aR
aR
aR
aR
aR
aR
aR
aR
aR
aR
aR
aF
aF
aF
aF
aF
aF
aF
aF
"}
(57,1,1) = {"
aR
aR
aR
aF
aR
aR
aR
aR
aR
aR
aR
aR
aR
aR
aR
aR
aR
aP
aR
aR
aR
aR
aR
aR
aR
aR
aR
aR
aR
aR
aR
aR
aR
aR
aF
aF
aF
aF
aF
aF
aF
aF
"}
(58,1,1) = {"
aR
aR
aR
aF
aF
aF
aF
aF
aF
aR
aR
aR
aR
aR
aR
aR
aR
aR
aR
aR
aR
aR
aR
aR
aR
aR
aF
aF
aF
aF
aF
aF
aF
aF
aF
aF
aF
aF
aF
aF
aF
aF
"}
(59,1,1) = {"
aR
aR
aF
aF
aF
aF
aF
aF
aF
aR
aR
aR
aR
aR
aR
aR
aR
aR
aR
aR
aR
aR
aR
aR
aR
aR
aF
aF
aF
aF
aF
aF
aF
aF
aF
aF
aF
aF
aF
aF
aF
aF
"}
(60,1,1) = {"
aF
aF
aF
aF
aF
aF
aF
aF
aF
aF
aF
aF
aF
aR
aR
aR
aR
aR
aF
aF
aF
aF
aF
aF
aF
aF
aF
aF
aF
aF
aF
aF
aF
aF
aF
aF
aF
aF
aF
aF
aF
aF
"}
(61,1,1) = {"
aF
aF
aF
aF
aF
aF
aF
aF
aF
aF
aF
aF
aF
aF
aF
aF
aF
aF
aF
aF
aF
aF
aF
aF
aF
aF
aF
aF
aF
aF
aF
aF
aF
aF
aF
aF
aF
aF
aF
aF
aF
aF
"}
(62,1,1) = {"
at
at
aF
aF
aF
aF
aF
aF
aF
aF
aF
aF
aF
aF
aF
aF
aF
aF
aF
aF
aF
aF
aF
aF
aF
aF
aF
aF
aF
aF
aF
aF
aF
aF
aF
aF
aF
aF
aF
aF
aF
aF
"}
(63,1,1) = {"
aF
at
at
aF
aF
aF
aF
aF
aF
aF
aF
aF
aF
aF
aF
aF
aF
aF
aF
aF
aF
aF
aF
aF
aF
aF
aF
aF
aF
aF
aF
aF
aF
aF
aF
aF
aF
aF
aF
aF
aF
aF
"}
(64,1,1) = {"
aF
aF
at
aF
aF
aF
aF
aF
aF
aF
aF
aF
aF
aF
aF
aF
aF
aF
aF
aF
aF
aF
aF
aF
aF
aF
aF
aF
aF
aF
aF
aF
aF
aF
aF
aF
aF
aF
aF
aF
aF
aF
"}
(65,1,1) = {"
aF
aF
at
aF
aF
aF
aF
aF
aF
aF
aF
aF
aF
aF
aF
aF
aF
aF
aF
aF
aF
aF
aF
aF
aF
aF
aF
aF
aF
aF
aF
aF
aF
aF
aF
aF
aF
aF
aF
aF
aF
aF
"}
(66,1,1) = {"
aR
aF
ae
ae
ae
ae
ae
ae
ae
ae
ae
ae
ae
ae
ae
ae
ae
ae
ae
ae
ae
ae
ae
ae
ae
ae
ae
ae
ae
ae
ae
ae
ae
ae
ae
ae
ae
ae
ae
ae
ae
ae
"}
