//MAP CONVERTED BY dmm2tgm.py THIS HEADER COMMENT PREVENTS RECONVERSION, DO NOT REMOVE
"ab" = (
/obj/machinery/light{
	dir = 8
	},
/turf/open/floor/plating/ground/mars/random/sand,
/area/bigredv2/outside/nanotrasen_lab/inside)
"bp" = (
/obj/machinery/atmospherics/components/unary/vent_pump{
	dir = 4;
	on = 1
	},
/turf/open/floor/tile/dark,
/area/bigredv2/outside/nanotrasen_lab/inside)
"bJ" = (
/turf/open/floor/tile/dark/red2{
	dir = 10
	},
/area/bigredv2/outside/nanotrasen_lab/inside)
"bZ" = (
/obj/machinery/light{
	dir = 4
	},
/turf/open/ground/jungle/clear,
/area/bigredv2/outside/nanotrasen_lab/inside)
"co" = (
/obj/effect/ai_node,
/turf/open/floor/plating/ground/mars/random/sand,
/area/bigredv2/outside/nanotrasen_lab/inside)
"dp" = (
/turf/open/floor/plating,
/area/bigredv2/outside/nanotrasen_lab/inside)
"dL" = (
/obj/machinery/door/airlock/mainship/research/glass/free_access{
	name = "\improper Eta Lab Cell"
	},
/turf/open/floor/tile/dark,
/area/bigredv2/outside/nanotrasen_lab/inside)
"dO" = (
/turf/closed/mineral/smooth/bigred,
/area/bigredv2/caves/rock)
"er" = (
/obj/effect/landmark/lv624/fog_blocker/xeno_spawn,
/turf/closed/mineral/smooth/bigred,
/area/bigredv2/caves/rock)
"ex" = (
/obj/structure/closet/crate/secure,
/turf/open/floor/tile/dark/red2/corner,
/area/bigredv2/outside/nanotrasen_lab/inside)
"eA" = (
/obj/item/target,
/turf/open/floor/tile/dark/red2{
	dir = 1
	},
/area/bigredv2/outside/nanotrasen_lab/inside)
"fG" = (
/obj/effect/decal/cleanable/dirt,
/turf/open/floor/tile/dark,
/area/bigredv2/outside/nanotrasen_lab/inside)
"fP" = (
/obj/effect/ai_node,
/turf/open/floor/plating/ground/mars/random/cave/rock,
/area/bigredv2/caves/south)
"ge" = (
/turf/open/floor/tile/dark,
/area/bigredv2/outside/nanotrasen_lab/inside)
"gN" = (
/obj/structure/table,
/obj/effect/spawner/random/engineering/technology_scanner,
/turf/open/floor/tile/dark/red2/corner{
	dir = 8
	},
/area/bigredv2/outside/nanotrasen_lab/inside)
"hm" = (
/obj/machinery/light,
/turf/open/floor/tile/darkgreen/darkgreen2,
/area/bigredv2/outside/nanotrasen_lab/inside)
"is" = (
/obj/structure/closet/l3closet/scientist,
/turf/open/floor/tile/darkgreen/darkgreen2{
	dir = 5
	},
/area/bigredv2/outside/nanotrasen_lab/inside)
"iO" = (
/obj/effect/landmark/lv624/fog_blocker/xeno_spawn,
/turf/open/floor/plating/ground/mars/random/cave/rock,
/area/bigredv2/caves/south)
"ja" = (
/obj/effect/landmark/xeno_silo_spawn,
/turf/open/floor/plating/ground/mars/random/cave,
/area/bigredv2/caves/south)
"jg" = (
/obj/structure/window/framed/colony/reinforced,
/turf/open/floor/plating,
/area/bigredv2/outside/nanotrasen_lab/inside)
"jH" = (
/obj/effect/ai_node,
/turf/open/floor/tile/dark,
/area/bigredv2/outside/nanotrasen_lab/inside)
"kP" = (
/obj/structure/xenoautopsy/tank/broken,
/turf/open/floor/tile/dark/red2/corner{
	dir = 8
	},
/area/bigredv2/outside/nanotrasen_lab/inside)
"kT" = (
/obj/effect/landmark/lv624/fog_blocker,
/turf/closed/wall/r_wall,
/turf/open/floor/plating/ground/mars/cavetodirt{
	dir = 1
	},
/area/bigredv2/outside/nanotrasen_lab/inside)
"lp" = (
/obj/structure/bed/chair{
	dir = 4
	},
/turf/open/floor/tile/dark/red2{
	dir = 4
	},
/area/bigredv2/outside/nanotrasen_lab/inside)
"lP" = (
/obj/effect/decal/cleanable/dirt,
/turf/open/floor/tile/dark/red2/corner,
/area/bigredv2/outside/nanotrasen_lab/inside)
"mB" = (
/obj/structure/table,
/obj/machinery/light,
/obj/effect/spawner/random/engineering/technology_scanner,
/obj/item/xenos_claw,
/turf/open/floor/tile/dark/red2/corner{
	dir = 8
	},
/area/bigredv2/outside/nanotrasen_lab/inside)
"nV" = (
/obj/effect/landmark/lv624/fog_blocker,
/turf/closed/wall/r_wall,
/turf/open/floor/plating/ground/mars/random/cave,
/area/bigredv2/outside/nanotrasen_lab/inside)
"oJ" = (
/turf/open/floor/tile/dark/red2,
/area/bigredv2/outside/nanotrasen_lab/inside)
"oK" = (
/obj/machinery/light{
	dir = 1
	},
/turf/open/floor/tile/dark/red2{
	dir = 5
	},
/area/bigredv2/outside/nanotrasen_lab/inside)
"pu" = (
/obj/effect/landmark/excavation_site_spawner,
/turf/open/floor/plating/ground/mars/random/cave,
/area/bigredv2/caves/south)
"pP" = (
/obj/structure/table,
/obj/effect/spawner/random/engineering/technology_scanner,
/turf/open/floor/tile/dark/red2/corner{
	dir = 4
	},
/area/bigredv2/outside/nanotrasen_lab/inside)
"pU" = (
/obj/machinery/computer/security,
/turf/open/floor/tile/dark/red2/corner{
	dir = 4
	},
/area/bigredv2/outside/nanotrasen_lab/inside)
"qb" = (
/obj/structure/xenoautopsy/tank,
/turf/open/floor/tile/dark/red2/corner{
	dir = 8
	},
/area/bigredv2/outside/nanotrasen_lab/inside)
"su" = (
/turf/open/floor/plating/ground/mars/random/cave,
/area/bigredv2/caves/south)
"sC" = (
/obj/machinery/light{
	dir = 8
	},
/turf/open/floor/tile/dark/red2/corner{
	dir = 8
	},
/area/bigredv2/outside/nanotrasen_lab/inside)
"ti" = (
/obj/machinery/miner/damaged/platinum,
/turf/open/floor/plating/ground/mars/random/cave/rock,
/area/bigredv2/caves/south)
"tZ" = (
/obj/machinery/atmospherics/pipe/simple/green/hidden{
	dir = 4
	},
/turf/open/floor/tile/dark,
/area/bigredv2/outside/nanotrasen_lab/inside)
"ur" = (
/obj/structure/bed/chair{
	dir = 8
	},
/turf/open/floor/tile/dark/red2{
	dir = 8
	},
/area/bigredv2/outside/nanotrasen_lab/inside)
"wn" = (
/obj/structure/table,
/obj/structure/xenoautopsy,
/turf/open/floor/tile/dark/red2/corner{
	dir = 4
	},
/area/bigredv2/outside/nanotrasen_lab/inside)
"wH" = (
/obj/structure/table,
/obj/item/paper,
/turf/open/floor/tile/dark/red2/corner,
/area/bigredv2/outside/nanotrasen_lab/inside)
"wT" = (
/turf/open/floor/tile/dark/red2{
	dir = 4
	},
/area/bigredv2/outside/nanotrasen_lab/inside)
"zk" = (
/obj/structure/table,
/obj/item/alienjar,
/turf/open/floor/tile/dark/red2/corner{
	dir = 4
	},
/area/bigredv2/outside/nanotrasen_lab/inside)
"zV" = (
/turf/open/floor/tile/darkgreen/darkgreen2{
	dir = 4
	},
/area/bigredv2/outside/nanotrasen_lab/inside)
"Ap" = (
/obj/structure/closet/l3closet/scientist,
/turf/open/floor/tile/darkgreen/darkgreen2{
	dir = 9
	},
/area/bigredv2/outside/nanotrasen_lab/inside)
"Bf" = (
/obj/machinery/light{
	dir = 1
	},
/turf/open/floor/tile/dark/red2{
	dir = 9
	},
/area/bigredv2/outside/nanotrasen_lab/inside)
"Bq" = (
/obj/structure/window/framed/colony,
/turf/open/floor/plating,
/area/bigredv2/outside/nanotrasen_lab/inside)
"Ca" = (
/obj/effect/spawner/random/engineering/structure/tank/fuelweighted,
/turf/open/floor/plating,
/area/bigredv2/outside/nanotrasen_lab/inside)
"Ce" = (
/obj/effect/decal/cleanable/blood,
/turf/open/floor/tile/dark,
/area/bigredv2/outside/nanotrasen_lab/inside)
"Ch" = (
/obj/machinery/atmospherics/components/unary/vent_pump{
	dir = 1;
	on = 1
	},
/turf/open/floor/tile/dark,
/area/bigredv2/outside/nanotrasen_lab/inside)
"CY" = (
/obj/effect/decal/cleanable/blood/gibs,
/turf/open/floor/plating/ground/mars/random/cave,
/area/bigredv2/caves/south)
"Dj" = (
/obj/structure/bed/chair{
	dir = 4
	},
/obj/effect/landmark/excavation_site_spawner,
/turf/open/floor/tile/dark/red2{
	dir = 4
	},
/area/bigredv2/outside/nanotrasen_lab/inside)
"DG" = (
/obj/structure/cable,
/obj/machinery/power/apc/high/ntf{
	dir = 1
	},
/turf/open/floor/plating,
/area/bigredv2/outside/nanotrasen_lab/inside)
"Eq" = (
/obj/machinery/atmospherics/pipe/simple/green/hidden{
	dir = 4
	},
/obj/machinery/door/airlock/mainship/research/glass/free_access{
	name = "\improper Eta Lab Xenobiology Lab"
	},
/turf/open/floor/tile/dark,
/area/bigredv2/outside/nanotrasen_lab/inside)
"Fb" = (
/obj/effect/landmark/excavation_site_spawner,
/turf/open/floor/plating/ground/mars/random/cave/rock,
/area/bigredv2/caves/south)
"FS" = (
/turf/open/floor/tile/dark/red2{
	dir = 1
	},
/area/bigredv2/outside/nanotrasen_lab/inside)
"HS" = (
/obj/effect/landmark/lv624/fog_blocker,
/turf/closed/wall/r_wall,
/area/bigredv2/outside/nanotrasen_lab/inside)
"HT" = (
/obj/structure/closet/l3closet/scientist,
/turf/open/floor/tile/darkgreen/darkgreen2{
	dir = 1
	},
/area/bigredv2/outside/nanotrasen_lab/inside)
"Ik" = (
/obj/structure/closet/toolcloset,
/turf/open/floor/plating,
/area/bigredv2/outside/nanotrasen_lab/inside)
"IX" = (
/obj/structure/fence/standard/xenoproof,
/turf/open/floor/plating/ground/mars/random/cave,
/area/bigredv2/caves/south)
"Jd" = (
/turf/closed/mineral/smooth/bigred/indestructible,
/area/space)
"JI" = (
/turf/open/floor/tile/dark/red2{
	dir = 8
	},
/area/bigredv2/outside/nanotrasen_lab/inside)
"Lb" = (
/turf/open/floor/tile/darkgreen/darkgreen2{
	dir = 6
	},
/area/bigredv2/outside/nanotrasen_lab/inside)
"Lu" = (
/obj/effect/ai_node,
/turf/open/floor/plating/ground/mars/random/cave,
/area/bigredv2/caves/south)
"LC" = (
/obj/structure/table,
/obj/item/tool/pen,
/turf/open/floor/tile/dark/red2/corner{
	dir = 4
	},
/area/bigredv2/outside/nanotrasen_lab/inside)
"Mk" = (
/turf/open/floor/tile/dark/red2/corner,
/area/bigredv2/outside/nanotrasen_lab/inside)
"MG" = (
/obj/effect/decal/cleanable/blood/oil,
/turf/open/floor/tile/dark,
/area/bigredv2/outside/nanotrasen_lab/inside)
"Nn" = (
/obj/effect/decal/cleanable/dirt,
/obj/effect/ai_node,
/turf/open/floor/tile/dark,
/area/bigredv2/outside/nanotrasen_lab/inside)
"NP" = (
/obj/structure/xenoautopsy/tank/hugger,
/turf/open/floor/tile/dark/red2/corner{
	dir = 8
	},
/area/bigredv2/outside/nanotrasen_lab/inside)
"OT" = (
/obj/structure/cable,
/obj/machinery/door/airlock/mainship/maint/free_access{
	name = "\improper Eta Lab Maintenance Storage"
	},
/turf/open/floor/tile/dark,
/area/bigredv2/outside/nanotrasen_lab/inside)
"PT" = (
/turf/closed/wall/r_wall,
/area/bigredv2/outside/nanotrasen_lab/inside)
"PW" = (
/obj/structure/cable,
/turf/open/floor/plating,
/area/bigredv2/outside/nanotrasen_lab/inside)
"Qf" = (
/obj/structure/fence/standard/xenoproof,
/turf/open/floor/plating/ground/mars/random/cave/rock,
/area/bigredv2/caves/south)
"Qt" = (
/turf/closed/wall,
/area/bigredv2/outside/nanotrasen_lab/inside)
"Qu" = (
/obj/machinery/light{
	dir = 4
	},
/obj/effect/decal/cleanable/dirt,
/obj/effect/ai_node,
/turf/open/floor/tile/dark/red2/corner,
/area/bigredv2/outside/nanotrasen_lab/inside)
"QI" = (
/obj/effect/landmark/lv624/fog_blocker,
/turf/closed/mineral/smooth/bigred,
/area/bigredv2/caves/rock)
"QQ" = (
/turf/open/floor/tile/darkgreen/darkgreen2{
	dir = 10
	},
/area/bigredv2/outside/nanotrasen_lab/inside)
"Rv" = (
/turf/open/floor/tile/dark/red2{
	dir = 6
	},
/area/bigredv2/outside/nanotrasen_lab/inside)
"RG" = (
/obj/structure/cable,
/obj/effect/ai_node,
/turf/open/floor/plating,
/area/bigredv2/outside/nanotrasen_lab/inside)
"RO" = (
/turf/open/floor/plating/ground/mars/random/cave/rock,
/area/bigredv2/caves/south)
"Ta" = (
/obj/structure/closet/firecloset,
/turf/open/floor/plating,
/area/bigredv2/outside/nanotrasen_lab/inside)
"UR" = (
/obj/machinery/door/airlock/mainship/research/glass/free_access{
	dir = 1;
	name = "\improper Eta Lab Cell"
	},
/turf/open/floor/tile/dark,
/area/bigredv2/outside/nanotrasen_lab/inside)
"Vd" = (
/turf/open/floor/tile/dark/red2/corner{
	dir = 8
	},
/area/bigredv2/outside/nanotrasen_lab/inside)
"VM" = (
/turf/open/floor/tile/darkgreen/darkgreen2{
	dir = 8
	},
/area/bigredv2/outside/nanotrasen_lab/inside)
"Wg" = (
/obj/machinery/atmospherics/pipe/simple/green/hidden{
	dir = 4
	},
/obj/effect/ai_node,
/turf/open/floor/tile/dark,
/area/bigredv2/outside/nanotrasen_lab/inside)
"Wh" = (
/obj/effect/decal/cleanable/blood/xeno,
/turf/open/floor/tile/dark/red2/corner{
	dir = 4
	},
/area/bigredv2/outside/nanotrasen_lab/inside)
"XM" = (
/turf/open/ground/jungle/clear,
/area/bigredv2/outside/nanotrasen_lab/inside)
"YD" = (
/obj/effect/landmark/lv624/fog_blocker/xeno_spawn,
/turf/open/floor/plating/ground/mars/random/cave,
/area/bigredv2/caves/south)
"Zx" = (
/turf/open/floor/plating/ground/mars/random/sand,
/area/bigredv2/outside/nanotrasen_lab/inside)
"ZB" = (
/obj/machinery/atmospherics/pipe/manifold/green/hidden{
	dir = 1
	},
/obj/effect/ai_node,
/turf/open/floor/tile/dark,
/area/bigredv2/outside/nanotrasen_lab/inside)

(1,1,1) = {"
Jd
Jd
Jd
Jd
Jd
Jd
Jd
Jd
Jd
Jd
Jd
Jd
Jd
Jd
Jd
Jd
Jd
Jd
Jd
Jd
Jd
Jd
Jd
Jd
Jd
Jd
Jd
Jd
Jd
Jd
Jd
Jd
Jd
Jd
Jd
Jd
Jd
Jd
"}
(2,1,1) = {"
Jd
Jd
Jd
Jd
Jd
Jd
Jd
Jd
Jd
Jd
Jd
Jd
Jd
Jd
Jd
Jd
Jd
Jd
Jd
Jd
Jd
Jd
Jd
Jd
Jd
Jd
Jd
Jd
Jd
Jd
Jd
Jd
Jd
Jd
Jd
Jd
Jd
Jd
"}
(3,1,1) = {"
Jd
Jd
Jd
Jd
Jd
Jd
Jd
Jd
Jd
Jd
Jd
Jd
Jd
Jd
Jd
Jd
Jd
Jd
Jd
Jd
Jd
Jd
Jd
Jd
Jd
Jd
Jd
Jd
Jd
Jd
Jd
Jd
Jd
Jd
Jd
Jd
Jd
Jd
"}
(4,1,1) = {"
Jd
Jd
Jd
Jd
Jd
Jd
Jd
Jd
Jd
Jd
Jd
Jd
Jd
Jd
Jd
Jd
Jd
Jd
Jd
Jd
Jd
Jd
Jd
Jd
Jd
Jd
Jd
Jd
Jd
Jd
Jd
Jd
Jd
Jd
Jd
Jd
Jd
Jd
"}
(5,1,1) = {"
Jd
Jd
Jd
Jd
Jd
Jd
Jd
Jd
Jd
Jd
Jd
Jd
Jd
Jd
Jd
Jd
Jd
Jd
Jd
Jd
Jd
Jd
Jd
Jd
Jd
Jd
Jd
Jd
Jd
Jd
Jd
Jd
Jd
Jd
Jd
Jd
Jd
Jd
"}
(6,1,1) = {"
Jd
Jd
Jd
Jd
Jd
Jd
Jd
Jd
Jd
Jd
Jd
Jd
Jd
Jd
Jd
Jd
Jd
Jd
Jd
Jd
Jd
Jd
Jd
Jd
Jd
Jd
Jd
Jd
Jd
Jd
Jd
Jd
Jd
Jd
Jd
Jd
Jd
Jd
"}
(7,1,1) = {"
Jd
Jd
Jd
Jd
Jd
Jd
Jd
Jd
Jd
Jd
Jd
Jd
Jd
Jd
Jd
Jd
Jd
Jd
Jd
Jd
Jd
Jd
Jd
Jd
Jd
Jd
Jd
Jd
Jd
Jd
Jd
Jd
Jd
Jd
Jd
Jd
Jd
Jd
"}
(8,1,1) = {"
Jd
Jd
Jd
Jd
Jd
Jd
Jd
Jd
Jd
Jd
Jd
Jd
Jd
Jd
Jd
Jd
Jd
Jd
Jd
Jd
Jd
Jd
Jd
Jd
Jd
Jd
Jd
Jd
Jd
Jd
Jd
Jd
Jd
Jd
Jd
Jd
Jd
Jd
"}
(9,1,1) = {"
Jd
Jd
Jd
Jd
Jd
Jd
Jd
Jd
Jd
Jd
Jd
Jd
Jd
Jd
Jd
Jd
Jd
Jd
Jd
Jd
Jd
Jd
Jd
Jd
Jd
Jd
Jd
Jd
Jd
Jd
Jd
Jd
Jd
Jd
Jd
Jd
Jd
Jd
"}
(10,1,1) = {"
Jd
Jd
Jd
Jd
Jd
Jd
Jd
Jd
Jd
Jd
Jd
Jd
Jd
Jd
Jd
Jd
Jd
Jd
Jd
Jd
Jd
Jd
Jd
Jd
Jd
Jd
Jd
Jd
Jd
Jd
Jd
Jd
Jd
Jd
Jd
Jd
Jd
Jd
"}
(11,1,1) = {"
Jd
Jd
Jd
Jd
Jd
Jd
Jd
Jd
Jd
Jd
Jd
Jd
Jd
Jd
Jd
Jd
Jd
Jd
Jd
Jd
Jd
Jd
Jd
Jd
Jd
Jd
Jd
Jd
Jd
Jd
Jd
Jd
Jd
Jd
Jd
Jd
Jd
Jd
"}
(12,1,1) = {"
Jd
Jd
Jd
Jd
Jd
Jd
Jd
Jd
Jd
Jd
Jd
Jd
Jd
Jd
Jd
Jd
Jd
Jd
Jd
Jd
Jd
Jd
Jd
Jd
Jd
Jd
Jd
Jd
Jd
Jd
Jd
Jd
Jd
Jd
Jd
Jd
Jd
Jd
"}
(13,1,1) = {"
Jd
Jd
Jd
Jd
Jd
Jd
Jd
Jd
Jd
Jd
Jd
Jd
Jd
Jd
Jd
Jd
Jd
Jd
Jd
Jd
Jd
Jd
Jd
Jd
Jd
Jd
Jd
Jd
Jd
Jd
Jd
Jd
Jd
Jd
Jd
Jd
Jd
Jd
"}
(14,1,1) = {"
Jd
Jd
Jd
Jd
Jd
Jd
Jd
Jd
Jd
Jd
Jd
Jd
Jd
Jd
Jd
Jd
Jd
Jd
Jd
Jd
Jd
Jd
Jd
Jd
Jd
Jd
Jd
Jd
Jd
Jd
Jd
Jd
Jd
Jd
Jd
Jd
Jd
Jd
"}
(15,1,1) = {"
Jd
Jd
Jd
Jd
Jd
Jd
Jd
Jd
Jd
Jd
Jd
Jd
Jd
Jd
Jd
Jd
Jd
Jd
Jd
Jd
Jd
Jd
Jd
Jd
Jd
Jd
Jd
Jd
Jd
Jd
Jd
Jd
Jd
Jd
Jd
Jd
Jd
Jd
"}
(16,1,1) = {"
Jd
Jd
Jd
Jd
Jd
Jd
Jd
Jd
Jd
Jd
Jd
Jd
Jd
Jd
Jd
Jd
Jd
Jd
Jd
Jd
Jd
Jd
Jd
Jd
Jd
Jd
Jd
Jd
Jd
Jd
Jd
Jd
Jd
Jd
Jd
Jd
Jd
Jd
"}
(17,1,1) = {"
Jd
Jd
Jd
Jd
Jd
Jd
Jd
Jd
Jd
Jd
Jd
Jd
Jd
Jd
Jd
Jd
Jd
Jd
Jd
Jd
Jd
Jd
Jd
Jd
Jd
Jd
Jd
Jd
Jd
Jd
Jd
Jd
Jd
Jd
Jd
Jd
Jd
Jd
"}
(18,1,1) = {"
Jd
Jd
Jd
Jd
Jd
Jd
Jd
Jd
Jd
Jd
Jd
Jd
Jd
Jd
Jd
Jd
Jd
Jd
Jd
Jd
Jd
Jd
Jd
Jd
Jd
Jd
Jd
Jd
Jd
Jd
Jd
Jd
Jd
Jd
Jd
Jd
Jd
Jd
"}
(19,1,1) = {"
dO
dO
dO
dO
dO
dO
dO
dO
dO
dO
dO
dO
dO
dO
dO
dO
dO
dO
dO
er
er
er
er
er
er
er
er
er
er
er
dO
dO
Jd
Jd
Jd
Jd
Jd
Jd
"}
(20,1,1) = {"
dO
dO
dO
dO
dO
dO
dO
dO
dO
dO
dO
dO
dO
dO
dO
dO
dO
dO
dO
er
dO
dO
dO
dO
dO
dO
dO
dO
dO
er
dO
dO
Jd
Jd
Jd
Jd
Jd
Jd
"}
(21,1,1) = {"
dO
dO
dO
dO
dO
dO
dO
dO
dO
dO
dO
dO
dO
dO
dO
dO
dO
dO
dO
er
dO
dO
dO
su
Lu
su
dO
dO
dO
er
dO
dO
Jd
Jd
Jd
Jd
Jd
Jd
"}
(22,1,1) = {"
dO
dO
dO
dO
dO
dO
dO
dO
dO
dO
dO
dO
dO
dO
su
su
Lu
su
dO
er
dO
dO
su
RO
su
su
su
dO
dO
er
dO
dO
Jd
Jd
Jd
Jd
Jd
Jd
"}
(23,1,1) = {"
dO
dO
dO
dO
dO
dO
dO
dO
dO
dO
dO
dO
dO
dO
su
RO
su
su
su
er
dO
su
su
su
su
su
ja
su
dO
er
dO
dO
Jd
Jd
Jd
Jd
Jd
Jd
"}
(24,1,1) = {"
dO
dO
dO
dO
dO
dO
dO
dO
dO
dO
dO
dO
su
RO
su
su
su
su
su
YD
su
su
su
su
su
su
su
su
dO
er
dO
dO
Jd
Jd
Jd
Jd
Jd
Jd
"}
(25,1,1) = {"
dO
dO
dO
dO
dO
dO
dO
dO
dO
dO
dO
pu
Lu
su
su
su
Lu
RO
su
YD
Lu
su
su
su
Lu
su
su
Lu
dO
er
dO
dO
Jd
Jd
Jd
Jd
Jd
Jd
"}
(26,1,1) = {"
dO
dO
dO
dO
dO
dO
dO
dO
dO
su
su
su
su
su
su
su
su
su
su
YD
su
su
su
RO
su
su
su
RO
dO
er
dO
dO
Jd
Jd
Jd
Jd
Jd
Jd
"}
(27,1,1) = {"
dO
dO
dO
dO
dO
dO
dO
dO
dO
su
su
su
su
su
su
dO
dO
su
su
YD
su
su
su
su
su
su
su
su
dO
er
dO
dO
Jd
Jd
Jd
Jd
Jd
Jd
"}
(28,1,1) = {"
dO
dO
dO
dO
dO
dO
dO
dO
dO
su
su
RO
su
su
dO
dO
dO
dO
su
YD
su
su
su
su
Lu
su
su
dO
dO
er
dO
dO
Jd
Jd
Jd
Jd
Jd
Jd
"}
(29,1,1) = {"
dO
dO
dO
dO
dO
dO
dO
dO
su
Lu
su
su
Lu
dO
dO
dO
dO
dO
dO
YD
Lu
su
su
su
su
Lu
su
dO
dO
er
dO
dO
Jd
Jd
Jd
Jd
Jd
Jd
"}
(30,1,1) = {"
dO
dO
dO
dO
dO
dO
dO
su
su
su
su
su
dO
dO
dO
dO
dO
dO
dO
er
YD
YD
YD
iO
YD
YD
YD
YD
er
er
dO
dO
dO
dO
dO
dO
dO
Jd
"}
(31,1,1) = {"
dO
dO
dO
dO
dO
dO
dO
RO
su
su
su
su
dO
dO
dO
dO
dO
dO
dO
dO
su
su
su
RO
su
su
su
su
dO
dO
dO
dO
dO
dO
dO
dO
dO
Jd
"}
(32,1,1) = {"
dO
dO
dO
dO
dO
dO
su
su
su
su
su
su
dO
dO
dO
dO
dO
dO
dO
dO
dO
dO
su
su
su
su
su
RO
su
dO
dO
dO
dO
dO
dO
dO
dO
Jd
"}
(33,1,1) = {"
dO
dO
dO
dO
dO
dO
su
su
su
su
su
su
dO
dO
dO
dO
dO
dO
dO
dO
dO
dO
dO
su
su
Lu
su
su
su
Lu
dO
dO
dO
dO
dO
dO
dO
Jd
"}
(34,1,1) = {"
dO
dO
dO
dO
dO
dO
su
RO
su
su
su
RO
RO
dO
dO
dO
dO
dO
dO
dO
dO
dO
dO
dO
su
su
su
su
su
su
dO
dO
dO
dO
dO
dO
dO
Jd
"}
(35,1,1) = {"
dO
dO
dO
dO
dO
dO
fP
su
su
Lu
su
su
fP
dO
dO
dO
dO
dO
dO
dO
dO
dO
dO
dO
dO
su
RO
su
pu
su
dO
dO
dO
dO
dO
dO
dO
Jd
"}
(36,1,1) = {"
dO
dO
dO
dO
dO
dO
su
su
su
su
su
su
su
dO
dO
dO
dO
dO
dO
dO
dO
dO
dO
dO
dO
su
RO
su
su
su
dO
dO
dO
dO
dO
dO
dO
Jd
"}
(37,1,1) = {"
dO
dO
dO
dO
su
su
su
pu
su
su
su
su
su
dO
dO
dO
dO
dO
dO
dO
dO
dO
dO
dO
dO
su
su
su
su
su
dO
dO
dO
dO
dO
dO
dO
Jd
"}
(38,1,1) = {"
dO
dO
dO
su
su
su
su
su
su
su
su
su
su
su
su
dO
dO
dO
dO
dO
dO
dO
dO
dO
dO
RO
su
RO
su
su
dO
dO
dO
dO
dO
dO
dO
Jd
"}
(39,1,1) = {"
su
su
su
su
su
su
su
su
su
su
su
su
su
su
su
su
su
su
su
su
su
dO
dO
dO
dO
su
su
RO
su
su
dO
dO
dO
dO
dO
dO
dO
Jd
"}
(40,1,1) = {"
su
RO
su
su
RO
Fb
su
su
su
su
su
su
su
su
su
su
su
su
su
su
su
su
dO
dO
su
Lu
su
su
su
Lu
dO
dO
dO
dO
dO
dO
dO
Jd
"}
(41,1,1) = {"
su
Lu
su
su
su
su
su
su
su
Lu
su
RO
RO
RO
RO
RO
RO
su
RO
fP
RO
su
su
su
Lu
su
su
su
su
dO
dO
dO
dO
dO
dO
dO
dO
Jd
"}
(42,1,1) = {"
su
su
su
su
su
su
su
su
su
su
su
su
su
su
su
su
su
su
su
su
su
su
RO
su
su
su
su
su
dO
dO
dO
dO
dO
dO
dO
dO
dO
Jd
"}
(43,1,1) = {"
su
dO
dO
dO
dO
dO
dO
RO
su
su
su
su
su
su
su
su
su
su
su
su
su
su
su
su
su
su
su
su
dO
dO
dO
dO
dO
dO
dO
dO
dO
Jd
"}
(44,1,1) = {"
dO
dO
dO
dO
dO
dO
dO
dO
dO
dO
dO
dO
dO
dO
dO
dO
dO
su
dO
dO
RO
RO
dO
RO
su
su
su
su
dO
dO
dO
dO
dO
dO
dO
dO
dO
Jd
"}
(45,1,1) = {"
dO
dO
dO
dO
dO
dO
dO
dO
dO
dO
dO
dO
dO
dO
dO
dO
dO
dO
dO
dO
dO
dO
dO
dO
su
su
su
su
su
dO
dO
dO
dO
dO
dO
dO
dO
Jd
"}
(46,1,1) = {"
QI
QI
QI
QI
QI
QI
QI
QI
QI
QI
QI
QI
QI
QI
QI
QI
QI
QI
QI
QI
QI
QI
dO
dO
RO
su
su
su
su
su
dO
dO
dO
dO
dO
dO
dO
Jd
"}
(47,1,1) = {"
PT
PT
PT
PT
PT
PT
PT
PT
PT
PT
PT
PT
PT
PT
PT
PT
PT
PT
PT
PT
PT
PT
HS
dO
su
su
su
su
su
su
su
dO
dO
dO
dO
dO
dO
Jd
"}
(48,1,1) = {"
Bf
JI
JI
bJ
PT
qb
kP
NP
NP
NP
PT
Zx
ab
Zx
PT
Zx
ab
Zx
PT
Zx
ab
Zx
HS
dO
IX
Lu
su
pu
su
su
Lu
dO
dO
dO
dO
dO
dO
Jd
"}
(49,1,1) = {"
FS
jH
ge
ge
UR
ge
ge
jH
ge
Vd
PT
Zx
co
Zx
PT
Zx
co
Zx
PT
Zx
Zx
Zx
kT
RO
Qf
su
su
su
su
su
su
dO
dO
dO
dO
dO
dO
Jd
"}
(50,1,1) = {"
FS
ge
ge
oJ
PT
Wh
fG
fG
ge
gN
PT
Zx
Zx
Zx
PT
Zx
Zx
Zx
PT
Zx
Zx
Zx
HS
su
IX
su
su
su
su
su
su
dO
dO
dO
dO
dO
dO
Jd
"}
(51,1,1) = {"
eA
ge
ge
oJ
jg
pU
fG
fG
ge
mB
PT
jg
dL
jg
PT
jg
dL
jg
PT
jg
dL
jg
HS
su
IX
su
su
RO
su
su
su
su
dO
dO
dO
dO
dO
Jd
"}
(52,1,1) = {"
FS
ge
ge
oJ
jg
pP
fG
fG
ge
Vd
Qt
ur
ge
ur
Qt
ur
ge
ur
Qt
ur
ge
ur
HS
su
IX
su
su
ti
su
su
su
su
su
dO
dO
dO
dO
Jd
"}
(53,1,1) = {"
eA
ge
ge
oJ
jg
zk
ge
fG
fG
ge
Vd
Vd
ge
Vd
sC
Vd
ge
Vd
Vd
Vd
fG
Vd
HS
su
IX
su
su
RO
su
su
su
su
su
dO
dO
dO
dO
Jd
"}
(54,1,1) = {"
FS
jH
ge
oJ
jg
wn
ge
bp
fG
fG
Ce
fG
fG
fG
ge
fG
fG
fG
ge
fG
ge
ge
HS
su
IX
su
su
RO
su
su
su
su
su
dO
dO
dO
dO
Jd
"}
(55,1,1) = {"
FS
ge
ge
oJ
jg
LC
MG
Wg
fG
fG
Qu
lP
Nn
lP
lP
lP
Nn
lP
Qu
Mk
ge
Mk
nV
su
IX
Lu
su
su
su
su
Lu
su
Lu
dO
dO
dO
dO
Jd
"}
(56,1,1) = {"
oK
wT
wT
Rv
jg
wH
Mk
tZ
Mk
ex
Qt
lp
ge
Dj
Qt
lp
ge
lp
Qt
lp
ge
lp
HS
dO
Qf
su
su
su
su
su
su
su
su
su
dO
dO
dO
Jd
"}
(57,1,1) = {"
PT
PT
PT
PT
PT
Qt
Bq
Eq
Bq
Qt
PT
jg
dL
jg
PT
jg
dL
jg
PT
jg
dL
jg
HS
dO
dO
dO
dO
su
su
su
su
su
su
su
dO
dO
dO
Jd
"}
(58,1,1) = {"
Ca
PW
PW
DG
Qt
Ap
VM
tZ
VM
QQ
PT
XM
XM
XM
PT
XM
XM
XM
PT
XM
XM
XM
HS
dO
dO
dO
dO
su
dO
dO
su
su
su
su
su
dO
dO
Jd
"}
(59,1,1) = {"
Ca
RG
dp
Ta
Qt
HT
ge
ZB
Ch
hm
PT
XM
XM
XM
PT
XM
XM
XM
PT
XM
XM
XM
HS
dO
dO
dO
dO
dO
dO
dO
dO
su
su
su
su
dO
dO
Jd
"}
(60,1,1) = {"
Ca
PW
dp
Ik
Qt
is
zV
tZ
zV
Lb
PT
XM
bZ
XM
PT
XM
bZ
XM
PT
XM
bZ
XM
HS
QI
QI
QI
QI
QI
QI
QI
dO
su
Lu
CY
su
dO
dO
Jd
"}
(61,1,1) = {"
Qt
OT
Qt
Qt
Qt
Qt
Bq
Eq
Bq
Qt
PT
PT
PT
PT
PT
PT
PT
PT
PT
PT
PT
PT
PT
PT
PT
PT
PT
PT
PT
QI
dO
su
su
su
su
dO
dO
Jd
"}
