//MAP CONVERTED BY dmm2tgm.py THIS HEADER COMMENT PREVENTS RECONVERSION, DO NOT REMOVE
"af" = (
/obj/machinery/miner/damaged/platinum,
/turf/open/floor/plating/ground/mars/random/cave,
/area/bigredv2/caves/east)
"ah" = (
/obj/machinery/miner/damaged/platinum,
/turf/open/floor/plating/ground/mars/random/cave,
/area/bigredv2/caves/east/garbledradio)
"ai" = (
/turf/open/floor/plating/ground/mars/random/cave/rock,
/area/bigredv2/caves/east/garbledradio)
"aj" = (
/obj/effect/landmark/excavation_site_spawner,
/turf/open/floor/plating/ground/mars/random/cave,
/area/bigredv2/caves/east/garbledradio)
"ak" = (
/obj/effect/landmark/xeno_silo_spawn,
/turf/open/floor/plating/ground/mars/random/cave,
/area/bigredv2/caves/east)
"an" = (
/turf/open/floor/plating/ground/mars/random/cave,
/area/bigredv2/caves/east/garbledradio)
"ao" = (
/turf/open/floor/plating/ground/mars/random/cave/rock,
/area/bigredv2/caves/east)
"ap" = (
/obj/effect/landmark/lv624/fog_blocker,
/turf/closed/mineral/smooth/bigred,
/area/bigredv2/caves/rock)
"aq" = (
/obj/effect/landmark/xeno_silo_spawn,
/turf/open/floor/plating/ground/mars/random/cave,
/area/bigredv2/caves/east/garbledradio)
"ar" = (
/turf/closed/mineral/smooth/bigred,
/area/bigredv2/caves/rock)
"av" = (
/obj/docking_port/stationary/crashmode,
/turf/open/floor/plating/ground/mars/random/cave,
/area/bigredv2/caves/east/garbledradio)
"az" = (
/turf/closed/mineral/smooth/bigred/indestructible,
/area/space)
"aC" = (
/obj/effect/landmark/lv624/fog_blocker/xeno_spawn,
/turf/open/floor/plating/ground/mars/random/cave,
/area/bigredv2/caves/east/garbledradio)
"aD" = (
/obj/effect/landmark/excavation_site_spawner,
/turf/open/floor/plating/ground/mars/random/cave,
/area/bigredv2/caves/east)
"aE" = (
/obj/effect/landmark/lv624/fog_blocker/xeno_spawn,
/turf/open/floor/plating/ground/mars/random/cave/rock,
/area/bigredv2/caves/east/garbledradio)
"aG" = (
/turf/open/floor/plating/ground/mars/random/sand,
/area/bigredv2/outside/se)
"aH" = (
/obj/docking_port/stationary/crashmode,
/turf/closed/mineral/smooth/bigred,
/area/bigredv2/caves/rock)
"aJ" = (
/obj/effect/landmark/lv624/fog_blocker/xeno_spawn,
/obj/effect/landmark/lv624/fog_blocker/xeno_spawn,
/turf/closed/mineral/smooth/bigred,
/area/bigredv2/caves/rock)
"aL" = (
/obj/effect/ai_node,
/turf/open/floor/plating/ground/mars/random/cave/rock,
/area/bigredv2/caves/east/garbledradio)
"aS" = (
/obj/structure/fence/standard/xenoproof,
/obj/effect/landmark/lv624/fog_blocker,
/turf/open/floor/plating/ground/mars/random/cave,
/area/bigredv2/caves/east/garbledradio)
"aT" = (
/obj/effect/ai_node,
/turf/open/floor/plating/ground/mars/random/cave,
/area/bigredv2/caves/east/garbledradio)
"aU" = (
/obj/effect/ai_node,
/turf/open/floor/plating/ground/mars/random/cave,
/area/bigredv2/caves/east)
"aW" = (
/obj/effect/landmark/lv624/fog_blocker/xeno_spawn,
/obj/effect/landmark/lv624/fog_blocker/xeno_spawn,
/turf/open/floor/plating/ground/mars/random/cave,
/area/bigredv2/caves/east/garbledradio)
"aX" = (
/obj/effect/landmark/lv624/fog_blocker/xeno_spawn,
/turf/closed/mineral/smooth/bigred,
/area/bigredv2/caves/rock)
"aY" = (
/obj/effect/landmark/lv624/fog_blocker/xeno_spawn,
/turf/open/floor/plating/ground/mars/random/cave,
/area/bigredv2/caves/east)
"aZ" = (
/turf/open/floor/plating/ground/mars/random/cave,
/area/bigredv2/caves/east)
"xE" = (
/obj/effect/landmark/xeno_tunnel_spawn,
/turf/open/floor/plating/ground/mars/random/cave,
/area/bigredv2/caves/east/garbledradio)
"DC" = (
/obj/effect/ai_node,
/turf/open/floor/plating/ground/mars/random/sand,
/area/bigredv2/outside/se)
"JU" = (
/obj/effect/landmark/xeno_tunnel_spawn,
/turf/open/floor/plating/ground/mars/random/cave,
/area/bigredv2/caves/east)

(1,1,1) = {"
aG
aG
aG
aG
aG
aG
aG
aG
aG
aG
aG
ar
ar
ar
aS
an
an
an
an
an
an
an
an
an
an
an
an
an
ar
ar
ar
ar
ar
ar
ar
ar
ar
an
an
an
an
an
"}
(2,1,1) = {"
aG
aG
aG
aG
aG
aG
aG
aG
aG
aG
aG
ar
ar
ar
ap
an
an
an
an
an
an
an
an
an
an
an
an
an
ar
ar
ar
ar
ar
ar
ar
ar
ar
ar
an
an
aT
an
"}
(3,1,1) = {"
aG
aG
aG
aG
aG
aG
aG
aG
aG
aG
aG
ar
ar
ar
ap
an
an
an
an
an
an
ar
ar
ar
ar
ar
an
an
an
ar
ar
ar
ar
ar
ar
ar
ar
ar
an
an
an
an
"}
(4,1,1) = {"
aG
ar
ar
ar
ar
aG
aG
aG
aG
aG
aG
aG
ar
ar
ap
an
an
an
an
an
an
ar
ar
ar
ar
ar
ai
an
an
an
an
an
an
an
an
ar
ai
ai
an
an
an
an
"}
(5,1,1) = {"
aG
ar
ar
ar
ar
ar
ar
aG
aG
aG
aG
aG
aG
ar
ap
ar
an
aW
aC
aC
aX
aX
aX
aX
aX
aX
aC
aE
aW
an
an
an
an
an
an
ai
an
an
an
an
an
an
"}
(6,1,1) = {"
aG
aG
ar
ar
ar
ar
ar
ar
aG
aG
aG
aG
aG
ar
ap
ar
ar
aC
an
ar
ar
ar
ar
ar
ar
an
an
an
aE
ai
aT
an
an
an
an
an
an
an
an
an
aT
ai
"}
(7,1,1) = {"
aG
aG
aG
aG
aG
aG
aG
aG
aG
aG
aG
aG
aG
ar
ap
ar
ar
aC
an
an
an
ar
an
ar
ar
an
aT
an
aC
aT
an
an
an
an
an
an
an
an
an
ah
an
ai
"}
(8,1,1) = {"
aG
aG
aG
aG
aG
aG
aG
aG
aG
aG
aG
aG
aG
ar
ap
ar
ar
aX
an
an
an
aT
an
an
aT
aT
an
an
aC
an
an
an
an
an
an
an
ai
an
an
an
ai
ar
"}
(9,1,1) = {"
aG
aG
aG
aG
aG
DC
aG
aG
aG
DC
aG
aG
aG
ar
ap
ar
ar
aX
an
an
an
an
an
an
an
an
an
ar
aX
ar
ar
ar
an
an
an
an
an
ai
an
an
an
ai
"}
(10,1,1) = {"
aG
aG
aG
aG
aG
aG
aG
aG
aG
aG
aG
aG
ar
ar
ap
ar
ar
aX
ar
ar
an
an
an
an
an
ar
ar
ar
aX
ar
ar
ar
ar
ar
ar
ar
an
an
an
an
an
ai
"}
(11,1,1) = {"
aG
aG
ar
aG
aG
aG
aG
aG
aG
aG
aG
ar
ar
ar
ap
ar
ar
aX
ar
an
an
an
an
an
an
an
ar
ar
aX
ar
ar
ar
ar
ar
ar
ar
an
an
an
an
an
ai
"}
(12,1,1) = {"
aG
ar
ar
aG
aG
aG
aG
aG
aG
ar
ar
ar
ar
ar
ap
ar
ar
aX
an
ai
an
an
ai
an
an
an
ar
ar
aX
ar
ar
ar
ar
ar
ar
ar
an
an
an
an
an
ai
"}
(13,1,1) = {"
ar
ar
ar
aG
aG
aG
aG
aG
aG
ar
ar
ar
ar
ar
ap
ar
ar
aX
an
an
an
an
an
an
an
an
ar
ar
aX
ar
ar
ar
ar
ar
ar
ar
ai
an
an
an
ai
ar
"}
(14,1,1) = {"
ar
ar
aG
aG
aG
aG
aG
aG
aG
ar
ar
ar
ar
ar
ap
ar
ar
aX
an
an
an
aT
aq
an
an
an
an
ar
aX
ar
ar
ar
ar
ar
ar
ar
an
an
an
an
aT
ai
"}
(15,1,1) = {"
ar
aG
aG
aG
aG
aG
ar
ar
ar
ar
ar
ar
ar
ar
ap
ar
ar
aX
xE
an
an
an
an
an
an
an
ar
ar
aX
ar
ar
ar
ar
ar
ar
ar
ar
ai
an
an
an
ai
"}
(16,1,1) = {"
aG
aG
aG
aG
aG
DC
ar
ar
ar
ar
ar
ar
ar
ar
ap
ar
ar
aX
ar
ar
ar
an
an
an
an
ar
ar
ar
aX
ar
ar
ar
ar
ar
ar
ar
ar
ar
an
an
an
an
"}
(17,1,1) = {"
aG
aG
aG
aG
aG
aG
ar
ar
ar
ar
ar
ar
ar
ar
ap
ar
ar
aX
ar
ar
ar
ar
ar
ar
ar
ar
ar
ar
aX
ar
ar
ar
ar
ar
ar
ar
ar
ar
an
an
an
an
"}
(18,1,1) = {"
ar
ar
ar
ar
ar
ar
ar
ar
ar
ar
ar
ar
ar
ar
ap
ar
ar
aJ
aX
aX
aX
aX
aX
aX
aX
aX
aX
aX
aJ
ar
ar
ar
ar
ar
ar
ar
an
an
an
an
an
an
"}
(19,1,1) = {"
ap
ap
ap
ap
ap
ap
ap
ap
ap
ap
ap
ap
ap
ap
ap
ar
ar
ar
ar
ar
ar
ar
ar
ar
ar
ar
ar
ar
ar
ar
ar
ar
ar
ar
ar
an
an
an
an
an
an
an
"}
(20,1,1) = {"
ar
ar
ar
ar
ar
ar
ar
ar
ar
ar
ar
ar
ar
ar
ar
ar
ar
ar
ar
ar
ar
ar
ar
ar
ar
aH
ar
ar
ar
ar
ar
ar
ar
ar
an
an
an
an
an
an
an
an
"}
(21,1,1) = {"
ar
ar
ar
ar
ar
ar
ar
ar
ar
ar
ar
ar
ar
ar
ar
ar
ar
ar
ar
ar
ar
ar
ar
ar
ar
ar
ar
ar
ar
ar
ar
ar
an
an
an
an
an
an
an
ai
an
an
"}
(22,1,1) = {"
ar
ai
ai
ai
ai
ai
ar
ar
ar
ar
ar
ar
ar
ar
ar
ar
ar
ar
ar
ar
ar
ar
ai
ai
ai
ai
ai
ar
ar
ar
an
an
an
aT
an
an
an
an
an
an
aT
an
"}
(23,1,1) = {"
ar
aT
an
an
an
an
aL
ar
ar
ar
ar
ar
ar
ar
ar
ar
ar
ar
aL
ai
ai
ai
an
an
aT
an
an
ai
ai
an
an
an
aT
an
an
an
ai
ar
ar
an
an
an
"}
(24,1,1) = {"
ar
ai
an
an
an
an
ai
ar
ar
ar
ar
ar
ar
ar
ar
ar
ar
ar
an
an
an
an
an
an
an
an
an
an
an
an
ai
an
an
ai
an
an
ai
ar
ar
an
an
an
"}
(25,1,1) = {"
ar
ar
ar
ai
an
an
ai
an
an
an
an
ar
ar
ar
ar
ar
ar
ai
an
an
an
an
an
an
an
an
an
an
an
an
an
an
ai
an
an
ai
ar
ar
ar
an
an
an
"}
(26,1,1) = {"
ar
ar
ar
ar
ar
an
ai
an
an
an
an
ar
ar
ar
ar
ai
ai
an
an
an
an
an
an
an
an
an
an
an
an
an
an
an
an
an
ai
ar
ar
ar
ar
an
aT
an
"}
(27,1,1) = {"
ai
ai
ai
ai
ai
an
ai
an
an
an
an
an
an
an
an
an
an
an
an
an
an
an
an
an
an
an
an
an
an
an
an
an
an
an
an
ai
ar
ai
ai
an
aj
an
"}
(28,1,1) = {"
an
an
an
an
an
an
aT
ai
ai
ai
ai
ai
ai
ai
an
an
aL
an
aT
an
an
an
an
an
an
ah
an
an
an
an
an
an
an
an
an
an
ai
an
an
an
an
an
"}
(29,1,1) = {"
an
an
an
an
an
an
an
an
an
an
an
an
an
an
an
an
ai
an
an
ai
an
an
an
aj
an
an
an
an
an
an
an
an
an
an
an
an
an
an
an
an
an
an
"}
(30,1,1) = {"
an
an
an
an
an
an
an
an
an
an
an
an
an
an
an
an
aL
an
an
an
an
an
an
an
aT
ai
an
an
an
an
an
an
an
aT
an
an
an
an
an
an
aL
ar
"}
(31,1,1) = {"
an
an
an
an
an
an
an
an
an
an
an
ai
ar
ar
an
an
ai
an
an
an
an
an
an
an
an
aT
an
an
an
an
an
an
an
an
an
an
an
an
an
an
ai
ar
"}
(32,1,1) = {"
ai
an
an
an
an
an
an
ar
ar
ar
ar
ar
ar
ar
ar
an
ai
an
an
an
an
an
an
an
an
an
an
an
an
an
an
an
an
an
an
an
an
an
an
ai
an
ar
"}
(33,1,1) = {"
an
an
an
an
ah
an
an
ar
ar
ar
ar
ar
ar
ar
ar
an
ai
an
an
an
aT
an
an
an
an
an
an
an
ar
ar
ar
ar
ar
ar
an
an
an
an
ai
an
an
an
"}
(34,1,1) = {"
ai
an
an
ai
an
an
an
ar
ar
ar
ar
ar
ar
ar
ai
an
an
an
an
an
an
ar
ar
ar
ar
ar
ar
ar
ar
ar
ar
ar
ar
ar
an
an
an
an
ai
an
an
an
"}
(35,1,1) = {"
ar
ai
an
an
an
an
an
an
ar
ar
ar
ar
ar
ai
an
an
an
an
an
an
ar
ar
ar
ar
ar
ar
ar
ar
ar
ar
ar
ar
ar
ar
ar
ar
ar
ar
ar
an
an
an
"}
(36,1,1) = {"
ar
ar
ar
an
an
ai
an
an
an
ar
ar
ar
ai
an
an
an
an
an
an
ar
ar
ar
ar
ar
ar
ar
ar
ar
ar
ar
ar
ar
ar
ar
ar
ar
ar
ar
ar
ar
aU
aZ
"}
(37,1,1) = {"
ar
ar
ar
an
an
ai
aT
an
av
ai
an
an
an
an
an
an
aL
ar
ar
ar
ar
ar
ar
ar
ar
ar
ar
ar
ar
ar
ar
ar
ar
ar
ar
ar
ar
ar
ar
ar
aZ
aZ
"}
(38,1,1) = {"
ar
ar
ar
an
an
aj
an
an
an
an
an
an
an
an
an
ai
ai
ar
ar
ar
ar
ar
ar
ar
ar
ar
ar
ar
ar
ar
ar
ar
ar
ar
ar
ar
ar
ar
ar
ar
ar
aZ
"}
(39,1,1) = {"
ar
ar
ar
ar
an
an
an
an
an
an
an
an
an
an
an
ar
ar
ar
ar
ar
ar
ar
ar
ar
ar
ar
ar
ar
ar
ar
ar
ar
ar
ar
ar
ar
ar
ar
ar
ar
ar
ar
"}
(40,1,1) = {"
ar
ar
ar
ar
an
an
an
an
an
an
an
an
an
an
an
ar
ar
ar
ar
ar
ar
ar
ar
ar
ar
ar
ar
ar
ar
ar
ar
ar
ar
ar
ar
ar
ar
ar
ar
ar
ar
ar
"}
(41,1,1) = {"
ar
ar
ar
an
an
an
an
an
an
an
an
an
an
an
ar
ar
ar
ar
ar
ar
ar
ar
ar
ar
ar
ar
ar
ar
ar
ar
ar
ar
ar
ar
ar
ar
ar
ar
ar
ar
ar
ar
"}
(42,1,1) = {"
ar
ar
ar
an
an
an
an
an
an
ar
ar
ar
ar
ar
ar
ar
ar
ar
ar
ar
ar
ar
ar
ar
ar
ar
ar
ar
ar
ar
ar
ar
ar
ar
ar
ar
ar
ar
ar
ar
ar
ar
"}
(43,1,1) = {"
ar
ar
an
an
an
an
an
an
an
ar
ar
ar
ar
ar
ar
ar
ar
ar
ar
aX
aX
aX
aX
aX
aX
aX
aX
aX
aX
aX
aX
ar
ar
ar
ar
ar
ar
ar
ar
ar
ar
ar
"}
(44,1,1) = {"
ar
ar
an
an
aZ
aZ
an
an
ar
ar
ar
ar
ar
ar
ar
ar
ar
ar
ar
aX
ar
ar
ar
ar
ar
ar
ar
ar
ar
ar
aX
ar
ar
ar
ar
ar
ar
ar
ar
ar
ar
ar
"}
(45,1,1) = {"
ar
ar
aZ
aZ
aZ
aZ
aZ
aZ
ar
ar
ar
ar
ar
ar
ar
ar
ar
ar
ar
aX
ar
ar
ar
JU
aZ
aZ
aZ
aZ
ar
ar
aX
ar
ar
ar
ar
ar
ar
ar
ar
ar
ar
ar
"}
(46,1,1) = {"
aZ
aZ
aZ
aZ
aZ
aZ
aZ
aZ
ar
ar
ar
ar
ar
ar
ar
ar
ar
ar
ar
aX
ar
ar
aZ
aZ
aZ
aZ
ak
aZ
aZ
ar
aX
ar
ar
ar
aZ
aZ
aZ
aZ
aZ
aZ
aZ
aZ
"}
(47,1,1) = {"
aZ
aZ
aU
aZ
aZ
aZ
aU
ar
ar
ar
ar
ar
ar
ar
ar
ar
ar
ar
ar
aX
ar
ar
aZ
aZ
aZ
aZ
aZ
aZ
aZ
aZ
aX
ar
ar
ar
aZ
aZ
aZ
aZ
aZ
aZ
aZ
aZ
"}
(48,1,1) = {"
aZ
aZ
aZ
aZ
aZ
aZ
aZ
ar
ar
ar
ar
ar
ar
ar
ar
ar
ar
ar
ar
aX
ar
ar
aZ
aZ
aZ
aZ
aZ
aZ
aZ
aZ
aX
ar
ar
aZ
aZ
aZ
aZ
aZ
aZ
aU
aZ
aZ
"}
(49,1,1) = {"
aZ
aZ
aU
aZ
aZ
aZ
ar
ar
ar
ar
ar
ar
ar
ar
ar
ar
ar
ar
ar
aX
ar
aZ
aZ
aZ
aZ
aZ
aZ
aZ
aZ
aZ
aX
ar
ar
aZ
aZ
aZ
aZ
aZ
aZ
aZ
aZ
aZ
"}
(50,1,1) = {"
aZ
aZ
aZ
aZ
aZ
aZ
ar
ar
ar
ar
ar
ar
ar
ar
ar
ar
ar
ar
ar
aX
aY
aY
aY
aY
aY
aY
aY
aY
aY
aY
aY
aZ
aZ
aZ
aZ
aZ
aZ
aZ
aZ
aZ
aZ
aZ
"}
(51,1,1) = {"
aZ
aZ
aZ
aZ
aZ
aZ
ar
ar
ar
ar
ar
ar
ar
ar
ar
ar
ar
ar
ar
ar
aZ
aZ
aZ
aZ
aZ
aZ
aZ
aZ
aZ
aZ
aZ
aZ
aZ
aZ
aZ
aZ
aZ
aZ
aZ
aZ
aZ
aZ
"}
(52,1,1) = {"
aZ
ao
aZ
aZ
aZ
aZ
ar
ar
ar
aZ
aZ
aZ
aZ
aZ
aZ
aZ
aZ
aZ
aZ
aZ
aZ
aZ
aZ
aZ
aZ
aZ
aZ
aZ
aZ
aZ
aU
aZ
aZ
aZ
aZ
aZ
aD
aZ
aZ
aU
aZ
aZ
"}
(53,1,1) = {"
aZ
aZ
aZ
aZ
aZ
aZ
ar
ar
ar
aZ
aZ
aZ
aZ
aZ
aZ
aZ
aZ
aZ
aZ
aZ
aZ
aZ
aZ
ao
aZ
aZ
aZ
aZ
aZ
aZ
aZ
aZ
aZ
aZ
ao
aZ
aZ
aZ
aZ
aZ
aZ
aZ
"}
(54,1,1) = {"
aZ
aZ
aZ
aZ
aZ
aZ
aZ
aZ
aZ
aZ
aZ
aZ
aZ
aZ
aZ
aZ
aZ
aZ
aZ
aD
aZ
aZ
aZ
aZ
aZ
aZ
aZ
af
aZ
aZ
aZ
aZ
aZ
aZ
aZ
aZ
aZ
aZ
aZ
aZ
aZ
aZ
"}
(55,1,1) = {"
aZ
aZ
aU
aZ
aZ
aZ
aZ
aZ
aZ
aZ
aZ
aZ
aU
aZ
aZ
aZ
aZ
aZ
aZ
aZ
aU
aZ
aZ
aZ
aZ
aZ
aZ
aZ
aZ
aZ
aU
aZ
aZ
aZ
aZ
aZ
aZ
aZ
aZ
aZ
aZ
aZ
"}
(56,1,1) = {"
aZ
aZ
aZ
aZ
aZ
aZ
aZ
aZ
aZ
aZ
aZ
ao
aZ
aZ
aZ
aZ
aZ
aZ
aZ
aZ
aZ
aZ
aZ
aZ
aZ
aZ
aZ
aZ
aZ
aZ
aZ
aZ
aZ
aZ
ar
ar
ar
ar
ar
ar
ar
ar
"}
(57,1,1) = {"
aZ
aZ
aZ
ar
aZ
aZ
aZ
aZ
aZ
aZ
aZ
aZ
aZ
aZ
aZ
aZ
aZ
ao
aZ
aZ
aZ
aZ
aZ
aZ
aZ
aZ
aZ
aZ
aZ
aZ
aZ
aZ
aZ
aZ
ar
ar
ar
ar
ar
ar
ar
ar
"}
(58,1,1) = {"
aZ
aZ
aZ
ar
ar
ar
ar
ar
ar
aZ
aZ
aZ
aZ
aZ
aZ
aZ
aZ
aZ
aZ
aZ
aZ
aZ
aZ
aZ
aZ
aZ
ar
ar
ar
ar
ar
ar
ar
ar
ar
ar
ar
ar
ar
ar
ar
ar
"}
(59,1,1) = {"
aZ
aZ
ar
ar
ar
ar
ar
ar
ar
aZ
aZ
aZ
aZ
aZ
aZ
aZ
aZ
aZ
aZ
aZ
aZ
aZ
aZ
aZ
aZ
aZ
ar
ar
ar
ar
ar
ar
ar
ar
ar
ar
ar
ar
ar
ar
ar
ar
"}
(60,1,1) = {"
ar
ar
ar
ar
ar
ar
ar
ar
ar
ar
ar
ar
ar
aZ
aZ
aZ
aZ
aZ
ar
ar
ar
ar
ar
ar
ar
ar
ar
ar
ar
ar
ar
ar
ar
ar
ar
ar
ar
ar
ar
ar
ar
ar
"}
(61,1,1) = {"
ar
ar
ar
ar
ar
ar
ar
ar
ar
ar
ar
ar
ar
ar
ar
ar
ar
ar
ar
ar
ar
ar
ar
ar
ar
ar
ar
ar
ar
ar
ar
ar
ar
ar
ar
ar
ar
ar
ar
ar
ar
ar
"}
(62,1,1) = {"
aX
aX
ar
ar
ar
ar
ar
ar
ar
ar
ar
ar
ar
ar
ar
ar
ar
ar
ar
ar
ar
ar
ar
ar
ar
ar
ar
ar
ar
ar
ar
ar
ar
ar
ar
ar
ar
ar
ar
ar
ar
ar
"}
(63,1,1) = {"
ar
aX
aX
ar
ar
ar
ar
ar
ar
ar
ar
ar
ar
ar
ar
ar
ar
ar
ar
ar
ar
ar
ar
ar
ar
ar
ar
ar
ar
ar
ar
ar
ar
ar
ar
ar
ar
ar
ar
ar
ar
ar
"}
(64,1,1) = {"
ar
ar
aX
ar
ar
ar
ar
ar
ar
ar
ar
ar
ar
ar
ar
ar
ar
ar
ar
ar
ar
ar
ar
ar
ar
ar
ar
ar
ar
ar
ar
ar
ar
ar
ar
ar
ar
ar
ar
ar
ar
ar
"}
(65,1,1) = {"
ar
ar
aX
ar
ar
ar
ar
ar
ar
ar
ar
ar
ar
ar
ar
ar
ar
ar
ar
ar
ar
ar
ar
ar
ar
ar
ar
ar
ar
ar
ar
ar
ar
ar
ar
ar
ar
ar
ar
ar
ar
ar
"}
(66,1,1) = {"
aZ
ar
az
az
az
az
az
az
az
az
az
az
az
az
az
az
az
az
az
az
az
az
az
az
az
az
az
az
az
az
az
az
az
az
az
az
az
az
az
az
az
az
"}
