//MAP CONVERTED BY dmm2tgm.py THIS HEADER COMMENT PREVENTS RECONVERSION, DO NOT REMOVE
"aa" = (
/turf/open/floor/plating/ground/mars/random/cave/rock,
/area/bigredv3/caves/east/garbledradio)
"aj" = (
/obj/effect/landmark/lv624/fog_blocker/xeno_spawn,
/turf/open/floor/plating/ground/mars/random/cave,
/area/bigredv3/caves/east/garbledradio)
"am" = (
/obj/effect/landmark/lv624/fog_blocker/xeno_spawn,
/turf/open/floor/plating/ground/mars/random/cave,
/area/bigredv3/caves/east)
"ao" = (
/turf/open/floor/plating/ground/mars/random/cave,
/area/bigredv3/caves/east/garbledradio)
"ap" = (
/obj/effect/landmark/xeno_silo_spawn,
/turf/open/floor/plating/ground/mars/random/cave,
/area/bigredv3/caves/east/garbledradio)
"aq" = (
/turf/closed/mineral/smooth/bigred/indestructible,
/area/space)
"aw" = (
/obj/effect/landmark/lv624/fog_blocker/xeno_spawn,
/turf/closed/mineral/smooth/bigred,
/area/bigredv3/caves/rock)
"ax" = (
/obj/effect/landmark/xeno_silo_spawn,
/turf/open/floor/plating/ground/mars/random/cave,
/area/bigredv3/caves/east)
"aC" = (
/obj/effect/landmark/lv624/fog_blocker,
/turf/closed/mineral/smooth/bigred,
/area/bigredv3/caves/rock)
"aE" = (
/obj/effect/ai_node,
/turf/open/floor/plating/ground/mars/random/cave,
/area/bigredv3/caves/east/garbledradio)
"aK" = (
/obj/effect/ai_node,
/turf/open/floor/plating/ground/mars/random/cave/rock,
/area/bigredv3/caves/east/garbledradio)
"aL" = (
/turf/open/floor/plating/ground/mars/random/cave,
/area/bigredv3/caves/east)
"aO" = (
/obj/effect/landmark/lv624/fog_blocker/xeno_spawn,
/turf/open/floor/plating/ground/mars/random/cave/rock,
/area/bigredv3/caves/east/garbledradio)
"aP" = (
/turf/open/floor/plating/ground/mars/random/cave/rock,
/area/bigredv3/caves/east)
"aQ" = (
/obj/effect/landmark/lv624/fog_blocker/xeno_spawn,
/obj/effect/landmark/lv624/fog_blocker/xeno_spawn,
/turf/closed/mineral/smooth/bigred,
/area/bigredv3/caves/rock)
"aU" = (
/obj/effect/landmark/lv624/fog_blocker,
/turf/closed/wall/r_wall,
/area/bigredv3/caves/east/garbledradio)
"aV" = (
/obj/effect/landmark/lv624/fog_blocker/xeno_spawn,
/obj/effect/landmark/lv624/fog_blocker/xeno_spawn,
/turf/open/floor/plating/ground/mars/random/cave,
/area/bigredv3/caves/east/garbledradio)
"aW" = (
/obj/effect/ai_node,
/turf/open/floor/plating/ground/mars/random/cave,
/area/bigredv3/caves/east)
"aX" = (
/turf/closed/mineral/smooth/bigred,
/area/bigredv3/caves/rock)
"pG" = (
/turf/open/floor/plating/ground/mars/random/sand,
/area/bigredv3/outside/directions/se)
"vx" = (
/obj/structure/cable,
/turf/open/floor/plating/ground/mars/random/sand,
/area/bigredv3/outside/directions/se)
"KL" = (
/obj/structure/fence/standard/xenoproof,
/turf/open/floor/plating/ground/mars/random/cave,
/area/bigredv3/caves/east/garbledradio)
"WZ" = (
/obj/effect/ai_node,
/turf/open/floor/plating/ground/mars/random/sand,
/area/bigredv3/outside/directions/se)

(1,1,1) = {"
pG
pG
pG
pG
pG
pG
pG
pG
pG
pG
pG
aX
aX
aX
aU
KL
KL
ao
ao
ao
ao
ao
ao
ao
ao
ao
ao
ao
aX
aX
aX
aX
aX
aX
aX
aX
aX
ao
ao
ao
ao
ao
"}
(2,1,1) = {"
pG
pG
pG
pG
pG
pG
pG
pG
pG
pG
pG
aX
aX
aX
aC
ao
ao
ao
ao
ao
ao
ao
ao
ao
ao
ao
ao
ao
aX
aX
aX
aX
aX
aX
aX
aX
aX
aX
ao
ao
aE
ao
"}
(3,1,1) = {"
pG
pG
pG
pG
pG
pG
pG
pG
pG
pG
pG
aX
aX
aX
aC
ao
ao
ao
ao
ao
ao
aX
aX
aX
aX
aX
ao
ao
ao
aX
aX
aX
aX
aX
aX
aX
aX
aX
ao
ao
ao
ao
"}
(4,1,1) = {"
pG
aX
aX
aX
aX
pG
pG
pG
pG
pG
pG
pG
aX
aX
aC
ao
ao
ao
ao
ao
ao
aX
aX
aX
aX
aX
aa
ao
ao
ao
ao
ao
ao
ao
ao
aX
aa
aa
ao
ao
ao
ao
"}
(5,1,1) = {"
pG
aX
aX
aX
aX
aX
aX
pG
pG
pG
pG
pG
pG
aX
aC
aX
ao
aV
aj
aj
aw
aw
aw
aw
aw
aw
aj
aO
aV
ao
ao
ao
ao
ao
ao
aa
ao
ao
ao
ao
ao
ao
"}
(6,1,1) = {"
pG
pG
aX
aX
aX
aX
aX
aX
pG
pG
pG
pG
pG
aX
aC
aX
aX
aj
ao
aX
aX
aX
aX
aX
aX
ao
ao
ao
aO
aa
aE
ao
ao
ao
ao
ao
ao
ao
ao
ao
aE
aa
"}
(7,1,1) = {"
pG
pG
pG
pG
pG
pG
pG
pG
pG
pG
pG
pG
pG
aX
aC
aX
aX
aj
ao
ao
ao
aX
ao
aX
aX
ao
aE
ao
aj
aE
ao
ao
ao
ao
ao
ao
ao
ao
ao
ao
ao
aa
"}
(8,1,1) = {"
pG
pG
pG
pG
pG
pG
pG
pG
pG
pG
pG
pG
pG
aX
aC
aX
aX
aw
ao
ao
ao
aE
ao
ao
aE
aE
ao
ao
aj
ao
ao
ao
ao
ao
ao
ao
aa
ao
ao
ao
aa
aX
"}
(9,1,1) = {"
pG
pG
pG
pG
pG
WZ
pG
pG
pG
WZ
pG
pG
pG
aX
aC
aX
aX
aw
ao
ao
ao
ao
ao
ao
ao
ao
ao
aX
aw
aX
aX
aX
ao
ao
ao
ao
ao
aa
ao
ao
ao
aa
"}
(10,1,1) = {"
pG
pG
pG
pG
pG
pG
pG
pG
pG
pG
pG
pG
aX
aX
aC
aX
aX
aw
aX
aX
ao
ao
ao
ao
ao
aX
aX
aX
aw
aX
aX
aX
aX
aX
aX
aX
ao
ao
ao
ao
ao
aa
"}
(11,1,1) = {"
pG
pG
aX
pG
pG
pG
pG
pG
pG
pG
pG
aX
aX
aX
aC
aX
aX
aw
aX
ao
ao
ao
ao
ao
ao
ao
aX
aX
aw
aX
aX
aX
aX
aX
aX
aX
ao
ao
ao
ao
ao
aa
"}
(12,1,1) = {"
pG
aX
aX
pG
pG
pG
pG
pG
pG
aX
aX
aX
aX
aX
aC
aX
aX
aw
ao
aa
ao
ao
aa
ao
ao
ao
aX
aX
aw
aX
aX
aX
aX
aX
aX
aX
ao
ao
ao
ao
ao
aa
"}
(13,1,1) = {"
aX
aX
aX
pG
pG
vx
pG
pG
pG
aX
aX
aX
aX
aX
aC
aX
aX
aw
ao
ao
ao
ao
ao
ao
ao
ao
aX
aX
aw
aX
aX
aX
aX
aX
aX
aX
aa
ao
ao
ao
aa
aX
"}
(14,1,1) = {"
aX
aX
pG
pG
pG
pG
pG
pG
pG
aX
aX
aX
aX
aX
aC
aX
aX
aw
ao
ao
ao
aE
ap
ao
ao
ao
ao
aX
aw
aX
aX
aX
aX
aX
aX
aX
ao
ao
ao
ao
aE
aa
"}
(15,1,1) = {"
aX
pG
pG
pG
pG
pG
aX
aX
aX
aX
aX
aX
aX
aX
aC
aX
aX
aw
ao
ao
ao
ao
ao
ao
ao
ao
aX
aX
aw
aX
aX
aX
aX
aX
aX
aX
aX
aa
ao
ao
ao
aa
"}
(16,1,1) = {"
pG
pG
pG
pG
pG
WZ
aX
aX
aX
aX
aX
aX
aX
aX
aC
aX
aX
aw
aX
aX
aX
ao
ao
ao
ao
aX
aX
aX
aw
aX
aX
aX
aX
aX
aX
aX
aX
aX
ao
ao
ao
ao
"}
(17,1,1) = {"
pG
pG
pG
pG
pG
pG
aX
aX
aX
aX
aX
aX
aX
aX
aC
aX
aX
aw
aX
aX
aX
aX
aX
aX
aX
aX
aX
aX
aw
aX
aX
aX
aX
aX
aX
aX
aX
aX
ao
ao
ao
ao
"}
(18,1,1) = {"
aX
aX
aX
aX
aX
aX
aX
aX
aX
aX
aX
aX
aX
aX
aC
aX
aX
aQ
aw
aw
aw
aw
aw
aw
aw
aw
aw
aw
aQ
aX
aX
aX
aX
aX
aX
aX
ao
ao
ao
ao
ao
ao
"}
(19,1,1) = {"
aC
aC
aC
aC
aC
aC
aC
aC
aC
aC
aC
aC
aC
aC
aC
aX
aX
aX
aX
aX
aX
aX
aX
aX
aX
aX
aX
aX
aX
aX
aX
aX
aX
aX
aX
ao
ao
ao
ao
ao
ao
ao
"}
(20,1,1) = {"
aX
aX
aX
aX
aX
aX
aX
aX
aX
aX
aX
aX
aX
aX
aX
aX
aX
aX
aX
aX
aX
aX
aX
aX
aX
aX
aX
aX
aX
aX
aX
aX
aX
aX
ao
ao
ao
ao
ao
ao
ao
ao
"}
(21,1,1) = {"
aX
aX
aX
aX
aX
aX
aX
aX
aX
aX
aX
aX
aX
aX
aX
aX
aX
aX
aX
aX
aX
aX
aX
aX
aX
aX
aX
aX
aX
aX
aX
aX
aX
aX
ao
ao
ao
ao
ao
aa
ao
ao
"}
(22,1,1) = {"
aX
aa
aa
aK
aa
aa
aX
aX
aX
aX
aX
aX
aX
aX
aX
aX
aX
aX
aX
aX
aX
aX
aX
aX
aX
aX
aX
aX
aX
aX
aX
aX
aX
aX
ao
ao
ao
ao
ao
ao
aE
ao
"}
(23,1,1) = {"
aX
ao
ao
ao
ao
ao
aa
aX
aX
aX
aX
aX
aX
aX
aX
aX
aX
aX
aX
aX
aX
aX
aX
aX
aX
aX
aX
aX
aX
aX
aX
aX
aX
aX
ao
ao
aa
aX
aX
ao
ao
ao
"}
(24,1,1) = {"
aX
aa
ao
ao
ao
ao
aa
aX
aX
aX
aX
aX
aX
aX
aX
aX
aX
aX
aX
aX
aX
aX
aX
aX
aX
aX
aX
aX
aX
aX
aX
aX
ao
aa
ao
ao
aa
aX
aX
ao
ao
ao
"}
(25,1,1) = {"
aX
aX
aX
aK
ao
ao
aa
ao
aE
ao
ao
aX
aX
aX
aX
aX
aX
aX
aX
aX
aX
aX
aX
aX
aX
aX
aX
aX
aX
aX
ao
ao
aa
ao
ao
aa
aX
aX
aX
ao
ao
ao
"}
(26,1,1) = {"
aX
aX
aX
aX
aX
ao
aa
ao
ao
ao
ao
aX
aX
aX
aX
aa
aa
ao
ao
ao
ao
ao
aX
aX
aX
aX
aX
ao
ao
ao
ao
ao
ao
ao
aa
aX
aX
aX
aX
ao
aE
ao
"}
(27,1,1) = {"
aa
aa
aa
aa
aa
ao
aa
ao
ao
ao
ao
ao
ao
ao
ao
ao
ao
ao
ao
ao
ao
ao
ao
ao
ao
ao
ao
ao
ao
ao
ao
ao
ao
ao
ao
aa
aX
aa
aa
ao
ao
ao
"}
(28,1,1) = {"
aE
ao
ao
ao
ao
aE
ao
aa
aK
aa
aa
aa
aa
aa
ao
ao
aK
ao
ao
ao
ao
ao
ao
aE
ao
ao
ao
ao
ao
ao
ao
ao
ao
aE
ao
ao
aa
ao
ao
ao
ao
ao
"}
(29,1,1) = {"
ao
ao
ao
ao
ao
ao
ao
ao
ao
ao
ao
ao
ao
ao
ao
ao
aa
ao
ao
aa
ao
ao
ao
ao
ao
ao
ao
ao
ao
ao
ao
ao
ao
ao
ao
ao
ao
ao
ao
ao
ao
ao
"}
(30,1,1) = {"
ao
ao
ao
ao
ao
ao
ao
ao
ao
ao
ao
ao
ao
ao
ao
ao
aa
ao
ao
ao
ao
ao
ao
ao
ao
aa
ao
ao
ao
ao
ao
ao
ao
ao
ao
ao
ao
ao
ao
ao
aK
aX
"}
(31,1,1) = {"
ao
ao
ao
ao
ao
ao
ao
ao
ao
ao
ao
aa
aX
aX
ao
ao
aa
ao
ao
ao
ao
ao
ao
ao
ao
ao
ao
ao
ao
aX
aX
aX
aX
ao
ao
ao
ao
ao
ao
ao
aa
aX
"}
(32,1,1) = {"
aa
ao
ao
ao
ao
ao
ao
aX
aX
aX
aX
aX
aX
aX
aX
ao
aa
ao
ao
ao
ao
ao
ao
ao
ao
ao
aX
aX
aX
aX
aX
aX
aX
ao
ao
ao
ao
ao
ao
aa
ao
aX
"}
(33,1,1) = {"
ao
ao
ao
ao
ao
ao
ao
aX
aX
aX
aX
aX
aX
aX
aX
ao
aa
ao
ao
ao
ao
ao
aX
aX
aX
aX
aX
aX
aX
aX
aX
aX
ao
aE
ao
ao
ao
ao
aa
ao
ao
ao
"}
(34,1,1) = {"
aa
ao
ao
aa
ao
ao
ao
aX
aX
aX
aX
aX
aX
aX
aa
ao
ao
ao
ao
ao
aX
aX
aX
aX
aX
aX
aX
aX
aX
aX
aX
aX
aE
ao
ao
ao
ao
ao
aa
ao
aE
ao
"}
(35,1,1) = {"
aX
aa
ao
ao
ao
ao
ao
ao
aX
aX
aX
aX
aX
aa
ao
ao
ao
ao
ao
aX
aX
aX
aX
aX
aX
aX
aX
aX
aX
aX
aL
aE
ao
ao
ao
ao
ao
aX
aX
ao
ao
aL
"}
(36,1,1) = {"
aX
aX
aX
ao
ao
aa
ao
ao
ao
aX
aX
aX
aa
ao
ao
ao
ao
ao
ao
aX
aX
aX
aX
aX
aX
aX
aX
aX
aX
aL
aL
aL
aL
aL
ao
ao
aX
aX
aX
aX
aW
aL
"}
(37,1,1) = {"
aX
aX
aX
ao
ao
aP
ao
aL
ao
aa
ao
ao
ao
ao
aL
ao
ao
aL
aX
aX
aX
aX
aX
aX
aX
aX
aX
aX
aL
aL
aL
aL
aL
aL
aL
aL
aX
aX
aX
aX
aL
aL
"}
(38,1,1) = {"
aX
aX
aX
aL
aL
aW
aL
aL
aL
ao
ao
aL
aL
aL
aL
aL
aW
aX
aX
aX
aX
aX
aX
aX
aX
aX
aX
aX
aL
aL
aL
aL
aL
aL
aL
aX
aX
aX
aX
aX
aX
aL
"}
(39,1,1) = {"
aX
aX
aX
aX
aL
aL
aL
aL
aL
aL
aL
aL
aL
aL
aL
aX
aX
aX
aX
aX
aX
aX
aX
aX
aX
aX
aX
aX
aL
aL
aL
aL
aL
aL
aL
aX
aX
aX
aX
aX
aX
aX
"}
(40,1,1) = {"
aX
aX
aX
aX
aL
aL
aL
aL
aL
aL
aL
aL
aL
aL
aX
aX
aX
aX
aX
aX
aX
aX
aX
aX
aX
aX
aL
aL
aL
aL
aL
aL
aL
aL
aL
aX
aX
aX
aX
aX
aX
aX
"}
(41,1,1) = {"
aX
aX
aX
aL
aL
aL
aL
aL
aL
aL
aL
aL
aX
aX
aX
aX
aX
aX
aX
aX
aX
aX
aX
aX
aX
aL
aL
aL
aL
aL
aL
aL
aL
aL
aL
aX
aX
aX
aX
aX
aX
aX
"}
(42,1,1) = {"
aX
aX
aX
aL
aL
aL
aL
aL
aL
aL
aL
aL
aX
aX
aX
aX
aX
aX
aX
aX
aL
aX
aX
aX
aL
aL
aL
aL
aL
aL
aL
aW
aL
aL
aL
aX
aX
aX
aX
aX
aX
aX
"}
(43,1,1) = {"
aX
aX
aL
aL
aL
aL
aL
aL
aL
aL
aL
aL
aL
aX
aX
aX
aX
aX
aX
aL
aL
aL
aX
aX
aL
aL
aL
aL
aL
aL
aL
aL
aL
aL
aL
aX
aX
aX
aX
aX
aX
aX
"}
(44,1,1) = {"
aX
aX
aL
aL
aL
aL
aL
aL
aL
aL
aL
aL
aL
aL
aL
aX
aX
aX
aL
aL
aL
aL
aL
aL
aL
aL
aL
aL
aL
aL
aL
aL
aL
aL
aL
aL
aX
aX
aX
aX
aX
aX
"}
(45,1,1) = {"
aX
aX
aL
aL
aL
aL
aL
aL
aL
aL
aL
aL
aL
aL
aL
aL
aL
aL
aL
aL
aL
aL
aL
aL
aL
aL
aL
aL
aL
aL
aL
aL
aL
aL
aL
aL
aL
aX
aX
aX
aX
aX
"}
(46,1,1) = {"
aL
aL
aL
aL
aL
aL
aL
aL
aL
aL
aL
aL
aL
aL
aL
aL
aL
aL
aL
aL
aL
aL
aL
aL
aL
aL
aL
aL
aL
aL
aL
aL
aL
aL
aL
aL
aL
aL
aL
aL
aL
aL
"}
(47,1,1) = {"
aL
aL
aL
aL
aL
aL
aL
aL
aL
aL
aL
aL
aL
aL
aL
aL
aL
aL
aL
aL
aL
aL
aL
aL
aL
aL
aL
aL
aL
aL
aL
aL
aL
aL
aL
aL
aL
aL
aL
aL
aL
aL
"}
(48,1,1) = {"
aW
aL
aL
aL
aL
aW
aL
aL
aL
aL
aL
aL
aL
aL
aW
aL
aL
aL
aL
aL
aL
aL
aL
aW
aL
aL
aL
aL
aL
aL
aL
aW
aL
aL
aL
aL
aL
aL
aL
aW
aL
aL
"}
(49,1,1) = {"
aL
aL
aL
aL
aL
aL
aL
aL
aL
aL
aL
aL
aL
aL
aL
aL
aL
aL
aL
aL
aL
aL
aL
aL
aL
aL
aL
aL
aL
aL
aL
aL
aL
aL
aL
aL
aL
aL
aL
aL
aL
aL
"}
(50,1,1) = {"
aL
aL
aL
aL
aL
aL
aL
aL
aL
aX
aX
aX
aX
aL
aL
aL
aL
aL
aL
aL
aL
aL
aL
aL
aL
aL
aL
aL
aL
aL
aL
aL
aL
aL
aL
aL
aL
aL
aL
aL
aL
aL
"}
(51,1,1) = {"
aL
aL
aL
aL
aL
aL
aL
aL
aL
aX
aX
aX
aX
aX
aL
aL
aL
aL
aL
aL
aL
aL
aL
aL
aL
aL
aL
aL
aL
aX
aX
aX
aX
aL
aL
aL
aL
aL
aL
aL
aL
aL
"}
(52,1,1) = {"
aL
aP
aL
aL
aL
aL
aL
aX
aX
aX
aX
aX
aw
aw
am
am
am
am
am
am
am
am
am
aL
aL
aL
aL
aL
aX
aX
aX
aX
aX
aX
aL
aL
aL
aL
aL
aW
aL
aL
"}
(53,1,1) = {"
aW
aL
aL
aL
aX
aX
aX
aX
aX
aX
aX
aX
aw
aX
aX
aL
aL
aL
aL
aL
aL
aL
aw
aP
aL
aL
aL
aX
aX
aX
aX
aX
aX
aX
aP
aL
aL
aL
aL
aL
aL
aL
"}
(54,1,1) = {"
aL
aL
aL
aL
aX
aX
aX
aX
aX
aX
aX
aX
aw
aX
aX
aL
aL
aL
aL
aL
aL
aX
aw
aX
aL
aX
aX
aX
aX
aX
aX
aX
aX
aX
aX
aX
aL
aL
aL
aL
aL
aL
"}
(55,1,1) = {"
aL
aL
aL
aX
aX
aX
aX
aX
aX
aX
aX
aX
aw
aX
aL
aL
aL
aL
aL
aL
aL
aX
aw
aX
aX
aX
aX
aX
aX
aX
aX
aX
aX
aX
aX
aX
aX
aX
aX
aL
aL
aL
"}
(56,1,1) = {"
aL
aL
aL
aX
aX
aX
aX
aX
aX
aX
aX
aX
aw
aX
aL
aL
aL
aL
aL
ax
aL
aX
aw
aX
aX
aX
aX
aX
aX
aX
aX
aX
aX
aX
aX
aX
aX
aX
aX
aX
aX
aX
"}
(57,1,1) = {"
aL
aL
aL
aX
aX
aX
aX
aX
aX
aX
aX
aX
aw
aX
aX
aL
aL
aL
aL
aL
aL
aL
aw
aX
aX
aX
aX
aX
aX
aX
aX
aX
aX
aX
aX
aX
aX
aX
aX
aX
aX
aX
"}
(58,1,1) = {"
aL
aL
aL
aX
aX
aX
aX
aX
aX
aX
aX
aX
aw
aX
aX
aX
aL
aL
aL
aL
aL
aL
aw
aX
aX
aX
aX
aX
aX
aX
aX
aX
aX
aX
aX
aX
aX
aX
aX
aX
aX
aX
"}
(59,1,1) = {"
aW
aL
aX
aX
aX
aX
aX
aX
aX
aX
aX
aX
aw
aw
aw
aw
aw
aw
aw
aw
aw
aw
aw
aX
aX
aX
aX
aX
aX
aX
aX
aX
aX
aX
aX
aX
aX
aX
aX
aX
aX
aX
"}
(60,1,1) = {"
aX
aX
aX
aX
aX
aX
aX
aX
aX
aX
aX
aX
aX
aX
aX
aX
aX
aX
aX
aX
aX
aX
aX
aX
aX
aX
aX
aX
aX
aX
aX
aX
aX
aX
aX
aX
aX
aX
aX
aX
aX
aX
"}
(61,1,1) = {"
aX
aX
aX
aX
aX
aX
aX
aX
aX
aX
aX
aX
aX
aX
aX
aX
aX
aX
aX
aX
aX
aX
aX
aX
aX
aX
aX
aX
aX
aX
aX
aX
aX
aX
aX
aX
aX
aX
aX
aX
aX
aX
"}
(62,1,1) = {"
aw
aw
aX
aX
aX
aX
aX
aX
aX
aX
aX
aX
aX
aX
aX
aX
aX
aX
aX
aX
aX
aX
aX
aX
aX
aX
aX
aX
aX
aX
aX
aX
aX
aX
aX
aX
aX
aX
aX
aX
aX
aX
"}
(63,1,1) = {"
aX
aw
aw
aX
aX
aX
aX
aX
aX
aX
aX
aX
aX
aX
aX
aX
aX
aX
aX
aX
aX
aX
aX
aX
aX
aX
aX
aX
aX
aX
aX
aX
aX
aX
aX
aX
aX
aX
aX
aX
aX
aX
"}
(64,1,1) = {"
aX
aX
aw
aX
aX
aX
aX
aX
aX
aX
aX
aX
aX
aX
aX
aX
aX
aX
aX
aX
aX
aX
aX
aX
aX
aX
aX
aX
aX
aX
aX
aX
aX
aX
aX
aX
aX
aX
aX
aX
aX
aX
"}
(65,1,1) = {"
aX
aX
aw
aX
aX
aX
aX
aX
aX
aX
aX
aX
aX
aX
aX
aX
aX
aX
aX
aX
aX
aX
aX
aX
aX
aX
aX
aX
aX
aX
aX
aX
aX
aX
aX
aX
aX
aX
aX
aX
aX
aX
"}
(66,1,1) = {"
aL
aX
aq
aq
aq
aq
aq
aq
aq
aq
aq
aq
aq
aq
aq
aq
aq
aq
aq
aq
aq
aq
aq
aq
aq
aq
aq
aq
aq
aq
aq
aq
aq
aq
aq
aq
aq
aq
aq
aq
aq
aq
"}
