//MAP CONVERTED BY dmm2tgm.py THIS HEADER COMMENT PREVENTS RECONVERSION, DO NOT REMOVE
"a" = (
/turf/open/floor/marking/asteroidwarning{
	dir = 8
	},
/area/bigredv3/outside/directions/central)
"f" = (
/obj/machinery/atmospherics/pipe/simple/green/hidden,
/obj/structure/cable,
/turf/open/floor/asteroidfloor,
/area/bigredv3/outside/directions/central)
"l" = (
/obj/structure/cable,
/turf/open/floor/asteroidfloor,
/area/bigredv3/outside/directions/central)
"n" = (
/obj/structure/cable,
/turf/open/floor/marking/asteroidwarning{
	dir = 4
	},
/area/bigredv3/outside/directions/central)
"E" = (
/turf/open/floor/marking/asteroidwarning{
	dir = 4
	},
/area/bigredv3/outside/directions/central)
"R" = (
/turf/open/floor/asteroidfloor,
/area/bigredv3/outside/directions/central)
"T" = (
/obj/structure/cable,
/obj/effect/ai_node,
/turf/open/floor/asteroidfloor,
/area/bigredv3/outside/directions/central)

(1,1,1) = {"
a
a
a
"}
(2,1,1) = {"
R
R
R
"}
(3,1,1) = {"
f
f
f
"}
(4,1,1) = {"
R
T
R
"}
(5,1,1) = {"
R
l
R
"}
(6,1,1) = {"
E
n
E
"}
