//MAP CONVERTED BY dmm2tgm.py THIS HEADER COMMENT PREVENTS RECONVERSION, DO NOT REMOVE
"b" = (
/obj/effect/landmark/lv624/fog_blocker,
/turf/closed/mineral/smooth/bigred,
/area/bigredv3/caves/rock)
"d" = (
/obj/effect/ai_node,
/turf/open/floor/plating/ground/mars/random/cave,
/area/bigredv3/caves/east/garbledradio)
"n" = (
/obj/effect/ai_node,
/turf/open/floor/plating/ground/mars/random/cave/rock,
/area/bigredv3/caves/east/garbledradio)
"p" = (
/obj/effect/landmark/lv624/fog_blocker,
/turf/open/floor/plating/ground/mars/random/cave,
/area/bigredv3/caves/east/garbledradio)
"w" = (
/turf/open/floor/plating/ground/mars/random/cave/rock,
/area/bigredv3/caves/northeast/garbledradio)
"y" = (
/turf/open/floor/plating/ground/mars/random/cave,
/area/bigredv3/caves/east/garbledradio)
"I" = (
/turf/open/floor/plating/ground/mars/random/cave/rock,
/area/bigredv3/caves/east/garbledradio)
"M" = (
/turf/closed/mineral/smooth/bigred,
/area/bigredv3/caves/rock)
"P" = (
/turf/open/floor/plating/ground/mars/random/cave,
/area/bigredv3/caves/northeast/garbledradio)

(1,1,1) = {"
M
M
M
M
M
M
M
M
M
M
M
"}
(2,1,1) = {"
M
M
I
I
M
M
M
M
M
M
M
"}
(3,1,1) = {"
M
I
y
y
I
I
I
M
M
M
M
"}
(4,1,1) = {"
M
d
y
y
y
y
y
n
M
M
M
"}
(5,1,1) = {"
w
y
y
y
y
y
y
I
M
M
M
"}
(6,1,1) = {"
P
y
y
y
y
y
y
I
y
M
M
"}
(7,1,1) = {"
P
y
y
y
y
y
y
y
I
I
I
"}
(8,1,1) = {"
P
d
y
y
y
y
y
d
y
d
p
"}
(9,1,1) = {"
P
y
y
y
y
y
y
y
y
p
d
"}
(10,1,1) = {"
P
y
y
y
M
M
y
I
y
p
y
"}
(11,1,1) = {"
P
d
y
M
M
M
y
p
p
y
y
"}
(12,1,1) = {"
P
y
M
M
M
M
b
I
y
y
y
"}
(13,1,1) = {"
P
M
M
M
M
b
M
M
M
M
M
"}
(14,1,1) = {"
M
M
M
M
M
b
M
M
M
M
M
"}
(15,1,1) = {"
M
M
M
M
M
b
M
M
M
M
M
"}
(16,1,1) = {"
M
M
M
M
M
b
M
M
M
M
M
"}
(17,1,1) = {"
M
M
M
M
M
b
M
M
M
M
M
"}
(18,1,1) = {"
M
M
M
M
M
b
M
M
M
M
M
"}
(19,1,1) = {"
M
M
M
M
M
b
M
M
M
M
M
"}
(20,1,1) = {"
M
M
M
M
M
b
M
M
M
M
M
"}
(21,1,1) = {"
M
M
M
M
M
b
M
M
M
M
M
"}
(22,1,1) = {"
b
b
b
b
b
M
M
M
M
M
M
"}
