//MAP CONVERTED BY dmm2tgm.py THIS HEADER COMMENT PREVENTS RECONVERSION, DO NOT REMOVE
"as" = (
/obj/structure/window/framed/colony,
/obj/machinery/door/poddoor/shutters/mainship{
	dir = 2;
	id = "Dormitories";
	name = "\improper Dormitories Shutters"
	},
/turf/open/floor/plating,
/area/bigredv2/outside/general_offices)
"aE" = (
/obj/structure/bed,
/turf/open/floor/wood,
/area/bigredv2/outside/general_offices)
"bd" = (
/obj/effect/ai_node,
/turf/open/floor/plating/ground/mars/random/sand,
/area/bigredv2/outside/ne)
"bw" = (
/obj/structure/table,
/obj/item/paper/hydroponics,
/turf/open/floor,
/area/bigredv2/outside/hydroponics)
"ca" = (
/obj/machinery/atmospherics/components/unary/vent_pump{
	dir = 8;
	on = 1
	},
/obj/effect/spawner/random/clothing/general,
/turf/open/floor/wood,
/area/bigredv2/outside/general_offices)
"ck" = (
/obj/machinery/vending/snack,
/turf/open/floor,
/area/bigredv2/outside/general_offices)
"cH" = (
/obj/effect/spawner/random/misc/trash,
/obj/machinery/light{
	dir = 8
	},
/turf/open/floor,
/area/bigredv2/outside/general_offices)
"dU" = (
/obj/machinery/washing_machine,
/turf/open/floor/freezer,
/area/bigredv2/outside/general_offices)
"fe" = (
/obj/structure/cable,
/obj/machinery/atmospherics/pipe/simple/green/hidden,
/turf/open/floor/asteroidfloor,
/area/bigredv2/outside/ne)
"fo" = (
/obj/structure/cable,
/obj/machinery/atmospherics/pipe/simple/green/hidden{
	dir = 4
	},
/turf/open/floor/asteroidfloor,
/area/bigredv2/outside/ne)
"fq" = (
/obj/structure/table,
/obj/effect/decal/cleanable/dirt,
/obj/effect/spawner/random/food_or_drink/kitchen,
/turf/open/floor/wood,
/area/bigredv2/outside/general_offices)
"fW" = (
/turf/open/floor/plating/ground/mars/random/sand,
/area/bigredv2/caves/northeast/garbledradio)
"gm" = (
/obj/machinery/light,
/obj/effect/decal/cleanable/dirt,
/obj/structure/cable,
/turf/open/floor,
/area/bigredv2/outside/general_offices)
"hc" = (
/obj/effect/ai_node,
/obj/structure/cable,
/turf/open/floor,
/area/bigredv2/outside/general_offices)
"ih" = (
/obj/machinery/light{
	dir = 8
	},
/turf/open/floor/plating,
/area/bigredv2/outside/general_offices)
"ir" = (
/obj/machinery/light{
	dir = 1
	},
/obj/effect/decal/cleanable/dirt,
/turf/open/floor,
/area/bigredv2/outside/general_offices)
"iw" = (
/obj/machinery/atmospherics/pipe/manifold/green/hidden,
/turf/open/floor,
/area/bigredv2/outside/general_offices)
"iD" = (
/obj/structure/table,
/obj/structure/bedsheetbin,
/turf/open/floor/freezer,
/area/bigredv2/outside/general_offices)
"iP" = (
/obj/structure/table,
/obj/item/paper,
/obj/item/paper,
/obj/item/tool/pen/invisible,
/turf/open/floor/wood,
/area/bigredv2/outside/general_offices)
"iV" = (
/obj/structure/table,
/turf/open/floor,
/area/bigredv2/outside/hydroponics)
"jq" = (
/obj/structure/closet/toolcloset,
/turf/open/floor,
/area/bigredv2/outside/general_offices)
"jZ" = (
/obj/machinery/atmospherics/pipe/simple/green/hidden{
	dir = 4
	},
/obj/structure/cable,
/turf/open/floor/plating,
/area/bigredv2/outside/bar)
"ko" = (
/obj/item/clothing/under/darkred,
/turf/open/floor/freezer,
/area/bigredv2/outside/general_offices)
"lb" = (
/turf/open/floor/asteroidfloor,
/area/bigredv2/outside/general_offices)
"lf" = (
/obj/effect/landmark/lv624/fog_blocker,
/turf/open/floor/plating/ground/mars/random/sand,
/area/bigredv2/caves/northeast/garbledradio)
"lo" = (
/obj/machinery/washing_machine,
/obj/item/clothing/under/darkred,
/turf/open/floor/freezer,
/area/bigredv2/outside/general_offices)
"lC" = (
/obj/effect/ai_node,
/turf/open/floor/plating/ground/mars/random/dirt,
/area/bigredv2/caves/northeast/garbledradio)
"mm" = (
/obj/machinery/atmospherics/pipe/manifold/green/hidden{
	dir = 4
	},
/turf/open/floor,
/area/bigredv2/outside/general_offices)
"mq" = (
/obj/machinery/light{
	dir = 1
	},
/turf/open/floor/plating,
/area/bigredv2/outside/bar)
"nj" = (
/obj/machinery/atmospherics/pipe/simple/green/hidden{
	dir = 4
	},
/turf/open/floor/wood,
/area/bigredv2/outside/general_offices)
"nx" = (
/turf/open/floor/marking/asteroidwarning,
/area/bigredv2/outside/ne)
"nP" = (
/obj/structure/cable,
/turf/open/floor/plating,
/area/bigredv2/outside/general_offices)
"ph" = (
/turf/closed/wall/r_wall,
/area/bigredv2/outside/general_offices)
"pp" = (
/obj/machinery/atmospherics/pipe/manifold4w/green/hidden,
/obj/effect/decal/cleanable/blood/oil,
/turf/open/floor,
/area/bigredv2/outside/general_offices)
"ps" = (
/obj/machinery/atmospherics/pipe/manifold4w/green/hidden,
/turf/open/floor,
/area/bigredv2/outside/general_offices)
"pP" = (
/obj/machinery/light{
	dir = 1
	},
/turf/open/floor,
/area/bigredv2/outside/general_offices)
"pU" = (
/obj/machinery/vending/hydronutrients,
/turf/open/floor,
/area/bigredv2/outside/hydroponics)
"qk" = (
/obj/machinery/light{
	dir = 8
	},
/obj/structure/cable,
/obj/machinery/atmospherics/pipe/simple/green/hidden,
/turf/open/floor/asteroidfloor,
/area/bigredv2/outside/general_offices)
"qr" = (
/obj/item/clothing/under/brown,
/turf/open/floor/freezer,
/area/bigredv2/outside/general_offices)
"qt" = (
/turf/open/floor/marking/asteroidwarning{
	dir = 4
	},
/area/bigredv2/outside/ne)
"qB" = (
/obj/machinery/vending/hydroseeds,
/turf/open/floor,
/area/bigredv2/outside/hydroponics)
"qG" = (
/obj/structure/rack,
/obj/effect/spawner/random/engineering/toolbox,
/turf/open/floor,
/area/bigredv2/outside/general_offices)
"qM" = (
/obj/machinery/atmospherics/pipe/simple/green/hidden{
	dir = 4
	},
/turf/open/floor/freezer,
/area/bigredv2/outside/general_offices)
"qX" = (
/obj/structure/bed/chair{
	dir = 1
	},
/turf/open/floor,
/area/bigredv2/outside/general_offices)
"rD" = (
/turf/closed/wall,
/area/bigredv2/outside/hydroponics)
"rT" = (
/turf/open/floor/plating/ground/mars/random/sand,
/area/bigredv2/outside/ne)
"rZ" = (
/obj/machinery/computer/intel_computer,
/turf/open/floor,
/area/bigredv2/outside/general_offices)
"sa" = (
/turf/open/floor/plating,
/area/bigredv2/outside/general_offices)
"sB" = (
/turf/closed/wall,
/area/bigredv2/outside/bar)
"sR" = (
/obj/effect/decal/cleanable/dirt,
/turf/open/floor/marking/asteroidwarning{
	dir = 1
	},
/area/bigredv2/outside/general_offices)
"te" = (
/turf/open/floor,
/area/bigredv2/outside/general_offices)
"tp" = (
/obj/machinery/atmospherics/pipe/simple/green/hidden{
	dir = 4
	},
/obj/structure/cable,
/turf/open/floor,
/area/bigredv2/outside/general_offices)
"tZ" = (
/obj/machinery/atmospherics/pipe/simple/green/hidden{
	dir = 9
	},
/turf/open/floor,
/area/bigredv2/outside/general_offices)
"ul" = (
/obj/structure/rack,
/obj/effect/spawner/random/engineering/tool,
/obj/effect/spawner/random/engineering/tool,
/turf/open/floor,
/area/bigredv2/outside/general_offices)
"um" = (
/obj/structure/table,
/turf/open/floor/wood,
/area/bigredv2/outside/general_offices)
"us" = (
/obj/machinery/atmospherics/pipe/manifold/green/hidden{
	dir = 4
	},
/obj/structure/cable,
/obj/effect/ai_node,
/turf/open/floor/asteroidfloor,
/area/bigredv2/outside/ne)
"uL" = (
/turf/open/floor/wood,
/area/bigredv2/outside/general_offices)
"uU" = (
/obj/effect/decal/cleanable/dirt,
/turf/open/floor/wood,
/area/bigredv2/outside/general_offices)
"uX" = (
/obj/effect/decal/cleanable/dirt,
/obj/effect/decal/cleanable/dirt,
/turf/open/floor/asteroidfloor,
/area/bigredv2/outside/general_offices)
"va" = (
/obj/structure/bed/chair{
	dir = 8
	},
/turf/open/floor,
/area/bigredv2/outside/general_offices)
"vP" = (
/obj/structure/closet/secure_closet/personal/cabinet,
/obj/effect/spawner/random/clothing/general,
/obj/machinery/light/small{
	dir = 4
	},
/turf/open/floor/wood,
/area/bigredv2/outside/general_offices)
"wi" = (
/obj/machinery/light{
	dir = 8
	},
/turf/open/floor,
/area/bigredv2/outside/general_offices)
"wA" = (
/turf/open/floor/freezer,
/area/bigredv2/outside/general_offices)
"wB" = (
/turf/open/floor/plating/ground/mars/random/sand,
/area/bigredv2/outside/n)
"wH" = (
/obj/machinery/atmospherics/pipe/simple/green/hidden,
/obj/effect/decal/cleanable/dirt,
/turf/open/floor,
/area/bigredv2/outside/general_offices)
"xj" = (
/obj/machinery/door/airlock/multi_tile/mainship/generic{
	name = "\improper Dormitories Tool Storage"
	},
/turf/open/floor,
/area/bigredv2/outside/general_offices)
"xs" = (
/obj/machinery/atmospherics/pipe/simple/green/hidden,
/obj/structure/cable,
/turf/open/floor/tile/green/whitegreenfull,
/area/bigredv2/outside/hydroponics)
"xt" = (
/obj/structure/cable,
/obj/machinery/atmospherics/pipe/simple/green/hidden{
	dir = 4
	},
/obj/effect/decal/cleanable/dirt,
/turf/open/floor/asteroidfloor,
/area/bigredv2/outside/ne)
"ye" = (
/obj/machinery/atmospherics/pipe/simple/green/hidden{
	dir = 4
	},
/obj/item/paper/crumpled/bloody,
/turf/open/floor/wood,
/area/bigredv2/outside/general_offices)
"yn" = (
/obj/structure/table,
/obj/effect/decal/cleanable/dirt,
/turf/open/floor/wood,
/area/bigredv2/outside/general_offices)
"yG" = (
/obj/effect/landmark/lv624/fog_blocker,
/turf/closed/mineral/smooth/bigred,
/area/bigredv2/caves/rock)
"yS" = (
/turf/closed/mineral/smooth/bigred,
/area/bigredv2/caves/rock)
"zO" = (
/obj/effect/spawner/random/clothing/general,
/obj/effect/decal/cleanable/dirt,
/obj/structure/bed/chair/wood{
	dir = 4
	},
/turf/open/floor/wood,
/area/bigredv2/outside/general_offices)
"zY" = (
/obj/machinery/vending/tool,
/turf/open/floor,
/area/bigredv2/outside/general_offices)
"AS" = (
/obj/structure/cable,
/obj/machinery/atmospherics/pipe/simple/green/hidden{
	dir = 4
	},
/obj/machinery/door/airlock/mainship/maint/free_access{
	name = "\improper Bar Maintenance"
	},
/turf/open/floor/plating,
/area/bigredv2/outside/bar)
"Bh" = (
/obj/structure/bed,
/obj/effect/spawner/random/clothing/general,
/turf/open/floor/wood,
/area/bigredv2/outside/general_offices)
"Bk" = (
/obj/structure/window/framed/colony,
/obj/machinery/door/poddoor/shutters/mainship{
	dir = 2;
	id = "Greenhouse";
	name = "\improper Greenhouse Shutters"
	},
/turf/open/floor/plating,
/area/bigredv2/outside/hydroponics)
"Bq" = (
/obj/effect/ai_node,
/turf/open/floor,
/area/bigredv2/outside/general_offices)
"BD" = (
/obj/structure/table,
/obj/effect/spawner/random/engineering/toolbox,
/obj/machinery/atmospherics/components/unary/vent_pump,
/turf/open/floor,
/area/bigredv2/outside/general_offices)
"BK" = (
/obj/effect/decal/cleanable/dirt,
/obj/structure/cable,
/turf/open/floor,
/area/bigredv2/outside/general_offices)
"Cd" = (
/obj/effect/decal/cleanable/dirt,
/obj/machinery/atmospherics/pipe/simple/green/hidden{
	dir = 6
	},
/obj/effect/ai_node,
/turf/open/floor,
/area/bigredv2/outside/general_offices)
"CD" = (
/obj/machinery/door/airlock/mainship/medical/glass/free_access{
	name = "\improper Dormitories Lavatory"
	},
/obj/machinery/atmospherics/pipe/simple/green/hidden{
	dir = 4
	},
/turf/open/floor/freezer,
/area/bigredv2/outside/general_offices)
"CI" = (
/obj/effect/landmark/excavation_site_spawner,
/turf/open/floor,
/area/bigredv2/outside/general_offices)
"CJ" = (
/obj/machinery/vending/engivend,
/turf/open/floor,
/area/bigredv2/outside/general_offices)
"Dr" = (
/obj/structure/cable,
/obj/machinery/atmospherics/pipe/simple/green/hidden,
/turf/open/floor/asteroidfloor,
/area/bigredv2/outside/general_offices)
"Dw" = (
/turf/open/floor/plating/ground/mars/random/sand,
/area/bigredv2/outside/general_offices)
"DX" = (
/obj/machinery/door/airlock/mainship/maint/free_access{
	dir = 1;
	name = "\improper Dormitories Tool Storage Maintenance"
	},
/obj/structure/cable,
/turf/open/floor/plating,
/area/bigredv2/outside/general_offices)
"Ef" = (
/obj/machinery/atmospherics/components/unary/vent_pump{
	dir = 8;
	on = 1
	},
/obj/effect/ai_node,
/turf/open/floor/freezer,
/area/bigredv2/outside/general_offices)
"Ex" = (
/turf/open/floor/plating,
/area/bigredv2/outside/bar)
"Ey" = (
/turf/open/floor/plating/ground/mars/random/dirt,
/area/bigredv2/outside/ne)
"EF" = (
/obj/structure/cable,
/turf/open/floor,
/area/bigredv2/outside/general_offices)
"EP" = (
/obj/effect/decal/cleanable/dirt,
/turf/open/floor/asteroidfloor,
/area/bigredv2/outside/general_offices)
"EU" = (
/turf/open/floor/plating/ground/mars/dirttosand/autosmooth{
	dir = 8
	},
/area/bigredv2/caves/northeast/garbledradio)
"FO" = (
/obj/effect/decal/cleanable/dirt,
/obj/machinery/atmospherics/pipe/simple/green/hidden{
	dir = 9
	},
/turf/open/floor,
/area/bigredv2/outside/general_offices)
"Gb" = (
/obj/machinery/atmospherics/pipe/simple/green/hidden{
	dir = 9
	},
/obj/structure/cable,
/obj/effect/ai_node,
/turf/open/floor,
/area/bigredv2/outside/general_offices)
"Go" = (
/turf/open/floor/plating/ground/mars/dirttosand/autosmooth{
	dir = 10
	},
/area/bigredv2/outside/ne)
"GG" = (
/obj/machinery/atmospherics/pipe/manifold/green/hidden{
	dir = 1
	},
/turf/open/floor,
/area/bigredv2/outside/general_offices)
"GV" = (
/obj/structure/closet/secure_closet/personal/cabinet,
/obj/machinery/light/small{
	dir = 4
	},
/turf/open/floor/wood,
/area/bigredv2/outside/general_offices)
"Hh" = (
/obj/machinery/vending/cola,
/turf/open/floor,
/area/bigredv2/outside/general_offices)
"Hm" = (
/obj/structure/window/framed/colony,
/turf/open/floor/plating,
/area/bigredv2/outside/hydroponics)
"Hw" = (
/obj/machinery/door/airlock/mainship/generic{
	dir = 1;
	name = "\improper Dormitories Bedroom"
	},
/turf/open/floor/wood,
/area/bigredv2/outside/general_offices)
"HK" = (
/obj/structure/cable,
/obj/machinery/atmospherics/pipe/simple/green/hidden{
	dir = 4
	},
/obj/effect/ai_node,
/turf/open/floor/asteroidfloor,
/area/bigredv2/outside/ne)
"HV" = (
/obj/structure/cable,
/obj/machinery/atmospherics/pipe/simple/green/hidden,
/obj/machinery/door/airlock/multi_tile/mainship/generic{
	name = "\improper Dormitories"
	},
/turf/open/floor,
/area/bigredv2/outside/general_offices)
"HX" = (
/obj/machinery/washing_machine,
/obj/machinery/light,
/turf/open/floor/freezer,
/area/bigredv2/outside/general_offices)
"Kt" = (
/obj/effect/decal/cleanable/blood/oil,
/turf/open/floor,
/area/bigredv2/outside/general_offices)
"Kz" = (
/obj/machinery/hydroponics,
/turf/open/floor/tile/green/whitegreenfull,
/area/bigredv2/outside/hydroponics)
"KI" = (
/obj/effect/decal/cleanable/dirt,
/obj/machinery/atmospherics/pipe/simple/green/hidden,
/turf/open/floor,
/area/bigredv2/outside/general_offices)
"Lm" = (
/obj/machinery/light{
	dir = 8
	},
/turf/open/floor/wood,
/area/bigredv2/outside/general_offices)
"Lo" = (
/obj/structure/closet/secure_closet/personal/cabinet,
/obj/effect/spawner/random/clothing/hats,
/obj/machinery/light/small{
	dir = 4
	},
/turf/open/floor/wood,
/area/bigredv2/outside/general_offices)
"Lp" = (
/turf/closed/wall,
/area/bigredv2/outside/general_offices)
"Lu" = (
/obj/structure/bed/fancy,
/turf/open/floor/wood,
/area/bigredv2/outside/general_offices)
"LV" = (
/obj/docking_port/stationary/crashmode,
/turf/open/floor,
/area/bigredv2/outside/general_offices)
"Mj" = (
/turf/open/floor,
/area/bigredv2/outside/hydroponics)
"Ms" = (
/obj/machinery/atmospherics/pipe/simple/green/hidden{
	dir = 4
	},
/obj/effect/decal/cleanable/dirt,
/turf/open/floor,
/area/bigredv2/outside/general_offices)
"ME" = (
/obj/machinery/atmospherics/pipe/simple/green/hidden,
/obj/structure/cable,
/obj/machinery/door/airlock/mainship/medical/glass/free_access{
	dir = 1;
	name = "\improper Greenhouse"
	},
/turf/open/floor,
/area/bigredv2/outside/hydroponics)
"MJ" = (
/obj/machinery/atmospherics/components/unary/vent_pump{
	dir = 4;
	on = 1
	},
/obj/effect/decal/cleanable/dirt,
/turf/open/floor/wood,
/area/bigredv2/outside/general_offices)
"Nf" = (
/obj/machinery/atmospherics/pipe/manifold/green/hidden,
/obj/effect/ai_node,
/obj/structure/cable,
/turf/open/floor,
/area/bigredv2/outside/general_offices)
"ND" = (
/obj/effect/decal/cleanable/blood/oil,
/obj/machinery/light{
	dir = 4
	},
/turf/open/floor,
/area/bigredv2/outside/general_offices)
"Oj" = (
/obj/machinery/door/airlock/mainship/generic{
	name = "\improper Dormitories Bedroom"
	},

/obj/machinery/atmospherics/pipe/simple/green/hidden{
	dir = 4
	},
/turf/open/floor,
/area/bigredv2/outside/general_offices)
"Oy" = (
/obj/structure/table,
/obj/effect/spawner/random/clothing/general,
/turf/open/floor/wood,
/area/bigredv2/outside/general_offices)
"OG" = (
/obj/structure/cable,
/obj/effect/ai_node,
/turf/open/floor/plating,
/area/bigredv2/outside/general_offices)
"OP" = (
/obj/structure/table,
/obj/effect/spawner/random/engineering/technology_scanner,
/obj/effect/spawner/random/engineering/technology_scanner,
/turf/open/floor,
/area/bigredv2/outside/general_offices)
"Pq" = (
/obj/machinery/atmospherics/pipe/simple/green/hidden{
	dir = 4
	},
/turf/open/floor,
/area/bigredv2/outside/general_offices)
"Ps" = (
/turf/open/floor/marking/asteroidwarning{
	dir = 9
	},
/area/bigredv2/outside/general_offices)
"Pw" = (
/obj/machinery/atmospherics/components/unary/vent_pump{
	dir = 4;
	on = 1
	},
/turf/open/floor/wood,
/area/bigredv2/outside/general_offices)
"PA" = (
/obj/machinery/light,
/turf/open/floor,
/area/bigredv2/outside/general_offices)
"Qs" = (
/obj/structure/table,
/turf/open/floor,
/area/bigredv2/outside/general_offices)
"QL" = (
/obj/machinery/door/airlock/mainship/generic{
	name = "\improper Dormitories Bedroom"
	},
/obj/machinery/atmospherics/pipe/simple/green/hidden{
	dir = 4
	},
/turf/open/floor,
/area/bigredv2/outside/general_offices)
"QQ" = (
/obj/machinery/atmospherics/pipe/simple/green/hidden{
	dir = 6
	},
/turf/open/floor,
/area/bigredv2/outside/general_offices)
"Rq" = (
/obj/effect/decal/cleanable/dirt,
/obj/machinery/atmospherics/pipe/simple/green/hidden,
/obj/structure/cable,
/turf/open/floor,
/area/bigredv2/outside/general_offices)
"RA" = (
/obj/structure/bed/fancy,
/obj/effect/spawner/random/clothing/general,
/obj/effect/spawner/random/clothing/hats,
/turf/open/floor/wood,
/area/bigredv2/outside/general_offices)
"Sd" = (
/obj/machinery/atmospherics/pipe/simple/green/hidden,
/turf/open/floor,
/area/bigredv2/outside/general_offices)
"Sj" = (
/obj/effect/ai_node,
/turf/open/floor/plating/ground/mars/random/sand,
/area/bigredv2/caves/northeast/garbledradio)
"St" = (
/obj/machinery/power/apc/high/ntf{
	dir = 4
	},
/obj/structure/cable,
/turf/open/floor/plating,
/area/bigredv2/outside/general_offices)
"SG" = (
/obj/structure/table,
/obj/effect/spawner/random/engineering/toolbox,
/obj/item/stack/cable_coil,
/turf/open/floor,
/area/bigredv2/outside/general_offices)
"SH" = (
/obj/machinery/atmospherics/pipe/simple/green/hidden{
	dir = 4
	},
/obj/effect/decal/cleanable/blood/oil,
/turf/open/floor,
/area/bigredv2/outside/general_offices)
"SP" = (
/obj/item/clothing/under/lightbrown,
/turf/open/floor/freezer,
/area/bigredv2/outside/general_offices)
"SU" = (
/obj/structure/table,
/obj/item/tool/shovel/spade,
/turf/open/floor,
/area/bigredv2/outside/hydroponics)
"SV" = (
/turf/open/floor/marking/asteroidwarning{
	dir = 1
	},
/area/bigredv2/outside/general_offices)
"TI" = (
/turf/open/floor/plating/ground/mars/random/dirt,
/area/bigredv2/caves/northeast/garbledradio)
"Ub" = (
/obj/structure/window/framed/colony,
/obj/machinery/door/poddoor/shutters/mainship{
	id = "Greenhouse";
	name = "\improper Greenhouse Shutters"
	},
/turf/open/floor/plating,
/area/bigredv2/outside/hydroponics)
"Uf" = (
/obj/machinery/washing_machine,
/obj/item/clothing/under/brown,
/turf/open/floor/freezer,
/area/bigredv2/outside/general_offices)
"Ug" = (
/obj/machinery/washing_machine,
/obj/item/clothing/under/lightbrown,
/turf/open/floor/freezer,
/area/bigredv2/outside/general_offices)
"Uy" = (
/obj/machinery/vending/cigarette/colony,
/turf/open/floor,
/area/bigredv2/outside/general_offices)
"UK" = (
/obj/effect/decal/cleanable/dirt,
/turf/open/floor,
/area/bigredv2/outside/general_offices)
"US" = (
/obj/structure/table,
/obj/effect/spawner/random/food_or_drink/drink_alcohol_bottle,
/turf/open/floor/wood,
/area/bigredv2/outside/general_offices)
"Vo" = (
/obj/machinery/atmospherics/components/unary/vent_pump{
	dir = 8;
	on = 1
	},
/turf/open/floor/wood,
/area/bigredv2/outside/general_offices)
"VW" = (
/obj/machinery/light{
	dir = 4
	},
/turf/open/floor,
/area/bigredv2/outside/general_offices)
"Wm" = (
/obj/effect/decal/cleanable/dirt,
/obj/effect/landmark/excavation_site_spawner,
/turf/open/floor,
/area/bigredv2/outside/general_offices)
"Wn" = (
/obj/structure/table,
/obj/item/flashlight/lamp/green,
/turf/open/floor/wood,
/area/bigredv2/outside/general_offices)
"Xv" = (
/obj/structure/bed,
/obj/effect/decal/cleanable/dirt,
/obj/effect/spawner/random/food_or_drink/outdoors_snacks,
/turf/open/floor/wood,
/area/bigredv2/outside/general_offices)
"Xy" = (
/obj/machinery/door/airlock/mainship/maint/free_access{
	dir = 1;
	name = "\improper Dormitories Tool Storage Maintenance"
	},
/turf/open/floor/plating,
/area/bigredv2/outside/general_offices)
"Xz" = (
/turf/open/floor/plating/ground/mars/dirttosand/autosmooth,
/area/bigredv2/outside/ne)
"XF" = (
/obj/machinery/atmospherics/components/unary/vent_pump{
	dir = 4;
	on = 1
	},
/obj/effect/spawner/random/clothing/general,
/obj/effect/decal/cleanable/dirt,
/turf/open/floor/wood,
/area/bigredv2/outside/general_offices)
"XZ" = (
/obj/structure/sign/safety/EVA{
	dir = 1
	},
/turf/open/floor,
/area/bigredv2/outside/general_offices)
"Yn" = (
/obj/effect/ai_node,
/turf/open/floor/marking/asteroidwarning{
	dir = 6
	},
/area/bigredv2/outside/ne)
"YL" = (
/obj/structure/closet/secure_closet/personal/cabinet,
/obj/machinery/light/small{
	dir = 8
	},
/turf/open/floor/wood,
/area/bigredv2/outside/general_offices)
"YO" = (
/obj/machinery/atmospherics/pipe/simple/green/hidden,
/obj/structure/cable,
/turf/open/floor,
/area/bigredv2/outside/general_offices)
"YX" = (
/obj/structure/rack,
/obj/effect/spawner/random/engineering/tool,
/obj/effect/spawner/random/engineering/tool,
/obj/effect/spawner/random/engineering/tool,
/turf/open/floor,
/area/bigredv2/outside/general_offices)
"Zd" = (
/obj/machinery/atmospherics/pipe/manifold/green/hidden{
	dir = 1
	},
/obj/structure/cable,
/obj/effect/ai_node,
/turf/open/floor,
/area/bigredv2/outside/general_offices)
"Zy" = (
/obj/machinery/washing_machine,
/obj/item/clothing/under/lightred,
/turf/open/floor/freezer,
/area/bigredv2/outside/general_offices)

(1,1,1) = {"
wB
wB
as
te
te
QQ
Sd
mm
Sd
Sd
Sd
Sd
Sd
Sd
iw
te
te
qX
sB
mq
jZ
Ex
Ex
sB
"}
(2,1,1) = {"
wB
wB
Lp
Lp
Lp
CD
Lp
Lp
Lp
Lp
Lp
Lp
Lp
pP
Pq
te
va
Qs
sB
Ex
jZ
Ex
Ex
sB
"}
(3,1,1) = {"
wB
wB
Lp
lo
wA
qM
wA
Ug
Lp
YX
ul
ul
Lp
te
Pq
te
Lp
Lp
sB
sB
AS
sB
sB
sB
"}
(4,1,1) = {"
wB
wB
Lp
dU
wA
qM
wA
dU
Lp
pP
UK
te
Lp
UK
Pq
te
Hw
uL
Lm
Lp
xt
nx
Ey
sB
"}
(5,1,1) = {"
wB
wB
Lp
dU
wA
qM
wA
Uf
Lp
te
UK
te
Lp
UK
Pq
te
Lp
um
aE
Lp
xt
nx
Ey
sB
"}
(6,1,1) = {"
wB
wB
Lp
dU
ko
Ef
wA
HX
Lp
CJ
UK
te
Lp
UK
Pq
PA
Lp
Lp
Lp
Lp
xt
nx
Ey
sB
"}
(7,1,1) = {"
yS
yS
Lp
dU
wA
iD
qr
dU
Lp
zY
te
te
xj
LV
Pq
te
Hw
uL
Lm
Lp
xt
nx
Ey
sB
"}
(8,1,1) = {"
yG
yS
Lp
Uf
SP
iD
wA
dU
Lp
SG
Cd
Rq
YO
YO
Nf
te
Lp
um
aE
Lp
fo
nx
Xz
rT
"}
(9,1,1) = {"
yS
yG
Lp
dU
wA
wA
wA
Zy
Lp
BD
FO
BK
Lp
CI
tp
te
Lp
Lp
Lp
Lp
HK
nx
Ey
Go
"}
(10,1,1) = {"
yS
yG
Lp
Lp
Lp
Lp
Lp
Lp
Lp
jq
UK
gm
Lp
Wm
tp
te
Hw
uL
Lm
Lp
xt
nx
Ey
Xz
"}
(11,1,1) = {"
fW
lf
Dw
Lp
St
ih
sa
sa
Lp
jq
UK
BK
Lp
UK
tp
te
Lp
um
aE
Lp
xt
nx
rD
Ub
"}
(12,1,1) = {"
Sj
lf
Dw
Xy
OG
nP
nP
nP
DX
EF
hc
EF
Lp
UK
tp
PA
Lp
Lp
Lp
Lp
fo
nx
Bk
Kz
"}
(13,1,1) = {"
fW
lf
Ps
Lp
Lp
Lp
Lp
Lp
Lp
Lp
Lp
Lp
Lp
ir
Zd
YO
HV
Dr
qk
Dr
us
fe
ME
xs
"}
(14,1,1) = {"
fW
lf
sR
Lp
YL
RA
Lp
YL
Lu
Lp
YL
Lu
Lp
te
tp
Bq
te
lb
lb
EP
qt
Yn
Bk
Kz
"}
(15,1,1) = {"
fW
lf
sR
Lp
uL
MJ
Lp
zO
Pw
Lp
uL
XF
Lp
XZ
tp
te
Lp
Lp
Lp
Lp
rT
rT
Bk
Kz
"}
(16,1,1) = {"
fW
lf
SV
Lp
Oy
nj
Lp
Wn
nj
Lp
fq
nj
Lp
te
tp
te
Hw
uL
Lm
Lp
rT
rT
Bk
Kz
"}
(17,1,1) = {"
EU
yG
EP
Lp
Lp
QL
Lp
Lp
QL
Lp
Lp
QL
Lp
te
Gb
te
Lp
um
aE
Lp
rT
rT
Bk
Kz
"}
(18,1,1) = {"
TI
yG
EP
Lp
rZ
Pq
cH
UK
Pq
wi
UK
SH
wi
UK
Pq
Kt
Lp
Lp
Lp
Lp
rT
rT
Bk
Kz
"}
(19,1,1) = {"
TI
yG
EP
Lp
qG
GG
wH
wH
pp
wH
Sd
ps
wH
KI
tZ
te
Hw
uL
Lm
Lp
rT
rT
Bk
Kz
"}
(20,1,1) = {"
lC
yG
lb
Lp
OP
Ms
ND
UK
Pq
VW
UK
Pq
VW
te
te
PA
Lp
um
aE
Lp
rT
rT
rD
Hm
"}
(21,1,1) = {"
TI
yG
lb
ph
Lp
QL
Lp
Lp
Oj
Lp
Lp
QL
ph
UK
te
te
Lp
Lp
Lp
Lp
rT
bd
rD
pU
"}
(22,1,1) = {"
yS
yG
lb
ph
iP
nj
Lp
yn
ye
Lp
US
nj
ph
UK
te
te
Lp
yS
rT
rT
rT
rT
rD
qB
"}
(23,1,1) = {"
yS
yG
EP
ph
uU
Vo
Lp
uL
Vo
Lp
uL
ca
ph
UK
Kt
te
Lp
yS
rT
rT
rT
rT
rD
iV
"}
(24,1,1) = {"
yS
yG
lb
ph
vP
aE
Lp
GV
Bh
Lp
Lo
Xv
ph
UK
te
te
Lp
yS
yS
rT
rT
rT
rD
SU
"}
(25,1,1) = {"
yS
yG
EP
ph
ph
ph
ph
ph
ph
ph
ph
ph
ph
pP
te
te
Lp
yS
yS
rT
rT
rT
rD
bw
"}
(26,1,1) = {"
yS
yG
lb
EP
lb
EP
lb
lb
EP
uX
EP
lb
ph
Hh
Uy
ck
Lp
yS
yS
rT
rT
rT
rD
Mj
"}
