//MAP CONVERTED BY dmm2tgm.py THIS HEADER COMMENT PREVENTS RECONVERSION, DO NOT REMOVE
"ai" = (
/obj/structure/table,
/obj/item/tool/lighter/random,
/turf/open/floor,
/area/bigredv3/inside/engi/west)
"ap" = (
/obj/structure/table,
/obj/effect/spawner/random/engineering/toolbox,
/turf/open/floor,
/area/bigredv3/inside/engi/fabrication)
"bg" = (
/obj/effect/spawner/random/machinery/machine_frame,
/turf/open/floor,
/area/bigredv3/inside/engi/west)
"bp" = (
/obj/effect/decal/cleanable/dirt,
/obj/item/clothing/head/welding,
/turf/open/floor,
/area/bigredv3/inside/engi/west)
"bw" = (
/turf/open/floor,
/area/bigredv3/inside/engi/west)
"bJ" = (
/obj/effect/decal/cleanable/dirt,
/turf/open/floor,
/area/bigredv3/inside/engi/west)
"bQ" = (
/obj/structure/table,
/obj/item/tool/lighter/random,
/turf/open/floor,
/area/bigredv3/inside/engi/fabrication)
"bR" = (
/obj/structure/sign/safety/high_radiation,
/turf/open/floor,
/area/bigredv3/inside/engi/west)
"cw" = (
/obj/machinery/floodlight/outpost/bigred,
/turf/open/floor/plating/ground/mars/random/cave,
/area/bigredv3/caves/southwest)
"cG" = (
/obj/machinery/door/airlock/mainship/engineering/free_access{
	dir = 1;
	name = "\improper Engine Reactor Control"
	},
/obj/machinery/atmospherics/pipe/simple/green/hidden,
/turf/open/floor,
/area/bigredv3/inside/engi/power_plant)
"cL" = (
/obj/machinery/atmospherics/pipe/simple/green/hidden,
/obj/machinery/power/apc/weak/ntf{
	dir = 8
	},
/obj/structure/cable,
/turf/open/floor,
/area/bigredv3/inside/engi/west)
"cT" = (
/obj/machinery/vending/snack,
/turf/open/floor,
/area/bigredv3/inside/engi/west)
"da" = (
/obj/effect/decal/cleanable/blood/oil,
/turf/open/floor/plating,
/area/bigredv3/inside/engi/power_plant)
"db" = (
/obj/structure/bed/chair{
	dir = 8
	},
/turf/open/floor,
/area/bigredv3/inside/engi/west)
"ek" = (
/turf/open/floor/plating/ground/mars/random/cave/rock,
/area/bigredv3/outside/directions/s)
"fl" = (
/obj/machinery/atmospherics/components/unary/vent_pump,
/turf/open/floor,
/area/bigredv3/inside/engi/locker_room)
"fD" = (
/obj/machinery/atmospherics/pipe/simple/green/hidden{
	dir = 4
	},
/obj/structure/cable,
/turf/open/floor,
/area/bigredv3/inside/engi/west)
"fX" = (
/obj/machinery/atmospherics/pipe/simple/green/hidden,
/obj/structure/cable,
/turf/open/floor,
/area/bigredv3/inside/engi/west)
"gs" = (
/obj/machinery/atmospherics/pipe/simple/green/hidden,
/obj/machinery/door/airlock/mainship/engineering/free_access{
	dir = 1;
	name = "\improper Engineering Tool Storage"
	},
/obj/structure/cable,
/turf/open/floor,
/area/bigredv3/inside/engi/fabrication)
"hG" = (
/turf/open/floor/plating,
/area/bigredv3/inside/engi/power_plant)
"ik" = (
/obj/structure/sign/safety/hazard,
/turf/open/floor,
/area/bigredv3/inside/engi/west)
"iL" = (
/obj/effect/decal/cleanable/dirt,
/turf/open/floor,
/area/bigredv3/inside/engi/power_plant)
"iS" = (
/obj/machinery/computer/station_alert,
/obj/structure/table,
/turf/open/floor,
/area/bigredv3/inside/engi/power_plant)
"iY" = (
/obj/machinery/floodlight/outpost/bigred,
/turf/open/floor/plating/ground/mars/random/dirt,
/area/bigredv3/outside/directions/sw)
"jb" = (
/obj/machinery/atmospherics/pipe/simple/green/hidden{
	dir = 5
	},
/obj/effect/ai_node,
/obj/structure/cable,
/turf/open/floor,
/area/bigredv3/inside/engi/west)
"jn" = (
/obj/effect/ai_node,
/turf/open/floor/plating/ground/mars/cavetodirt{
	dir = 1
	},
/area/bigredv3/caves/southwest)
"jT" = (
/turf/open/floor/plating/ground/mars/random/cave/rock,
/area/bigredv3/caves/southwest)
"kf" = (
/turf/open/floor/plating/ground/mars/random/sand,
/area/bigredv3/outside/directions/central)
"ks" = (
/obj/structure/table,
/obj/effect/spawner/random/engineering/tool,
/obj/effect/spawner/random/engineering/technology_scanner,
/turf/open/floor,
/area/bigredv3/inside/engi/west)
"kZ" = (
/obj/effect/decal/cleanable/dirt,
/obj/effect/ai_node,
/turf/open/floor,
/area/bigredv3/inside/engi/west)
"lc" = (
/obj/effect/decal/cleanable/dirt,
/obj/machinery/door/airlock/multi_tile/mainship/generic{
	name = "\improper Engineering Complex"
	},
/turf/open/floor,
/area/bigredv3/inside/engi/west)
"lv" = (
/obj/machinery/light{
	dir = 8
	},
/turf/open/floor,
/area/bigredv3/inside/engi/fabrication)
"ly" = (
/obj/structure/closet/radiation,
/turf/open/floor,
/area/bigredv3/inside/engi/west)
"lE" = (
/obj/effect/landmark/start/job/survivor,
/obj/effect/landmark/start/latejoinsurvivor,
/turf/open/floor,
/area/bigredv3/inside/engi/west)
"lM" = (
/obj/machinery/atmospherics/pipe/simple/green/hidden,
/obj/structure/cable,
/turf/open/floor,
/area/bigredv3/inside/engi/fabrication)
"mo" = (
/obj/structure/table,
/obj/machinery/light,
/obj/effect/spawner/random/engineering/tool,
/turf/open/floor,
/area/bigredv3/inside/engi/west)
"mp" = (
/obj/machinery/floodlight/outpost/bigred,
/turf/open/floor/plating/ground/mars/random/sand,
/area/bigredv3/outside/directions/s)
"mW" = (
/obj/structure/table,
/obj/effect/decal/cleanable/dirt,
/obj/item/tool/pen,
/turf/open/floor,
/area/bigredv3/inside/engi/west)
"nf" = (
/obj/machinery/computer/area_atmos,
/turf/open/floor,
/area/bigredv3/inside/engi/west)
"nl" = (
/obj/effect/decal/cleanable/dirt,
/obj/item/clothing/mask/breath,
/turf/open/floor,
/area/bigredv3/inside/engi/west)
"nP" = (
/turf/closed/mineral/smooth/bigred,
/area/bigredv3/caves/rock)
"os" = (
/obj/effect/decal/cleanable/dirt,
/obj/machinery/door/airlock/mainship/secure/free_access{
	name = "\improper Engineering Secure Storage"
	},
/obj/structure/cable,
/turf/open/floor,
/area/bigredv3/inside/engi/fabrication)
"oI" = (
/obj/effect/spawner/random/engineering/structure/tank/waterweighted,
/obj/effect/decal/cleanable/dirt,
/obj/machinery/light{
	dir = 4
	},
/turf/open/floor,
/area/bigredv3/inside/engi/fabrication)
"pu" = (
/turf/closed/wall,
/area/bigredv3/inside/wall)
"pC" = (
/obj/structure/cable,
/turf/open/floor,
/area/bigredv3/inside/engi/fabrication)
"qe" = (
/obj/structure/table,
/obj/item/tool/lighter/random,
/obj/item/lightreplacer,
/turf/open/floor,
/area/bigredv3/inside/engi/west)
"qg" = (
/obj/structure/closet/radiation,
/turf/open/floor,
/area/bigredv3/inside/engi/power_plant)
"qm" = (
/turf/open/floor,
/area/bigredv3/inside/engi/fabrication)
"qq" = (
/obj/machinery/atmospherics/pipe/manifold/green/hidden,
/obj/effect/ai_node,
/obj/structure/cable,
/turf/open/floor,
/area/bigredv3/inside/engi/west)
"qu" = (
/turf/open/floor/plating/ground/mars/dirttosand/autosmooth{
	dir = 1
	},
/area/bigredv3/outside/directions/s)
"qD" = (
/obj/machinery/atmospherics/pipe/simple/green/hidden,
/obj/machinery/door/airlock/mainship/engineering/free_access{
	dir = 1;
	name = "\improper Engineering Lockers"
	},
/obj/structure/cable,
/turf/open/floor,
/area/bigredv3/inside/engi/locker_room)
"qF" = (
/obj/effect/decal/cleanable/dirt,
/obj/item/lightreplacer,
/turf/open/floor,
/area/bigredv3/inside/engi/west)
"re" = (
/obj/effect/decal/cleanable/dirt,
/obj/effect/decal/cleanable/blood/oil,
/turf/open/floor,
/area/bigredv3/inside/engi/west)
"ru" = (
/obj/machinery/door/airlock/mainship/engineering/free_access{
	dir = 1;
	name = "\improper Engineering SMES"
	},
/turf/open/floor/plating,
/area/bigredv3/inside/engi/fabrication)
"sb" = (
/obj/effect/decal/cleanable/dirt,
/obj/machinery/atmospherics/pipe/simple/green/hidden,
/turf/open/floor,
/area/bigredv3/inside/engi/west)
"sk" = (
/obj/machinery/computer/arcade,
/turf/open/floor,
/area/bigredv3/inside/engi/west)
"sG" = (
/obj/machinery/light{
	dir = 8
	},
/turf/open/floor,
/area/bigredv3/inside/engi/power_plant)
"sH" = (
/turf/open/floor/plating/ground/mars/random/sand,
/area/bigredv3/outside/directions/sw)
"tJ" = (
/obj/machinery/atmospherics/pipe/simple/green/hidden,
/obj/structure/cable,
/turf/open/floor,
/area/bigredv3/inside/engi/ceo)
"tQ" = (
/obj/item/tool/multitool,
/turf/open/floor/plating,
/area/bigredv3/inside/engi/power_plant)
"tW" = (
/obj/structure/window/framed/colony/reinforced,
/obj/machinery/door/poddoor/mainship{
	dir = 2;
	id = "rad_door";
	name = "\improper Radiation Shielding"
	},
/turf/open/floor/plating,
/area/bigredv3/inside/wall)
"up" = (
/obj/effect/decal/cleanable/dirt,
/obj/structure/sign/safety/high_radiation,
/turf/open/floor,
/area/bigredv3/inside/engi/west)
"uA" = (
/obj/structure/table,
/obj/effect/spawner/random/engineering/tool,
/turf/open/floor,
/area/bigredv3/inside/engi/west)
"uN" = (
/turf/open/floor/plating/ground/mars/random/cave,
/area/bigredv3/outside/directions/s)
"wB" = (
/obj/structure/table,
/obj/effect/spawner/random/engineering/powercell,
/turf/open/floor,
/area/bigredv3/inside/engi/west)
"wF" = (
/obj/effect/decal/cleanable/dirt,
/obj/machinery/atmospherics/components/unary/vent_pump{
	dir = 1;
	on = 1
	},
/turf/open/floor,
/area/bigredv3/inside/engi/west)
"wL" = (
/obj/machinery/atmospherics/pipe/simple/green/hidden,
/obj/effect/decal/cleanable/dirt,
/obj/structure/cable,
/turf/open/floor,
/area/bigredv3/inside/engi/west)
"wZ" = (
/obj/effect/decal/cleanable/dirt,
/turf/open/floor,
/area/bigredv3/inside/engi/fabrication)
"xr" = (
/obj/effect/decal/cleanable/dirt,
/obj/machinery/atmospherics/components/unary/vent_pump{
	dir = 1;
	on = 1
	},
/turf/open/floor,
/area/bigredv3/inside/engi/power_plant)
"xW" = (
/obj/structure/rack,
/obj/item/tool/analyzer,
/turf/open/floor,
/area/bigredv3/inside/engi/west)
"yi" = (
/obj/structure/table,
/obj/effect/spawner/random/engineering/toolbox,
/obj/effect/decal/cleanable/dirt,
/turf/open/floor,
/area/bigredv3/inside/engi/west)
"yk" = (
/obj/effect/decal/cleanable/dirt,
/obj/machinery/atmospherics/pipe/simple/green/hidden{
	dir = 4
	},
/obj/structure/cable,
/turf/open/floor,
/area/bigredv3/inside/engi/west)
"yn" = (
/obj/machinery/atmospherics/components/unary/vent_pump{
	dir = 8;
	on = 1
	},
/turf/open/floor,
/area/bigredv3/inside/engi/west)
"yT" = (
/obj/effect/decal/cleanable/dirt,
/obj/structure/cable,
/turf/open/floor,
/area/bigredv3/inside/engi/fabrication)
"zl" = (
/obj/structure/table,
/turf/open/floor,
/area/bigredv3/inside/engi/ceo)
"zn" = (
/obj/machinery/atmospherics/pipe/simple/green/hidden{
	dir = 4
	},
/obj/machinery/door/airlock/mainship/engineering/free_access{
	name = "\improper Engineering Workshop"
	},
/obj/structure/cable,
/turf/open/floor,
/area/bigredv3/inside/engi/west)
"zF" = (
/obj/effect/decal/cleanable/dirt,
/obj/machinery/atmospherics/pipe/simple/green/hidden{
	dir = 4
	},
/obj/effect/ai_node,
/obj/structure/cable,
/turf/open/floor,
/area/bigredv3/inside/engi/west)
"zR" = (
/obj/machinery/light,
/turf/open/floor/plating,
/area/bigredv3/inside/engi/power_plant)
"Aa" = (
/obj/machinery/light{
	dir = 4
	},
/turf/open/floor/plating,
/area/bigredv3/inside/engi/power_plant)
"At" = (
/obj/machinery/atmospherics/pipe/simple/green/hidden{
	dir = 9
	},
/obj/effect/ai_node,
/obj/structure/cable,
/turf/open/floor,
/area/bigredv3/inside/engi/west)
"AA" = (
/obj/structure/table,
/obj/effect/spawner/random/engineering/tool,
/turf/open/floor,
/area/bigredv3/inside/engi/fabrication)
"Br" = (
/turf/open/floor,
/area/bigredv3/inside/engi/power_plant)
"BG" = (
/obj/structure/table,
/obj/effect/decal/cleanable/dirt,
/obj/item/clothing/glasses/welding,
/turf/open/floor,
/area/bigredv3/inside/engi/west)
"BH" = (
/obj/effect/ai_node,
/turf/open/floor/plating/ground/mars/random/dirt,
/area/bigredv3/outside/directions/sw)
"BP" = (
/turf/open/floor/plating/ground/mars/dirttosand/autosmooth{
	dir = 8
	},
/area/bigredv3/outside/directions/sw)
"Cn" = (
/obj/machinery/vending/cigarette/colony,
/turf/open/floor,
/area/bigredv3/inside/engi/west)
"Cr" = (
/obj/structure/table,
/obj/effect/spawner/random/engineering/tool,
/turf/open/floor,
/area/bigredv3/inside/engi/power_plant)
"CA" = (
/obj/machinery/atmospherics/pipe/manifold/green/hidden{
	dir = 8
	},
/obj/structure/cable,
/turf/open/floor,
/area/bigredv3/inside/engi/west)
"CU" = (
/obj/machinery/light{
	dir = 1
	},
/obj/machinery/atmospherics/pipe/simple/green/hidden{
	dir = 4
	},
/obj/structure/cable,
/turf/open/floor,
/area/bigredv3/inside/engi/west)
"DJ" = (
/obj/machinery/atmospherics/pipe/simple/green/hidden,
/turf/open/floor,
/area/bigredv3/inside/engi/power_plant)
"Eh" = (
/turf/open/floor,
/area/bigredv3/inside/engi/ceo)
"Em" = (
/obj/structure/window/framed/colony,
/turf/open/floor/plating,
/area/bigredv3/inside/wall)
"Ev" = (
/turf/open/floor/plating/ground/mars/cavetodirt{
	dir = 9
	},
/area/bigredv3/outside/directions/sw)
"Ft" = (
/turf/closed/wall/r_wall,
/area/bigredv3/inside/wall)
"Fz" = (
/obj/machinery/door/airlock/mainship/secure/free_access{
	dir = 1;
	name = "\improper Engine Reactor"
	},
/turf/open/floor,
/area/bigredv3/inside/engi/power_plant)
"FG" = (
/obj/machinery/atmospherics/pipe/manifold/green/hidden{
	dir = 4
	},
/obj/structure/cable,
/turf/open/floor,
/area/bigredv3/inside/engi/locker_room)
"FH" = (
/obj/machinery/atmospherics/pipe/simple/green/hidden{
	dir = 4
	},
/obj/machinery/door/airlock/multi_tile/mainship/generic{
	dir = 1;
	name = "\improper Engineering Complex"
	},
/obj/structure/cable,
/turf/open/floor,
/area/bigredv3/inside/engi/west)
"FJ" = (
/obj/machinery/light{
	dir = 8
	},
/obj/effect/spawner/random/misc/structure/supplycrate,
/turf/open/floor,
/area/bigredv3/inside/engi/fabrication)
"Gj" = (
/obj/structure/bed/chair/office/light{
	dir = 4
	},
/turf/open/floor,
/area/bigredv3/inside/engi/west)
"Gr" = (
/obj/machinery/atmospherics/pipe/manifold/green/hidden{
	dir = 1
	},
/obj/effect/ai_node,
/obj/structure/cable,
/turf/open/floor,
/area/bigredv3/inside/engi/west)
"Gu" = (
/obj/machinery/atmospherics/pipe/simple/green/hidden{
	dir = 4
	},
/obj/effect/decal/cleanable/dirt,
/obj/structure/cable,
/turf/open/floor,
/area/bigredv3/inside/engi/west)
"Gv" = (
/obj/machinery/power/apc/weak/ntf{
	dir = 4
	},
/obj/structure/cable,
/turf/open/floor,
/area/bigredv3/inside/engi/fabrication)
"Gy" = (
/obj/structure/table,
/obj/machinery/light{
	dir = 8
	},
/obj/effect/spawner/random/engineering/technology_scanner,
/turf/open/floor,
/area/bigredv3/inside/engi/power_plant)
"GD" = (
/obj/structure/table,
/obj/item/tool/analyzer,
/turf/open/floor,
/area/bigredv3/inside/engi/power_plant)
"HL" = (
/turf/open/floor/plating/ground/mars/dirttosand/autosmooth{
	dir = 9
	},
/area/bigredv3/outside/directions/s)
"Ib" = (
/obj/effect/decal/cleanable/dirt,
/obj/machinery/air_alarm{
	dir = 1
	},
/turf/open/floor,
/area/bigredv3/inside/engi/west)
"IK" = (
/obj/machinery/light{
	dir = 8
	},
/obj/effect/decal/cleanable/dirt,
/turf/open/floor/plating,
/area/bigredv3/inside/engi/power_plant)
"IS" = (
/obj/structure/table,
/obj/effect/spawner/random/misc/earmuffs,
/turf/open/floor,
/area/bigredv3/inside/engi/west)
"Jb" = (
/obj/machinery/vending/cola,
/turf/open/floor,
/area/bigredv3/inside/engi/west)
"Jw" = (
/obj/machinery/light{
	dir = 8
	},
/turf/open/floor,
/area/bigredv3/inside/engi/west)
"JO" = (
/obj/machinery/power/monitor{
	name = "Main Power Grid Monitoring"
	},
/turf/open/floor,
/area/bigredv3/inside/engi/power_plant)
"JS" = (
/obj/effect/spawner/random/engineering/structure/tank/fuelweighted,
/turf/open/floor,
/area/bigredv3/inside/engi/fabrication)
"Km" = (
/obj/machinery/light{
	dir = 4
	},
/turf/open/floor,
/area/bigredv3/inside/engi/power_plant)
"Ko" = (
/obj/effect/decal/cleanable/dirt,
/turf/open/floor/plating,
/area/bigredv3/inside/engi/power_plant)
"Ll" = (
/obj/machinery/atmospherics/pipe/simple/green/hidden,
/obj/machinery/door/airlock/mainship/engineering/free_access{
	dir = 1;
	name = "\improper Chief Engineer's Office"
	},
/obj/structure/cable,
/turf/open/floor,
/area/bigredv3/inside/engi/ceo)
"Lw" = (
/obj/structure/rack,
/obj/item/camera_film,
/turf/open/floor,
/area/bigredv3/inside/engi/west)
"Lz" = (
/obj/machinery/computer/atmos_alert,
/obj/structure/table,
/turf/open/floor,
/area/bigredv3/inside/engi/power_plant)
"LM" = (
/obj/machinery/atmospherics/pipe/simple/green/hidden,
/obj/effect/ai_node,
/obj/structure/cable,
/turf/open/floor,
/area/bigredv3/inside/engi/west)
"Ml" = (
/obj/machinery/door/airlock/mainship/engineering/free_access{
	name = "\improper Engine Reactor Control"
	},
/turf/open/floor,
/area/bigredv3/inside/engi/power_plant)
"Mq" = (
/turf/open/liquid/water/river,
/area/bigredv3/inside/engi/power_plant)
"Nb" = (
/turf/open/floor,
/area/bigredv3/inside/engi/locker_room)
"Ne" = (
/obj/structure/table,
/obj/effect/spawner/random/engineering/tool,
/obj/machinery/light{
	dir = 4
	},
/turf/open/floor,
/area/bigredv3/inside/engi/fabrication)
"Nn" = (
/obj/structure/table,
/obj/effect/spawner/random/engineering/toolbox,
/turf/open/floor,
/area/bigredv3/inside/engi/west)
"Nr" = (
/turf/open/floor/marking/asteroidwarning{
	dir = 4
	},
/area/bigredv3/outside/directions/central)
"NB" = (
/obj/structure/window/framed/colony/reinforced,
/obj/machinery/door/poddoor/shutters/mainship{
	dir = 2;
	id = "Engineering";
	name = "\improper Engineering Shutters"
	},
/turf/open/floor/plating,
/area/bigredv3/inside/wall)
"NN" = (
/obj/structure/bed/chair{
	dir = 4
	},
/turf/open/floor,
/area/bigredv3/inside/engi/west)
"Ol" = (
/obj/effect/decal/cleanable/dirt,
/obj/effect/spawner/random/machinery/machine_frame,
/turf/open/floor,
/area/bigredv3/inside/engi/west)
"OB" = (
/obj/effect/decal/cleanable/dirt,
/obj/structure/sign/safety/electronics{
	dir = 1
	},
/obj/structure/cable,
/turf/open/floor,
/area/bigredv3/inside/engi/fabrication)
"OJ" = (
/turf/open/floor/plating/ground/mars/random/dirt,
/area/bigredv3/outside/directions/s)
"ON" = (
/obj/machinery/floodlight/outpost/bigred,
/turf/open/floor/plating/ground/mars/random/cave,
/area/bigredv3/outside/directions/s)
"OW" = (
/obj/effect/ai_node,
/obj/structure/cable,
/turf/open/floor,
/area/bigredv3/inside/engi/fabrication)
"Po" = (
/obj/machinery/atmospherics/pipe/manifold/green/hidden{
	dir = 8
	},
/obj/effect/ai_node,
/obj/structure/cable,
/turf/open/floor,
/area/bigredv3/inside/engi/west)
"PK" = (
/obj/structure/bed/chair/office/light{
	dir = 8
	},
/turf/open/floor,
/area/bigredv3/inside/engi/power_plant)
"Ql" = (
/obj/machinery/bot/mulebot,
/turf/open/floor,
/area/bigredv3/inside/engi/west)
"QY" = (
/turf/closed/wall/mineral/gold,
/area/bigredv3/inside/engi/power_plant)
"Ro" = (
/obj/machinery/atmospherics/pipe/simple/green/hidden{
	dir = 10
	},
/obj/structure/cable,
/turf/open/floor,
/area/bigredv3/inside/engi/west)
"RA" = (
/obj/structure/table,
/obj/effect/spawner/random/engineering/tool,
/obj/effect/spawner/random/engineering/technology_scanner,
/turf/open/floor,
/area/bigredv3/inside/engi/fabrication)
"Sl" = (
/obj/machinery/atmospherics/pipe/simple/green/hidden,
/obj/effect/ai_node,
/turf/open/floor,
/area/bigredv3/inside/engi/power_plant)
"Tb" = (
/obj/effect/decal/cleanable/dirt,
/obj/effect/ai_node,
/turf/open/floor/plating,
/area/bigredv3/inside/engi/power_plant)
"TD" = (
/obj/effect/ai_node,
/turf/open/floor/plating/ground/mars/random/dirt,
/area/bigredv3/outside/directions/s)
"TH" = (
/turf/open/floor/plating/ground/mars/random/cave,
/area/bigredv3/caves/southwest)
"TO" = (
/obj/machinery/light{
	dir = 4
	},
/obj/effect/decal/cleanable/dirt,
/turf/open/floor,
/area/bigredv3/inside/engi/west)
"Ud" = (
/obj/structure/bed/chair/office/light,
/turf/open/floor,
/area/bigredv3/inside/engi/power_plant)
"Um" = (
/obj/machinery/door_control{
	desc = "A remote control-switch for opening the engines blast doors.";
	dir = 8;
	id = "rad_door";
	name = "Reactor Radiation Shielding control"
	},
/turf/open/floor,
/area/bigredv3/inside/engi/power_plant)
"UV" = (
/obj/effect/decal/cleanable/dirt,
/obj/machinery/atmospherics/pipe/simple/green/hidden{
	dir = 5
	},
/obj/structure/cable,
/turf/open/floor,
/area/bigredv3/inside/engi/west)
"Va" = (
/obj/effect/ai_node,
/turf/open/floor/plating/ground/mars/random/cave,
/area/bigredv3/caves/southwest)
"VC" = (
/turf/open/floor/plating/ground/mars/cavetodirt{
	dir = 9
	},
/area/bigredv3/outside/directions/s)
"VE" = (
/obj/effect/decal/cleanable/dirt,
/obj/structure/sign/safety/electronics{
	dir = 1
	},
/turf/open/floor,
/area/bigredv3/inside/engi/fabrication)
"Wd" = (
/obj/effect/ai_node,
/turf/open/floor/plating,
/area/bigredv3/inside/engi/power_plant)
"WA" = (
/obj/machinery/door_control{
	dir = 1;
	id = "Engineering";
	name = "Storm Shutters"
	},
/turf/open/floor,
/area/bigredv3/inside/engi/west)
"Xa" = (
/obj/effect/decal/cleanable/dirt,
/obj/item/tool/weldpack,
/turf/open/floor,
/area/bigredv3/inside/engi/west)
"Xp" = (
/turf/open/floor/plating/ground/mars/random/sand,
/area/bigredv3/outside/directions/s)
"XB" = (
/turf/open/floor/plating/ground/mars/random/dirt,
/area/bigredv3/outside/directions/sw)
"Yr" = (
/obj/machinery/floodlight/outpost/bigred,
/turf/open/floor/plating/ground/mars/random/cave/rock,
/area/bigredv3/caves/southwest)
"YN" = (
/obj/machinery/atmospherics/pipe/simple/green/hidden,
/obj/effect/ai_node,
/obj/structure/cable,
/turf/open/floor,
/area/bigredv3/inside/engi/fabrication)
"YP" = (
/obj/machinery/atmospherics/pipe/simple/green/hidden,
/turf/open/floor,
/area/bigredv3/inside/engi/west)
"Zc" = (
/obj/machinery/atmospherics/pipe/manifold/green/hidden{
	dir = 4
	},
/obj/effect/ai_node,
/obj/structure/cable,
/turf/open/floor,
/area/bigredv3/inside/engi/west)
"Zn" = (
/obj/effect/decal/cleanable/dirt,
/obj/structure/sign/safety/hazard,
/turf/open/floor,
/area/bigredv3/inside/engi/west)
"ZV" = (
/obj/structure/bed/chair{
	dir = 4
	},
/obj/effect/decal/cleanable/dirt,
/turf/open/floor,
/area/bigredv3/inside/engi/west)

(1,1,1) = {"
Nb
fl
FG
qD
fX
Po
sb
YP
sb
wF
bg
NB
sH
sH
sH
nP
nP
TH
TH
TH
TH
TH
TH
jT
TH
TH
TH
"}
(2,1,1) = {"
Ft
Ft
Ft
Ft
pu
fD
bJ
bw
bJ
bw
Ol
NB
BP
BP
BP
XB
nP
TH
TH
TH
TH
TH
TH
TH
jT
TH
TH
"}
(3,1,1) = {"
pu
VE
FJ
Gv
pu
fD
bw
Gj
bw
bw
mo
Ft
BH
iY
XB
XB
XB
jn
TH
cw
TH
TH
TH
TH
Va
Yr
TH
"}
(4,1,1) = {"
ru
OW
pC
yT
pu
fD
yi
wB
mW
bJ
uA
Ft
XB
XB
XB
XB
Ev
jT
TH
TH
TH
TH
TH
TH
TH
TH
TH
"}
(5,1,1) = {"
pu
OB
qm
qm
pu
zn
Em
Em
Em
Ft
Ft
Ft
Ft
Ft
Ft
Ft
Ft
Ft
Ft
Ft
Ft
Ft
Ft
Ft
Ft
nP
nP
"}
(6,1,1) = {"
pu
pC
oI
JS
pu
fD
bw
bJ
ik
Ft
qg
Ft
hG
Ko
IK
hG
hG
hG
hG
Ko
IK
Ko
Ko
hG
Ft
nP
nP
"}
(7,1,1) = {"
pu
os
pu
pu
pu
zF
bw
bw
kZ
Fz
Km
Fz
hG
Ko
Ko
Ko
Tb
hG
Ko
Ko
Tb
Ko
Ko
Ko
Ft
Ft
nP
"}
(8,1,1) = {"
lv
yT
pu
xW
Lw
fD
bw
bw
bR
Ft
Ft
Ft
Ko
Ko
Ko
hG
hG
Ko
Ko
Ko
Ko
Ko
Ko
hG
hG
Ft
nP
"}
(9,1,1) = {"
qm
yT
Em
bw
bw
yk
Ql
bw
bw
ly
ly
Ft
Mq
Mq
Mq
Mq
hG
Mq
Mq
Mq
hG
Mq
Mq
Mq
hG
Ft
Ft
"}
(10,1,1) = {"
qm
yT
Em
bw
nl
yk
Xa
bw
bw
bw
bw
tW
Mq
Mq
QY
Mq
hG
Mq
QY
Mq
hG
Mq
QY
Mq
hG
zR
Ft
"}
(11,1,1) = {"
lM
YN
gs
Po
fX
At
bw
bw
bw
bw
bw
tW
Mq
Mq
Mq
Mq
hG
Mq
Mq
Mq
hG
Mq
Mq
Mq
hG
hG
Ft
"}
(12,1,1) = {"
wZ
wZ
Em
Gu
bJ
bJ
bJ
TO
bJ
bw
bw
tW
Mq
Mq
QY
Mq
hG
Mq
QY
Mq
hG
Mq
QY
Mq
hG
hG
Ft
"}
(13,1,1) = {"
wZ
bQ
Em
Gu
bJ
pu
pu
pu
Ml
pu
pu
Ft
Ft
Mq
Mq
Mq
hG
Mq
Mq
Mq
hG
Mq
Mq
Mq
hG
hG
Ft
"}
(14,1,1) = {"
qm
AA
pu
fD
bw
pu
Gy
Cr
Br
Br
Br
iS
tW
Mq
QY
Mq
hG
Mq
QY
Mq
hG
Mq
QY
Mq
hG
hG
Ft
"}
(15,1,1) = {"
qm
ap
Em
Gu
qF
pu
Br
PK
Br
iL
Ud
Cr
tW
Mq
Mq
Mq
hG
Mq
Mq
Mq
hG
Mq
Mq
Mq
hG
hG
Ft
"}
(16,1,1) = {"
Ne
RA
Em
Gr
sb
cG
DJ
DJ
Sl
xr
Br
JO
tW
Mq
QY
Mq
Wd
Mq
QY
Mq
tQ
Mq
QY
Mq
hG
hG
Ft
"}
(17,1,1) = {"
pu
pu
pu
CU
Ib
pu
iL
iL
Br
iL
Ud
GD
tW
Mq
Mq
Mq
hG
Mq
Mq
Mq
hG
Mq
Mq
Mq
hG
hG
Ft
"}
(18,1,1) = {"
zl
Em
Jw
fD
bJ
pu
Br
Um
Br
Br
Br
Lz
tW
Mq
QY
Mq
hG
Mq
QY
Mq
hG
Mq
QY
Mq
hG
hG
Ft
"}
(19,1,1) = {"
Eh
Em
bw
fD
WA
pu
pu
pu
Ml
pu
pu
Ft
Ft
Mq
Mq
Mq
hG
Mq
Mq
Mq
hG
Mq
Mq
Mq
hG
hG
Ft
"}
(20,1,1) = {"
Eh
Em
bw
fD
bJ
bw
bw
Jw
bw
bJ
bw
tW
Mq
Mq
QY
Mq
hG
Mq
QY
Mq
hG
Mq
QY
Mq
hG
hG
Ft
"}
(21,1,1) = {"
tJ
Ll
fX
qq
ZV
NN
NN
bJ
bw
bJ
bw
tW
Mq
Mq
Mq
Mq
hG
Mq
Mq
Mq
hG
Mq
Mq
Mq
hG
hG
Ft
"}
(22,1,1) = {"
Eh
Em
bw
fD
BG
ks
qe
bJ
bw
bw
bw
tW
Mq
Mq
QY
Mq
hG
Mq
QY
Mq
hG
Mq
QY
Mq
hG
zR
Ft
"}
(23,1,1) = {"
pu
pu
lE
fD
Nn
IS
ai
bw
bw
bw
nf
Ft
Mq
Mq
Mq
Mq
hG
Mq
Mq
Mq
hG
Mq
Mq
Mq
hG
Ft
Ft
"}
(24,1,1) = {"
bJ
lc
bw
fD
db
db
db
bJ
up
Ft
Ft
Ft
hG
hG
hG
hG
hG
da
hG
Ko
Ko
hG
hG
hG
hG
Ft
uN
"}
(25,1,1) = {"
wL
wL
fX
Zc
cL
fX
CA
UV
kZ
Fz
sG
Fz
hG
hG
hG
hG
Wd
Ko
Ko
hG
Tb
hG
hG
hG
Ft
Ft
ek
"}
(26,1,1) = {"
Ft
Ft
Ft
Ft
Ft
sk
yn
yk
Zn
Ft
qg
Ft
hG
Ko
Aa
hG
hG
hG
hG
hG
Aa
hG
hG
hG
Ft
ek
uN
"}
(27,1,1) = {"
Nr
Nr
Nr
Nr
Ft
Ft
Cn
yk
bp
Ft
Ft
Ft
Ft
Ft
Ft
Ft
Ft
Ft
Ft
Ft
Ft
Ft
Ft
Ft
Ft
uN
ON
"}
(28,1,1) = {"
kf
kf
kf
kf
kf
Ft
cT
Ro
LM
fX
fX
fX
fX
jb
Ft
Xp
Xp
Xp
Xp
qu
OJ
OJ
OJ
OJ
VC
uN
uN
"}
(29,1,1) = {"
kf
kf
kf
kf
kf
Ft
Jb
bw
re
TO
bJ
bw
bw
fD
Ft
Xp
Xp
mp
HL
OJ
TD
OJ
OJ
VC
uN
uN
uN
"}
(30,1,1) = {"
kf
kf
kf
kf
kf
Ft
Ft
Ft
Ft
Ft
Ft
Ft
bw
FH
Ft
Xp
Xp
HL
OJ
OJ
OJ
Ft
Ft
Ft
Ft
Ft
Ft
"}
