//MAP CONVERTED BY dmm2tgm.py THIS HEADER COMMENT PREVENTS RECONVERSION, DO NOT REMOVE
"b" = (
/turf/open/floor/plating/ground/mars/random/cave/rock,
/area/bigredv2/caves/south/garbledradio)
"c" = (
/turf/open/floor/plating/ground/mars/random/cave/rock,
/area/bigredv2/caves/southwest)
"d" = (
/obj/effect/ai_node,
/turf/open/floor/plating/ground/mars/random/cave,
/area/bigredv2/caves/south/garbledradio)
"h" = (
/obj/effect/ai_node,
/turf/open/floor/plating/ground/mars/random/cave/rock,
/area/bigredv2/caves/southwest)
"i" = (
/obj/effect/landmark/lv624/fog_blocker,
/turf/closed/mineral/smooth/bigred,
/area/bigredv2/caves/rock)
"j" = (
/turf/closed/mineral/smooth/bigred,
/area/bigredv2/caves/rock)
"l" = (
/obj/effect/landmark/lv624/fog_blocker,
/turf/open/floor/plating/ground/mars/random/cave/rock,
/area/bigredv2/caves/southwest)
"q" = (
/obj/effect/ai_node,
/turf/open/floor/plating/ground/mars/random/cave,
/area/bigredv2/caves/southwest)
"s" = (
/turf/open/floor/plating/ground/mars/random/cave,
/area/bigredv2/caves/southwest)
"u" = (
/turf/open/floor/plating/ground/mars/random/cave,
/area/bigredv2/caves/south)
"A" = (
/obj/effect/landmark/excavation_site_spawner,
/turf/open/floor/plating/ground/mars/random/cave,
/area/bigredv2/caves/south/garbledradio)
"E" = (
/obj/effect/ai_node,
/turf/open/floor/plating/ground/mars/random/cave/rock,
/area/bigredv2/caves/south/garbledradio)
"M" = (
/turf/open/floor/plating/ground/mars/random/cave,
/area/bigredv2/caves/south/garbledradio)
"N" = (
/obj/effect/landmark/lv624/fog_blocker,
/turf/open/floor/plating/ground/mars/random/cave,
/area/bigredv2/caves/southwest)
"W" = (
/obj/effect/ai_node,
/turf/open/floor/plating/ground/mars/random/cave,
/area/bigredv2/caves/south)

(1,1,1) = {"
i
j
j
j
j
j
c
s
s
s
c
j
j
j
j
s
s
j
j
j
j
j
"}
(2,1,1) = {"
N
j
j
j
j
j
j
s
q
s
c
j
j
j
j
s
s
s
j
j
j
j
"}
(3,1,1) = {"
N
j
j
j
j
j
j
s
s
s
c
j
j
j
c
s
s
j
j
j
j
j
"}
(4,1,1) = {"
N
j
j
j
j
j
s
s
s
s
c
j
j
j
c
s
s
j
j
j
j
j
"}
(5,1,1) = {"
N
c
j
j
j
j
s
s
s
s
s
j
j
c
s
s
s
j
j
j
j
j
"}
(6,1,1) = {"
N
c
j
j
c
c
s
s
s
s
s
j
j
s
s
q
j
j
j
j
j
j
"}
(7,1,1) = {"
N
s
c
h
s
s
s
s
q
s
s
s
s
s
q
j
j
j
j
j
j
j
"}
(8,1,1) = {"
N
s
s
c
s
s
s
s
s
s
s
s
s
s
s
j
j
j
j
j
j
j
"}
(9,1,1) = {"
N
c
s
s
s
s
s
j
j
j
s
s
s
s
s
j
j
j
j
j
j
j
"}
(10,1,1) = {"
l
s
s
q
j
j
j
j
j
j
j
s
s
s
s
j
j
s
j
j
j
j
"}
(11,1,1) = {"
i
j
j
j
j
j
j
j
j
j
j
j
s
s
s
s
s
s
j
j
j
j
"}
(12,1,1) = {"
j
i
j
j
j
j
j
j
j
j
j
j
s
s
s
s
s
s
j
j
j
j
"}
(13,1,1) = {"
j
j
i
i
j
j
j
j
j
j
j
j
s
s
s
s
s
j
j
j
j
j
"}
(14,1,1) = {"
j
j
j
j
i
j
j
j
j
j
j
j
s
s
s
s
j
j
j
j
j
j
"}
(15,1,1) = {"
j
j
j
j
j
i
j
j
j
j
j
j
j
s
s
c
j
j
j
j
j
j
"}
(16,1,1) = {"
j
j
j
j
j
j
i
j
j
j
j
j
j
s
q
c
c
j
j
j
j
j
"}
(17,1,1) = {"
s
j
j
j
j
j
i
j
j
j
j
j
j
s
c
c
j
j
j
j
j
j
"}
(18,1,1) = {"
s
q
j
j
j
j
i
j
j
j
j
j
j
s
s
s
j
j
j
j
j
j
"}
(19,1,1) = {"
s
s
j
j
j
j
i
j
j
j
j
j
s
s
s
s
s
j
j
j
j
j
"}
(20,1,1) = {"
c
s
j
j
j
j
i
j
j
j
s
s
s
s
s
c
s
j
j
j
j
j
"}
(21,1,1) = {"
c
s
s
j
j
j
i
j
j
j
s
s
s
s
s
c
s
j
j
j
j
j
"}
(22,1,1) = {"
s
s
s
s
s
s
N
j
j
j
s
s
s
s
s
j
j
j
j
j
j
j
"}
(23,1,1) = {"
s
s
s
s
s
s
N
s
s
j
s
s
s
s
s
j
j
j
j
j
j
j
"}
(24,1,1) = {"
s
s
s
s
s
s
N
s
s
s
s
s
s
s
s
j
j
j
j
j
j
j
"}
(25,1,1) = {"
s
s
s
s
s
j
i
s
s
s
s
c
s
s
q
s
j
j
j
j
j
j
"}
(26,1,1) = {"
M
M
M
M
M
j
i
j
j
M
M
M
M
b
M
A
j
j
j
j
j
j
"}
(27,1,1) = {"
M
d
M
M
M
j
i
j
j
j
j
j
M
M
M
M
M
j
j
j
j
j
"}
(28,1,1) = {"
b
M
M
M
M
j
i
j
j
j
j
j
j
M
M
M
M
M
M
j
j
j
"}
(29,1,1) = {"
b
M
M
M
M
j
i
j
j
j
j
j
j
M
d
b
M
d
M
M
j
j
"}
(30,1,1) = {"
M
M
M
M
M
j
i
j
j
j
j
j
j
j
M
M
M
M
M
M
M
j
"}
(31,1,1) = {"
M
M
M
M
M
j
i
j
j
j
j
j
j
j
j
M
M
M
M
M
M
j
"}
(32,1,1) = {"
M
M
M
M
M
j
i
j
j
j
j
j
j
j
j
M
M
M
M
M
M
u
"}
(33,1,1) = {"
M
M
M
M
M
j
i
j
j
j
j
j
j
j
j
j
M
M
M
M
u
u
"}
(34,1,1) = {"
b
M
M
M
j
j
i
j
j
j
j
j
j
j
j
j
j
d
M
M
W
u
"}
(35,1,1) = {"
b
M
M
M
j
j
i
j
j
j
j
j
j
j
j
j
j
M
M
M
b
u
"}
(36,1,1) = {"
b
M
M
M
j
j
i
j
j
j
j
j
j
j
j
j
j
j
M
M
M
u
"}
(37,1,1) = {"
M
M
M
M
j
j
i
j
j
j
j
j
j
j
j
j
j
j
M
M
M
u
"}
(38,1,1) = {"
M
d
M
M
j
j
i
j
j
j
j
j
j
j
j
j
j
M
M
M
u
u
"}
(39,1,1) = {"
M
M
M
j
j
j
i
j
j
j
j
j
j
j
j
M
M
M
M
M
u
u
"}
(40,1,1) = {"
M
M
M
j
j
j
i
j
j
j
j
j
j
j
M
M
M
M
M
M
d
u
"}
(41,1,1) = {"
M
M
M
j
j
j
i
j
j
j
j
j
j
M
M
M
M
M
E
M
M
W
"}
(42,1,1) = {"
M
M
j
j
j
j
i
j
j
j
j
j
M
M
M
M
M
M
M
A
M
u
"}
(43,1,1) = {"
M
j
j
j
j
j
i
j
j
j
j
M
d
M
b
d
M
M
d
b
j
j
"}
(44,1,1) = {"
j
j
j
j
j
j
i
j
j
j
j
j
M
b
M
M
M
b
j
j
j
j
"}
