//MAP CONVERTED BY dmm2tgm.py THIS HEADER COMMENT PREVENTS RECONVERSION, DO NOT REMOVE
"a" = (
/obj/machinery/atmospherics/pipe/simple/green/hidden{
	dir = 5
	},
/obj/structure/cable,
/turf/open/floor/marking/asteroidwarning{
	dir = 10
	},
/area/bigredv3/outside/directions/central)
"c" = (
/obj/machinery/atmospherics/components/unary/vent_pump{
	dir = 4;
	on = 1
	},
/turf/open/floor/asteroidfloor,
/area/bigredv3/outside/directions/central)
"e" = (
/turf/open/floor/marking/asteroidwarning{
	dir = 1
	},
/area/bigredv3/outside/directions/central)
"g" = (
/obj/effect/turf_decal/warning_stripes/thin,
/turf/open/floor/asteroidfloor,
/area/bigredv3/outside/directions/central)
"h" = (
/turf/open/floor/marking/asteroidwarning{
	dir = 9
	},
/area/bigredv3/outside/directions/central)
"i" = (
/obj/structure/bed/chair{
	dir = 8
	},
/turf/open/floor/marking/asteroidwarning{
	dir = 5
	},
/area/bigredv3/outside/directions/central)
"l" = (
/obj/effect/turf_decal/warning_stripes/thin{
	dir = 8
	},
/obj/effect/turf_decal/warning_stripes,
/obj/structure/hoop{
	dir = 4;
	id = "basketball";
	side = "left"
	},
/turf/open/floor/asteroidfloor,
/area/bigredv3/outside/directions/central)
"m" = (
/obj/effect/turf_decal/warning_stripes/thin{
	dir = 1
	},
/turf/open/floor/asteroidfloor,
/area/bigredv3/outside/directions/central)
"n" = (
/obj/effect/turf_decal/warning_stripes/nscenter,
/turf/open/floor/asteroidfloor,
/area/bigredv3/outside/directions/central)
"o" = (
/obj/machinery/atmospherics/pipe/simple/green/hidden,
/obj/structure/cable,
/turf/open/floor/marking/asteroidwarning{
	dir = 8
	},
/area/bigredv3/outside/directions/central)
"p" = (
/obj/effect/turf_decal/warning_stripes/thin{
	dir = 1
	},
/obj/effect/turf_decal/warning_stripes/nscenter,
/turf/open/floor/asteroidfloor,
/area/bigredv3/outside/directions/central)
"q" = (
/obj/machinery/atmospherics/pipe/simple/green/hidden,
/obj/structure/bed/chair{
	dir = 8
	},
/obj/structure/cable,
/turf/open/floor/marking/asteroidwarning{
	dir = 4
	},
/area/bigredv3/outside/directions/central)
"r" = (
/obj/machinery/atmospherics/pipe/simple/green/hidden,
/obj/structure/cable,
/turf/open/floor/asteroidfloor,
/area/bigredv3/outside/directions/central)
"s" = (
/obj/effect/turf_decal/warning_stripes/thin{
	dir = 4
	},
/obj/effect/ai_node,
/turf/open/floor/asteroidfloor,
/area/bigredv3/outside/directions/central)
"u" = (
/obj/effect/turf_decal/warning_stripes/nscenter,
/obj/effect/ai_node,
/turf/open/floor/asteroidfloor,
/area/bigredv3/outside/directions/central)
"v" = (
/obj/machinery/atmospherics/pipe/simple/green/hidden{
	dir = 4
	},
/obj/structure/cable,
/turf/open/floor/asteroidfloor,
/area/bigredv3/outside/directions/central)
"w" = (
/obj/machinery/atmospherics/pipe/simple/green/hidden{
	dir = 9
	},
/obj/effect/ai_node,
/obj/structure/bed/chair{
	dir = 8
	},
/obj/structure/cable,
/turf/open/floor/marking/asteroidwarning{
	dir = 6
	},
/area/bigredv3/outside/directions/central)
"z" = (
/obj/effect/turf_decal/warning_stripes/thin{
	dir = 4
	},
/turf/open/floor/asteroidfloor,
/area/bigredv3/outside/directions/central)
"A" = (
/obj/effect/turf_decal/warning_stripes/thin{
	dir = 8
	},
/obj/effect/turf_decal/warning_stripes/thin,
/obj/machinery/floodlight/outpost/bigred,
/turf/open/floor/asteroidfloor,
/area/bigredv3/outside/directions/central)
"C" = (
/obj/effect/turf_decal/warning_stripes/thin{
	dir = 4
	},
/obj/effect/turf_decal/warning_stripes/thin{
	dir = 1
	},
/obj/machinery/floodlight/outpost/bigred,
/turf/open/floor/asteroidfloor,
/area/bigredv3/outside/directions/central)
"F" = (
/obj/effect/turf_decal/warning_stripes,
/obj/item/toy/beach_ball/basketball,
/turf/open/floor/asteroidfloor,
/area/bigredv3/outside/directions/central)
"G" = (
/obj/effect/ai_node,
/obj/machinery/atmospherics/pipe/manifold/green/hidden{
	dir = 1
	},
/obj/structure/cable,
/turf/open/floor/asteroidfloor,
/area/bigredv3/outside/directions/central)
"H" = (
/obj/effect/turf_decal/warning_stripes/thin,
/obj/effect/turf_decal/warning_stripes/nscenter,
/turf/open/floor/asteroidfloor,
/area/bigredv3/outside/directions/central)
"I" = (
/turf/open/floor/asteroidfloor,
/area/bigredv3/outside/directions/central)
"J" = (
/obj/machinery/atmospherics/pipe/manifold/green/hidden{
	dir = 1
	},
/obj/effect/ai_node,
/obj/structure/cable,
/turf/open/floor/asteroidfloor,
/area/bigredv3/outside/directions/central)
"L" = (
/obj/effect/turf_decal/warning_stripes/thin{
	dir = 4
	},
/obj/effect/turf_decal/warning_stripes,
/obj/structure/hoop{
	dir = 8;
	id = "basketball";
	side = "right"
	},
/turf/open/floor/asteroidfloor,
/area/bigredv3/outside/directions/central)
"M" = (
/obj/effect/turf_decal/warning_stripes/thin{
	dir = 4
	},
/obj/effect/turf_decal/warning_stripes/thin,
/obj/machinery/floodlight/outpost/bigred,
/turf/open/floor/asteroidfloor,
/area/bigredv3/outside/directions/central)
"O" = (
/obj/machinery/atmospherics/pipe/simple/green/hidden{
	dir = 4
	},
/obj/structure/cable,
/turf/open/floor/marking/asteroidwarning,
/area/bigredv3/outside/directions/central)
"P" = (
/obj/effect/turf_decal/warning_stripes/thin{
	dir = 8
	},
/obj/effect/turf_decal/warning_stripes/thin{
	dir = 1
	},
/obj/machinery/floodlight/outpost/bigred,
/turf/open/floor/asteroidfloor,
/area/bigredv3/outside/directions/central)
"Q" = (
/obj/machinery/atmospherics/pipe/manifold/green/hidden{
	dir = 1
	},
/obj/structure/cable,
/turf/open/floor/asteroidfloor,
/area/bigredv3/outside/directions/central)
"R" = (
/obj/structure/mopbucket,
/obj/item/tool/mop,
/turf/open/floor/marking/asteroidwarning{
	dir = 1
	},
/area/bigredv3/outside/directions/central)
"S" = (
/turf/open/floor/marking/asteroidwarning{
	dir = 8
	},
/area/bigredv3/outside/directions/central)
"T" = (
/obj/effect/turf_decal/warning_stripes/thin{
	dir = 8
	},
/turf/open/floor/asteroidfloor,
/area/bigredv3/outside/directions/central)
"Y" = (
/obj/structure/bed/chair{
	dir = 8
	},
/turf/open/floor/marking/asteroidwarning{
	dir = 4
	},
/area/bigredv3/outside/directions/central)
"Z" = (
/obj/machinery/atmospherics/pipe/simple/green/hidden{
	dir = 10
	},
/obj/structure/cable,
/turf/open/floor/asteroidfloor,
/area/bigredv3/outside/directions/central)

(1,1,1) = {"
h
S
S
I
Z
r
o
o
a
"}
(2,1,1) = {"
e
P
T
T
l
T
T
A
O
"}
(3,1,1) = {"
e
m
I
I
I
I
I
g
O
"}
(4,1,1) = {"
R
m
I
I
I
I
I
g
O
"}
(5,1,1) = {"
e
m
I
I
I
I
I
g
O
"}
(6,1,1) = {"
e
m
I
I
I
I
I
g
O
"}
(7,1,1) = {"
e
m
I
I
I
I
I
g
Q
"}
(8,1,1) = {"
e
p
u
n
F
u
n
H
G
"}
(9,1,1) = {"
e
m
I
I
I
I
I
g
v
"}
(10,1,1) = {"
e
m
I
I
I
I
I
g
O
"}
(11,1,1) = {"
e
m
I
I
I
I
I
g
O
"}
(12,1,1) = {"
e
m
I
I
I
I
I
g
O
"}
(13,1,1) = {"
e
m
I
I
I
I
I
g
O
"}
(14,1,1) = {"
e
C
z
z
L
s
z
M
O
"}
(15,1,1) = {"
e
I
I
I
c
I
I
I
O
"}
(16,1,1) = {"
i
Y
Y
I
J
r
q
q
w
"}
