//MAP CONVERTED BY dmm2tgm.py THIS HEADER COMMENT PREVENTS RECONVERSION, DO NOT REMOVE
"ab" = (
/obj/machinery/light{
	dir = 8
	},
/turf/open/floor/plating/ground/mars/random/sand,
/area/bigredv3/inside/science/xenolab)
"bp" = (
/obj/machinery/atmospherics/components/unary/vent_pump{
	dir = 4;
	on = 1
	},
/turf/open/floor/tile/dark,
/area/bigredv3/inside/science/xenolab)
"bJ" = (
/turf/open/floor/tile/dark/red2{
	dir = 10
	},
/area/bigredv3/inside/science/xenolab)
"bZ" = (
/obj/machinery/light{
	dir = 4
	},
/turf/open/ground/jungle/clear,
/area/bigredv3/inside/science/xenolab)
"co" = (
/obj/effect/ai_node,
/turf/open/floor/plating/ground/mars/random/sand,
/area/bigredv3/inside/science/xenolab)
"dp" = (
/turf/open/floor/plating,
/area/bigredv3/inside/science/research_office)
"dL" = (
/obj/machinery/door/airlock/mainship/research/glass/free_access{
	name = "\improper Eta Lab Cell"
	},
/turf/open/floor/tile/dark,
/area/bigredv3/inside/science/xenolab)
"dO" = (
/turf/closed/mineral/smooth/bigred,
/area/bigredv3/caves/rock)
"dV" = (
/obj/structure/window/framed/colony/reinforced/unbreakable,
/turf/open/floor/plating,
/area/bigredv3/inside/wall)
"er" = (
/obj/effect/landmark/lv624/fog_blocker/xeno_spawn,
/turf/closed/mineral/smooth/bigred,
/area/bigredv3/caves/rock)
"ex" = (
/obj/structure/closet/crate/secure,
/turf/open/floor/tile/dark/red2/corner,
/area/bigredv3/inside/science/xenolab)
"eA" = (
/obj/item/target,
/turf/open/floor/tile/dark/red2{
	dir = 1
	},
/area/bigredv3/inside/science/xenolab)
"eM" = (
/obj/effect/spawner/random/engineering/structure/tank/fuelweighted,
/obj/machinery/light/small{
	dir = 1
	},
/turf/open/floor/plating,
/area/bigredv3/inside/science/research_office)
"fG" = (
/obj/effect/decal/cleanable/dirt,
/turf/open/floor/tile/dark,
/area/bigredv3/inside/science/xenolab)
"fP" = (
/obj/effect/ai_node,
/turf/open/floor/plating/ground/mars/random/cave/rock,
/area/bigredv3/caves/south)
"ge" = (
/turf/open/floor/tile/dark,
/area/bigredv3/inside/science/xenolab)
"gz" = (
/turf/closed/mineral/smooth/bigred/indestructible,
/area/bigredv3/inside/wall)
"gN" = (
/obj/structure/table,
/obj/effect/spawner/random/engineering/technology_scanner,
/turf/open/floor/tile/dark/red2/corner{
	dir = 8
	},
/area/bigredv3/inside/science/xenolab)
"hm" = (
/obj/machinery/light,
/turf/open/floor/tile/darkgreen/darkgreen2,
/area/bigredv3/inside/science/xenolab)
"is" = (
/obj/structure/closet/l3closet/scientist,
/turf/open/floor/tile/darkgreen/darkgreen2{
	dir = 5
	},
/area/bigredv3/inside/science/xenolab)
"iO" = (
/obj/effect/landmark/lv624/fog_blocker/xeno_spawn,
/turf/open/floor/plating/ground/mars/random/cave/rock,
/area/bigredv3/caves/south)
"ja" = (
/obj/effect/landmark/xeno_silo_spawn,
/turf/open/floor/plating/ground/mars/random/cave,
/area/bigredv3/caves/south)
"jg" = (
/obj/structure/window/framed/colony/reinforced,
/turf/open/floor/plating,
/area/bigredv3/inside/wall)
"jH" = (
/obj/effect/ai_node,
/turf/open/floor/tile/dark,
/area/bigredv3/inside/science/xenolab)
"kP" = (
/obj/structure/xenoautopsy/tank/hugger,
/turf/open/floor/tile/dark/red2/corner{
	dir = 8
	},
/area/bigredv3/inside/science/xenolab)
"kT" = (
/obj/effect/landmark/lv624/fog_blocker,
/turf/closed/wall/r_wall,
/turf/open/floor/plating/ground/mars/cavetodirt{
	dir = 1
	},
/area/bigredv3/inside/wall)
"lp" = (
/obj/structure/bed/chair{
	dir = 4
	},
/turf/open/floor/tile/dark/red2{
	dir = 4
	},
/area/bigredv3/inside/science/xenolab)
"lP" = (
/obj/effect/decal/cleanable/dirt,
/turf/open/floor/tile/dark/red2/corner,
/area/bigredv3/inside/science/xenolab)
"mB" = (
/obj/structure/table,
/obj/machinery/light,
/obj/effect/spawner/random/engineering/technology_scanner,
/obj/item/xenos_claw,
/turf/open/floor/tile/dark/red2/corner{
	dir = 8
	},
/area/bigredv3/inside/science/xenolab)
"nV" = (
/obj/effect/landmark/lv624/fog_blocker,
/turf/closed/wall/r_wall,
/turf/open/floor/plating/ground/mars/random/cave,
/area/bigredv3/inside/wall)
"oJ" = (
/turf/open/floor/tile/dark/red2,
/area/bigredv3/inside/science/xenolab)
"oK" = (
/obj/machinery/light{
	dir = 1
	},
/turf/open/floor/tile/dark/red2{
	dir = 5
	},
/area/bigredv3/inside/science/xenolab)
"pu" = (
/turf/open/floor/plating/ground/mars/random/cave,
/area/bigredv3/caves/south)
"pP" = (
/obj/structure/table,
/obj/effect/spawner/random/engineering/technology_scanner,
/turf/open/floor/tile/dark/red2/corner{
	dir = 4
	},
/area/bigredv3/inside/science/xenolab)
"pU" = (
/obj/machinery/computer/security,
/turf/open/floor/tile/dark/red2/corner{
	dir = 4
	},
/area/bigredv3/inside/science/xenolab)
"qb" = (
/obj/machinery/door/airlock/mainship/research/glass/free_access{
	name = "\improper Eta Lab Cell"
	},
/turf/open/floor/tile/dark)
"sC" = (
/obj/machinery/light{
	dir = 8
	},
/turf/open/floor/tile/dark/red2/corner{
	dir = 8
	},
/area/bigredv3/inside/science/xenolab)
"tZ" = (
/obj/machinery/atmospherics/pipe/simple/green/hidden{
	dir = 4
	},
/turf/open/floor/tile/dark,
/area/bigredv3/inside/science/xenolab)
"ur" = (
/obj/structure/bed/chair{
	dir = 8
	},
/turf/open/floor/tile/dark/red2{
	dir = 8
	},
/area/bigredv3/inside/science/xenolab)
"wn" = (
/obj/structure/table,
/obj/structure/xenoautopsy,
/turf/open/floor/tile/dark/red2/corner{
	dir = 4
	},
/area/bigredv3/inside/science/xenolab)
"wH" = (
/obj/structure/table,
/obj/item/paper,
/turf/open/floor/tile/dark/red2/corner,
/area/bigredv3/inside/science/xenolab)
"wT" = (
/turf/open/floor/tile/dark/red2{
	dir = 4
	},
/area/bigredv3/inside/science/xenolab)
"zk" = (
/obj/structure/table,
/obj/item/alienjar,
/turf/open/floor/tile/dark/red2/corner{
	dir = 4
	},
/area/bigredv3/inside/science/xenolab)
"zV" = (
/turf/open/floor/tile/darkgreen/darkgreen2{
	dir = 4
	},
/area/bigredv3/inside/science/xenolab)
"Ap" = (
/obj/structure/closet/l3closet/scientist,
/turf/open/floor/tile/darkgreen/darkgreen2{
	dir = 9
	},
/area/bigredv3/inside/science/xenolab)
"Bf" = (
/obj/machinery/light{
	dir = 1
	},
/turf/open/floor/tile/dark/red2{
	dir = 9
	},
/area/bigredv3/inside/science/xenolab)
"Bq" = (
/obj/structure/window/framed/colony,
/turf/open/floor/plating,
/area/bigredv3/inside/wall)
"Ca" = (
/obj/effect/spawner/random/engineering/structure/tank/fuelweighted,
/turf/open/floor/plating,
/area/bigredv3/inside/science/research_office)
"Ce" = (
/obj/effect/decal/cleanable/blood,
/turf/open/floor/tile/dark,
/area/bigredv3/inside/science/xenolab)
"Ch" = (
/obj/machinery/atmospherics/components/unary/vent_pump{
	dir = 1;
	on = 1
	},
/turf/open/floor/tile/dark,
/area/bigredv3/inside/science/xenolab)
"Cm" = (
/turf/closed/mineral/smooth/bigred/indestructible,
/area/bigredv3/inside/science/research_office)
"CY" = (
/obj/effect/decal/cleanable/blood/gibs,
/turf/open/floor/plating/ground/mars/random/cave,
/area/bigredv3/caves/south)
"DG" = (
/obj/structure/cable,
/obj/machinery/power/apc/weak/ntf{
	dir = 1
	},
/turf/open/floor/plating,
/area/bigredv3/inside/science/research_office)
"Eq" = (
/obj/machinery/atmospherics/pipe/simple/green/hidden{
	dir = 4
	},
/obj/machinery/door/airlock/mainship/research/glass/free_access{
	name = "\improper Eta Lab Xenobiology Lab"
	},
/turf/open/floor/tile/dark,
/area/bigredv3/inside/science/xenolab)
"FS" = (
/turf/open/floor/tile/dark/red2{
	dir = 1
	},
/area/bigredv3/inside/science/xenolab)
"HS" = (
/obj/effect/landmark/lv624/fog_blocker,
/turf/closed/wall/r_wall,
/area/bigredv3/inside/wall)
"HT" = (
/obj/structure/closet/l3closet/scientist,
/turf/open/floor/tile/darkgreen/darkgreen2{
	dir = 1
	},
/area/bigredv3/inside/science/xenolab)
"Ik" = (
/obj/structure/closet/toolcloset,
/turf/open/floor/plating,
/area/bigredv3/inside/science/research_office)
"IX" = (
/obj/structure/fence/standard/xenoproof,
/turf/open/floor/plating/ground/mars/random/cave,
/area/bigredv3/caves/south)
"Jd" = (
/turf/closed/mineral/smooth/bigred/indestructible,
/area/space)
"JI" = (
/turf/open/floor/tile/dark/red2{
	dir = 8
	},
/area/bigredv3/inside/science/xenolab)
"Lb" = (
/turf/open/floor/tile/darkgreen/darkgreen2{
	dir = 6
	},
/area/bigredv3/inside/science/xenolab)
"Lu" = (
/obj/effect/ai_node,
/turf/open/floor/plating/ground/mars/random/cave,
/area/bigredv3/caves/south)
"LC" = (
/obj/structure/table,
/obj/item/tool/pen,
/turf/open/floor/tile/dark/red2/corner{
	dir = 4
	},
/area/bigredv3/inside/science/xenolab)
"Mk" = (
/turf/open/floor/tile/dark/red2/corner,
/area/bigredv3/inside/science/xenolab)
"MG" = (
/obj/effect/decal/cleanable/blood/oil,
/turf/open/floor/tile/dark,
/area/bigredv3/inside/science/xenolab)
"Nn" = (
/obj/effect/decal/cleanable/dirt,
/obj/effect/ai_node,
/turf/open/floor/tile/dark,
/area/bigredv3/inside/science/xenolab)
"NP" = (
/obj/structure/xenoautopsy/tank,
/turf/open/floor/tile/dark/red2/corner{
	dir = 8
	},
/area/bigredv3/inside/science/xenolab)
"OT" = (
/obj/structure/cable,
/obj/machinery/door/airlock/mainship/maint/free_access{
	name = "\improper Eta Lab Maintenance Storage"
	},
/turf/open/floor/tile/dark,
/area/bigredv3/inside/science/research_office)
"PT" = (
/turf/closed/wall/r_wall,
/area/bigredv3/inside/wall)
"PW" = (
/obj/structure/cable,
/turf/open/floor/plating,
/area/bigredv3/inside/science/research_office)
"Qf" = (
/obj/structure/fence/standard/xenoproof,
/turf/open/floor/plating/ground/mars/random/cave/rock,
/area/bigredv3/caves/south)
"Qt" = (
/turf/closed/wall,
/area/bigredv3/inside/wall)
"Qu" = (
/obj/machinery/light{
	dir = 4
	},
/obj/effect/decal/cleanable/dirt,
/obj/effect/ai_node,
/turf/open/floor/tile/dark/red2/corner,
/area/bigredv3/inside/science/xenolab)
"QI" = (
/obj/effect/landmark/lv624/fog_blocker,
/turf/closed/mineral/smooth/bigred,
/area/bigredv3/caves/rock)
"QQ" = (
/turf/open/floor/tile/darkgreen/darkgreen2{
	dir = 10
	},
/area/bigredv3/inside/science/xenolab)
"Rv" = (
/turf/open/floor/tile/dark/red2{
	dir = 6
	},
/area/bigredv3/inside/science/xenolab)
"RG" = (
/obj/structure/cable,
/obj/effect/ai_node,
/turf/open/floor/plating,
/area/bigredv3/inside/science/research_office)
"RO" = (
/turf/open/floor/plating/ground/mars/random/cave/rock,
/area/bigredv3/caves/south)
"Ta" = (
/obj/structure/closet/firecloset,
/turf/open/floor/plating,
/area/bigredv3/inside/science/research_office)
"UR" = (
/obj/machinery/door/airlock/mainship/research/glass/free_access{
	dir = 1;
	name = "\improper Eta Lab Cell"
	},
/turf/open/floor/tile/dark,
/area/bigredv3/inside/science/xenolab)
"Vd" = (
/turf/open/floor/tile/dark/red2/corner{
	dir = 8
	},
/area/bigredv3/inside/science/xenolab)
"VM" = (
/turf/open/floor/tile/darkgreen/darkgreen2{
	dir = 8
	},
/area/bigredv3/inside/science/xenolab)
"Wg" = (
/obj/machinery/atmospherics/pipe/simple/green/hidden{
	dir = 4
	},
/obj/effect/ai_node,
/turf/open/floor/tile/dark,
/area/bigredv3/inside/science/xenolab)
"Wh" = (
/obj/effect/decal/cleanable/blood/xeno,
/turf/open/floor/tile/dark/red2/corner{
	dir = 4
	},
/area/bigredv3/inside/science/xenolab)
"XM" = (
/turf/open/ground/jungle/clear,
/area/bigredv3/inside/science/xenolab)
"YD" = (
/obj/effect/landmark/lv624/fog_blocker/xeno_spawn,
/turf/open/floor/plating/ground/mars/random/cave,
/area/bigredv3/caves/south)
"Zx" = (
/turf/open/floor/plating/ground/mars/random/sand,
/area/bigredv3/inside/science/xenolab)
"ZB" = (
/obj/machinery/atmospherics/pipe/manifold/green/hidden{
	dir = 1
	},
/obj/effect/ai_node,
/turf/open/floor/tile/dark,
/area/bigredv3/inside/science/xenolab)

(1,1,1) = {"
Jd
Jd
Jd
Jd
Jd
Jd
Jd
Jd
Jd
Jd
Jd
Jd
Jd
Jd
Jd
Jd
Jd
Jd
Jd
Jd
Jd
Jd
Jd
Jd
Jd
Jd
Jd
Jd
Jd
Jd
Jd
Jd
Jd
Jd
Jd
Jd
Jd
Jd
"}
(2,1,1) = {"
Jd
Jd
Jd
Jd
Jd
Jd
Jd
Jd
Jd
Jd
Jd
Jd
Jd
Jd
Jd
Jd
Jd
Jd
Jd
Jd
Jd
Jd
Jd
Jd
Jd
Jd
Jd
Jd
Jd
Jd
Jd
Jd
Jd
Jd
Jd
Jd
Jd
Jd
"}
(3,1,1) = {"
Jd
Jd
Jd
Jd
Jd
Jd
Jd
Jd
Jd
Jd
Jd
Jd
Jd
Jd
Jd
Jd
Jd
Jd
Jd
Jd
Jd
Jd
Jd
Jd
Jd
Jd
Jd
Jd
Jd
Jd
Jd
Jd
Jd
Jd
Jd
Jd
Jd
Jd
"}
(4,1,1) = {"
Jd
Jd
Jd
Jd
Jd
Jd
Jd
Jd
Jd
Jd
Jd
Jd
Jd
Jd
Jd
Jd
Jd
Jd
Jd
Jd
Jd
Jd
Jd
Jd
Jd
Jd
Jd
Jd
Jd
Jd
Jd
Jd
Jd
Jd
Jd
Jd
Jd
Jd
"}
(5,1,1) = {"
Jd
Jd
Jd
Jd
Jd
Jd
Jd
Jd
Jd
Jd
Jd
Jd
Jd
Jd
Jd
Jd
Jd
Jd
Jd
Jd
Jd
Jd
Jd
Jd
Jd
Jd
Jd
Jd
Jd
Jd
Jd
Jd
Jd
Jd
Jd
Jd
Jd
Jd
"}
(6,1,1) = {"
Jd
Jd
Jd
Jd
Jd
Jd
Jd
Jd
Jd
Jd
Jd
Jd
Jd
Jd
Jd
Jd
Jd
Jd
Jd
Jd
Jd
Jd
Jd
Jd
Jd
Jd
Jd
Jd
Jd
Jd
Jd
Jd
Jd
Jd
Jd
Jd
Jd
Jd
"}
(7,1,1) = {"
Jd
Jd
Jd
Jd
Jd
Jd
Jd
Jd
Jd
Jd
Jd
Jd
Jd
Jd
Jd
Jd
Jd
Jd
Jd
Jd
Jd
Jd
Jd
Jd
Jd
Jd
Jd
Jd
Jd
Jd
Jd
Jd
Jd
Jd
Jd
Jd
Jd
Jd
"}
(8,1,1) = {"
Jd
Jd
Jd
Jd
Jd
Jd
Jd
Jd
Jd
Jd
Jd
Jd
Jd
Jd
Jd
Jd
Jd
Jd
Jd
Jd
Jd
Jd
Jd
Jd
Jd
Jd
Jd
Jd
Jd
Jd
Jd
Jd
Jd
Jd
Jd
Jd
Jd
Jd
"}
(9,1,1) = {"
Jd
Jd
Jd
Jd
Jd
Jd
Jd
Cm
Jd
Jd
Jd
Jd
Jd
Jd
Jd
Jd
Jd
Jd
Jd
Jd
Jd
Jd
Jd
Jd
Jd
Jd
Jd
Jd
Jd
Jd
Jd
Jd
Jd
Jd
Jd
Jd
Jd
Jd
"}
(10,1,1) = {"
Jd
Jd
Jd
Jd
Jd
Jd
Jd
Jd
Jd
Jd
Jd
Jd
Jd
Jd
Jd
Jd
Jd
Jd
Jd
Jd
Jd
Jd
Jd
Jd
Jd
Jd
Jd
Jd
Jd
Jd
Jd
Jd
Jd
Jd
Jd
Jd
Jd
Jd
"}
(11,1,1) = {"
Jd
Jd
Jd
Jd
Jd
Jd
Jd
gz
Jd
Jd
Jd
Jd
Jd
Jd
Jd
Jd
Jd
Jd
Jd
Jd
Jd
Jd
Jd
Jd
Jd
Jd
Jd
Jd
Jd
Jd
Jd
Jd
Jd
Jd
Jd
Jd
Jd
Jd
"}
(12,1,1) = {"
Jd
Jd
Jd
Jd
Jd
Jd
Jd
Jd
Jd
Jd
Jd
Jd
Jd
Jd
Jd
Jd
Jd
Jd
Jd
Jd
Jd
Jd
Jd
Jd
Jd
Jd
Jd
Jd
Jd
Jd
Jd
Jd
Jd
Jd
Jd
Jd
Jd
Jd
"}
(13,1,1) = {"
Jd
Jd
Jd
Jd
Jd
Jd
Jd
Jd
Jd
Jd
Jd
Jd
Jd
Jd
Jd
Jd
Jd
Jd
Jd
Jd
Jd
Jd
Jd
Jd
Jd
Jd
Jd
Jd
Jd
Jd
Jd
Jd
Jd
Jd
Jd
Jd
Jd
Jd
"}
(14,1,1) = {"
Jd
Jd
Jd
Jd
Jd
Jd
Jd
Jd
Jd
Jd
Jd
Jd
Jd
Jd
Jd
Jd
Jd
Jd
Jd
Jd
Jd
Jd
Jd
Jd
Jd
Jd
Jd
Jd
Jd
Jd
Jd
Jd
Jd
Jd
Jd
Jd
Jd
Jd
"}
(15,1,1) = {"
Jd
Jd
Jd
Jd
Jd
Jd
Jd
Jd
Jd
Jd
Jd
Jd
Jd
Jd
Jd
Jd
Jd
Jd
Jd
Jd
Jd
Jd
Jd
Jd
Jd
Jd
Jd
Jd
Jd
Jd
Jd
Jd
Jd
Jd
Jd
Jd
Jd
Jd
"}
(16,1,1) = {"
Jd
Jd
Jd
Jd
Jd
Jd
Jd
Jd
Jd
Jd
Jd
Jd
Jd
Jd
Jd
Jd
Jd
Jd
Jd
Jd
Jd
Jd
Jd
Jd
Jd
Jd
Jd
Jd
Jd
Jd
Jd
Jd
Jd
Jd
Jd
Jd
Jd
Jd
"}
(17,1,1) = {"
Jd
Jd
Jd
Jd
Jd
Jd
Jd
Jd
Jd
Jd
Jd
Jd
Jd
Jd
Jd
Jd
Jd
Jd
Jd
Jd
Jd
Jd
Jd
Jd
Jd
Jd
Jd
Jd
Jd
Jd
Jd
Jd
Jd
Jd
Jd
Jd
Jd
Jd
"}
(18,1,1) = {"
Jd
Jd
Jd
Jd
Jd
Jd
Jd
Jd
Jd
Jd
Jd
Jd
Jd
Jd
Jd
Jd
Jd
Jd
Jd
Jd
Jd
Jd
Jd
Jd
Jd
Jd
Jd
Jd
Jd
Jd
Jd
Jd
Jd
Jd
Jd
Jd
Jd
Jd
"}
(19,1,1) = {"
dO
dO
dO
dO
dO
dO
dO
dO
dO
dO
dO
dO
dO
dO
dO
dO
dO
dO
dO
er
er
er
er
er
er
er
er
er
er
er
dO
dO
Jd
Jd
Jd
Jd
Jd
Jd
"}
(20,1,1) = {"
dO
dO
dO
dO
dO
dO
dO
dO
dO
dO
dO
dO
dO
dO
dO
dO
dO
dO
dO
er
dO
dO
dO
dO
dO
dO
dO
dO
dO
er
dO
dO
Jd
Jd
Jd
Jd
Jd
Jd
"}
(21,1,1) = {"
dO
dO
dO
dO
dO
dO
dO
dO
dO
dO
dO
dO
dO
dO
dO
dO
dO
dO
dO
er
dO
dO
dO
pu
Lu
pu
dO
dO
dO
er
dO
dO
Jd
Jd
Jd
Jd
Jd
Jd
"}
(22,1,1) = {"
dO
dO
dO
dO
dO
dO
dO
dO
dO
dO
dO
dO
dO
dO
pu
pu
Lu
pu
dO
er
dO
dO
pu
RO
pu
pu
pu
dO
dO
er
dO
dO
Jd
Jd
Jd
Jd
Jd
Jd
"}
(23,1,1) = {"
dO
dO
dO
dO
dO
dO
dO
dO
dO
dO
dO
dO
dO
dO
pu
RO
pu
pu
pu
er
dO
pu
pu
pu
pu
pu
ja
pu
dO
er
dO
dO
Jd
Jd
Jd
Jd
Jd
Jd
"}
(24,1,1) = {"
dO
dO
dO
dO
dO
dO
dO
dO
dO
dO
dO
dO
pu
RO
pu
pu
pu
pu
pu
YD
pu
pu
pu
pu
pu
pu
pu
pu
dO
er
dO
dO
Jd
Jd
Jd
Jd
Jd
Jd
"}
(25,1,1) = {"
dO
dO
dO
dO
dO
dO
dO
dO
dO
dO
dO
pu
Lu
pu
pu
pu
Lu
RO
pu
YD
Lu
pu
pu
pu
Lu
pu
pu
Lu
dO
er
dO
dO
Jd
Jd
Jd
Jd
Jd
Jd
"}
(26,1,1) = {"
dO
dO
dO
dO
dO
dO
dO
dO
dO
pu
pu
pu
pu
pu
pu
pu
pu
pu
pu
YD
pu
pu
pu
RO
pu
pu
pu
RO
dO
er
dO
dO
Jd
Jd
Jd
Jd
Jd
Jd
"}
(27,1,1) = {"
dO
dO
dO
dO
dO
dO
dO
dO
dO
pu
pu
pu
pu
pu
pu
dO
dO
pu
pu
YD
pu
pu
pu
pu
pu
pu
pu
pu
dO
er
dO
dO
Jd
Jd
Jd
Jd
Jd
Jd
"}
(28,1,1) = {"
dO
dO
dO
dO
dO
dO
dO
dO
dO
pu
pu
RO
pu
pu
dO
dO
dO
dO
pu
YD
pu
pu
pu
pu
Lu
pu
pu
dO
dO
er
dO
dO
Jd
Jd
Jd
Jd
Jd
Jd
"}
(29,1,1) = {"
dO
dO
dO
dO
dO
dO
dO
dO
pu
Lu
pu
pu
Lu
dO
dO
dO
dO
dO
dO
YD
Lu
pu
pu
pu
pu
Lu
pu
dO
dO
er
dO
dO
Jd
Jd
Jd
Jd
Jd
Jd
"}
(30,1,1) = {"
dO
dO
dO
dO
dO
dO
dO
pu
pu
pu
pu
pu
dO
dO
dO
dO
dO
dO
dO
er
YD
YD
YD
iO
YD
YD
YD
YD
er
er
dO
dO
dO
dO
dO
dO
dO
Jd
"}
(31,1,1) = {"
dO
dO
dO
dO
dO
dO
dO
RO
pu
pu
pu
pu
dO
dO
dO
dO
dO
dO
dO
dO
pu
pu
pu
RO
pu
pu
pu
pu
dO
dO
dO
dO
dO
dO
dO
dO
dO
Jd
"}
(32,1,1) = {"
dO
dO
dO
dO
dO
dO
pu
pu
pu
pu
pu
pu
dO
dO
dO
dO
dO
dO
dO
dO
dO
dO
pu
pu
pu
pu
pu
RO
pu
dO
dO
dO
dO
dO
dO
dO
dO
Jd
"}
(33,1,1) = {"
dO
dO
dO
dO
dO
dO
pu
pu
pu
pu
pu
pu
dO
dO
dO
dO
dO
dO
dO
dO
dO
dO
dO
pu
pu
Lu
pu
pu
pu
Lu
dO
dO
dO
dO
dO
dO
dO
Jd
"}
(34,1,1) = {"
dO
dO
dO
dO
dO
dO
pu
RO
pu
pu
pu
RO
RO
dO
dO
dO
dO
dO
dO
dO
dO
dO
dO
dO
pu
pu
pu
pu
pu
pu
dO
dO
dO
dO
dO
dO
dO
Jd
"}
(35,1,1) = {"
dO
dO
dO
dO
dO
dO
fP
pu
pu
Lu
pu
pu
fP
dO
dO
dO
dO
dO
dO
dO
dO
dO
dO
dO
dO
pu
RO
pu
pu
pu
dO
dO
dO
dO
dO
dO
dO
Jd
"}
(36,1,1) = {"
dO
dO
dO
dO
dO
dO
pu
pu
pu
pu
pu
pu
pu
dO
dO
dO
dO
dO
dO
dO
dO
dO
dO
dO
dO
pu
RO
pu
pu
pu
dO
dO
dO
dO
dO
dO
dO
Jd
"}
(37,1,1) = {"
dO
dO
dO
dO
pu
pu
pu
pu
pu
pu
pu
pu
pu
dO
dO
dO
dO
dO
dO
dO
dO
dO
dO
dO
dO
pu
pu
pu
pu
pu
dO
dO
dO
dO
dO
dO
dO
Jd
"}
(38,1,1) = {"
dO
dO
dO
pu
pu
pu
pu
pu
pu
pu
pu
pu
pu
pu
pu
dO
dO
dO
dO
dO
dO
dO
dO
dO
dO
RO
pu
RO
pu
pu
dO
dO
dO
dO
dO
dO
dO
Jd
"}
(39,1,1) = {"
pu
pu
pu
pu
pu
pu
pu
pu
pu
pu
pu
pu
pu
pu
pu
pu
pu
pu
pu
pu
pu
dO
dO
dO
dO
pu
pu
RO
pu
pu
dO
dO
dO
dO
dO
dO
dO
Jd
"}
(40,1,1) = {"
pu
RO
pu
pu
RO
RO
pu
pu
pu
pu
pu
pu
pu
pu
pu
pu
pu
pu
pu
pu
pu
pu
dO
dO
pu
Lu
pu
pu
pu
Lu
dO
dO
dO
dO
dO
dO
dO
Jd
"}
(41,1,1) = {"
pu
Lu
pu
pu
pu
pu
pu
pu
pu
Lu
pu
RO
RO
RO
RO
RO
RO
pu
RO
fP
RO
pu
pu
pu
Lu
pu
pu
pu
pu
dO
dO
dO
dO
dO
dO
dO
dO
Jd
"}
(42,1,1) = {"
pu
pu
pu
pu
pu
pu
pu
pu
pu
pu
pu
pu
pu
pu
pu
pu
pu
pu
pu
pu
pu
pu
RO
pu
pu
pu
pu
pu
dO
dO
dO
dO
dO
dO
dO
dO
dO
Jd
"}
(43,1,1) = {"
pu
dO
dO
dO
dO
dO
dO
RO
pu
pu
pu
pu
pu
pu
pu
pu
pu
pu
pu
pu
pu
pu
pu
pu
pu
pu
pu
pu
dO
dO
dO
dO
dO
dO
dO
dO
dO
Jd
"}
(44,1,1) = {"
dO
dO
dO
dO
dO
dO
dO
dO
dO
dO
dO
dO
dO
dO
dO
dO
dO
pu
dO
dO
RO
RO
dO
RO
pu
pu
pu
pu
dO
dO
dO
dO
dO
dO
dO
dO
dO
Jd
"}
(45,1,1) = {"
dO
dO
dO
dO
dO
dO
dO
dO
dO
dO
dO
dO
dO
dO
dO
dO
dO
dO
dO
dO
dO
dO
dO
dO
pu
pu
pu
pu
pu
dO
dO
dO
dO
dO
dO
dO
dO
Jd
"}
(46,1,1) = {"
QI
QI
QI
QI
QI
QI
QI
QI
QI
QI
QI
QI
QI
QI
QI
QI
QI
QI
QI
QI
QI
QI
dO
dO
RO
pu
pu
pu
pu
pu
dO
dO
dO
dO
dO
dO
dO
Jd
"}
(47,1,1) = {"
PT
PT
PT
PT
PT
PT
PT
PT
PT
PT
PT
PT
PT
PT
PT
PT
PT
PT
PT
PT
PT
PT
HS
dO
pu
pu
pu
pu
pu
pu
pu
dO
dO
dO
dO
dO
dO
Jd
"}
(48,1,1) = {"
Bf
JI
JI
bJ
PT
NP
kP
NP
NP
kP
PT
Zx
ab
Zx
PT
Zx
ab
Zx
PT
Zx
ab
Zx
HS
dO
IX
Lu
pu
pu
pu
pu
Lu
dO
dO
dO
dO
dO
dO
Jd
"}
(49,1,1) = {"
FS
jH
ge
ge
UR
ge
ge
jH
ge
Vd
PT
Zx
co
Zx
PT
Zx
co
Zx
PT
Zx
Zx
Zx
kT
RO
Qf
pu
pu
pu
pu
pu
pu
dO
dO
dO
dO
dO
dO
Jd
"}
(50,1,1) = {"
FS
ge
ge
oJ
PT
Wh
fG
fG
ge
gN
PT
Zx
Zx
Zx
PT
Zx
Zx
Zx
PT
Zx
Zx
Zx
HS
pu
IX
pu
pu
pu
pu
pu
pu
dO
dO
dO
dO
dO
dO
Jd
"}
(51,1,1) = {"
eA
ge
ge
oJ
jg
pU
fG
fG
ge
mB
PT
dV
qb
dV
PT
dV
dL
dV
PT
dV
dL
dV
HS
pu
IX
pu
pu
RO
pu
pu
pu
pu
dO
dO
dO
dO
dO
Jd
"}
(52,1,1) = {"
FS
ge
ge
oJ
jg
pP
fG
fG
ge
Vd
Qt
ur
ge
ur
Qt
ur
ge
ur
Qt
ur
ge
ur
HS
pu
IX
pu
pu
RO
pu
pu
pu
pu
pu
dO
dO
dO
dO
Jd
"}
(53,1,1) = {"
eA
ge
ge
oJ
jg
zk
ge
fG
fG
ge
Vd
Vd
ge
Vd
sC
Vd
ge
Vd
Vd
Vd
fG
Vd
HS
pu
IX
pu
pu
RO
pu
pu
pu
pu
pu
dO
dO
dO
dO
Jd
"}
(54,1,1) = {"
FS
jH
ge
oJ
jg
wn
ge
bp
fG
fG
Ce
fG
fG
fG
ge
fG
fG
fG
ge
fG
ge
ge
HS
pu
IX
pu
pu
RO
pu
pu
pu
pu
pu
dO
dO
dO
dO
Jd
"}
(55,1,1) = {"
FS
ge
ge
oJ
jg
LC
MG
Wg
fG
fG
Qu
lP
Nn
lP
lP
lP
Nn
lP
Qu
Mk
ge
Mk
nV
pu
IX
Lu
pu
pu
pu
pu
Lu
pu
Lu
dO
dO
dO
dO
Jd
"}
(56,1,1) = {"
oK
wT
wT
Rv
jg
wH
Mk
tZ
Mk
ex
Qt
lp
ge
lp
Qt
lp
ge
lp
Qt
lp
ge
lp
HS
dO
Qf
pu
pu
pu
pu
pu
pu
pu
pu
pu
dO
dO
dO
Jd
"}
(57,1,1) = {"
PT
PT
PT
PT
PT
Qt
Bq
Eq
Bq
Qt
PT
dV
dL
dV
PT
dV
dL
dV
PT
dV
dL
dV
HS
dO
dO
dO
dO
pu
pu
pu
pu
pu
pu
pu
dO
dO
dO
Jd
"}
(58,1,1) = {"
Ca
PW
PW
DG
Qt
Ap
VM
tZ
VM
QQ
PT
XM
XM
XM
PT
XM
XM
XM
PT
XM
XM
XM
HS
dO
dO
dO
dO
pu
dO
dO
pu
pu
pu
pu
pu
dO
dO
Jd
"}
(59,1,1) = {"
eM
RG
dp
Ta
Qt
HT
ge
ZB
Ch
hm
PT
XM
XM
XM
PT
XM
XM
XM
PT
XM
XM
XM
HS
dO
dO
dO
dO
dO
dO
dO
dO
pu
pu
pu
pu
dO
dO
Jd
"}
(60,1,1) = {"
Ca
PW
dp
Ik
Qt
is
zV
tZ
zV
Lb
PT
XM
bZ
XM
PT
XM
bZ
XM
PT
XM
bZ
XM
HS
QI
QI
QI
QI
QI
QI
QI
dO
pu
Lu
CY
pu
dO
dO
Jd
"}
(61,1,1) = {"
Qt
OT
Qt
Qt
Qt
Qt
Bq
Eq
Bq
Qt
PT
PT
PT
PT
PT
PT
PT
PT
PT
PT
PT
PT
PT
PT
PT
PT
PT
PT
PT
QI
dO
pu
pu
pu
pu
dO
dO
Jd
"}
