//MAP CONVERTED BY dmm2tgm.py THIS HEADER COMMENT PREVENTS RECONVERSION, DO NOT REMOVE
"ad" = (
/turf/closed/mineral/smooth/bigred,
/area/bigredv2/caves/rock)
"ae" = (
/turf/open/floor/plating/ground/mars/random/cave,
/area/bigredv2/caves/east/garbledradio)
"ag" = (
/obj/effect/landmark/excavation_site_spawner,
/turf/open/floor/plating/ground/mars/random/cave,
/area/bigredv2/caves/east/garbledradio)
"ah" = (
/obj/machinery/miner/damaged/platinum,
/turf/open/floor/plating/ground/mars/random/cave,
/area/bigredv2/caves/east/garbledradio)
"ak" = (
/obj/machinery/miner/damaged/platinum,
/turf/open/floor/plating/ground/mars/random/cave,
/area/bigredv2/caves/east)
"am" = (
/obj/effect/ai_node,
/turf/open/floor/plating/ground/mars/random/cave,
/area/bigredv2/caves/east)
"ao" = (
/turf/open/floor/plating/ground/mars/random/cave,
/area/bigredv2/caves/east)
"ap" = (
/turf/open/floor/plating/ground/mars/random/cave/rock,
/area/bigredv2/caves/east)
"aq" = (
/obj/docking_port/stationary/crashmode,
/turf/closed/mineral/smooth/bigred,
/area/bigredv2/caves/rock)
"ar" = (
/obj/effect/ai_node,
/turf/open/floor/plating/ground/mars/random/cave,
/area/bigredv2/caves/east/garbledradio)
"as" = (
/obj/effect/landmark/lv624/fog_blocker,
/turf/closed/mineral/smooth/bigred,
/area/bigredv2/caves/rock)
"au" = (
/obj/effect/landmark/lv624/fog_blocker/xeno_spawn,
/turf/closed/mineral/smooth/bigred,
/area/bigredv2/caves/rock)
"aB" = (
/turf/open/floor/plating/ground/mars/random/cave/rock,
/area/bigredv2/caves/east/garbledradio)
"aE" = (
/obj/effect/landmark/lv624/fog_blocker/xeno_spawn,
/turf/open/floor/plating/ground/mars/random/cave/rock,
/area/bigredv2/caves/east/garbledradio)
"aG" = (
/obj/effect/landmark/lv624/fog_blocker/xeno_spawn,
/obj/effect/landmark/lv624/fog_blocker/xeno_spawn,
/turf/closed/mineral/smooth/bigred,
/area/bigredv2/caves/rock)
"aH" = (
/obj/effect/landmark/lv624/fog_blocker/xeno_spawn,
/obj/effect/landmark/lv624/fog_blocker/xeno_spawn,
/turf/open/floor/plating/ground/mars/random/cave,
/area/bigredv2/caves/east/garbledradio)
"aK" = (
/obj/effect/landmark/xeno_silo_spawn,
/turf/open/floor/plating/ground/mars/random/cave,
/area/bigredv2/caves/east/garbledradio)
"aN" = (
/obj/effect/landmark/excavation_site_spawner,
/turf/open/floor/plating/ground/mars/random/cave,
/area/bigredv2/caves/east)
"aP" = (
/turf/open/floor/plating/ground/mars/random/sand,
/area/bigredv2/outside/se)
"aQ" = (
/obj/structure/fence/standard/xenoproof,
/obj/effect/landmark/lv624/fog_blocker,
/turf/open/floor/plating/ground/mars/random/cave,
/area/bigredv2/caves/east/garbledradio)
"aR" = (
/obj/effect/landmark/lv624/fog_blocker/xeno_spawn,
/turf/open/floor/plating/ground/mars/random/cave,
/area/bigredv2/caves/east)
"aS" = (
/obj/effect/ai_node,
/turf/open/floor/plating/ground/mars/random/sand,
/area/bigredv2/outside/se)
"aT" = (
/obj/docking_port/stationary/crashmode,
/turf/open/floor/plating/ground/mars/random/cave,
/area/bigredv2/caves/east/garbledradio)
"aW" = (
/obj/effect/landmark/lv624/fog_blocker/xeno_spawn,
/turf/open/floor/plating/ground/mars/random/cave,
/area/bigredv2/caves/east/garbledradio)
"aZ" = (
/turf/closed/mineral/smooth/bigred/indestructible,
/area/space)
"uH" = (
/obj/effect/landmark/xeno_tunnel_spawn,
/turf/open/floor/plating/ground/mars/random/cave,
/area/bigredv2/caves/east/garbledradio)
"wM" = (
/obj/effect/ai_node,
/turf/open/floor/plating/ground/mars/random/cave/rock,
/area/bigredv2/caves/east/garbledradio)

(1,1,1) = {"
aP
aP
aP
aP
aP
aP
aP
aP
aP
aP
aP
ad
ad
ad
aQ
ae
ae
ae
ae
ae
ae
ae
ae
ae
ae
ae
ae
ae
ad
ad
ad
ad
ad
ad
ad
ad
ad
ae
ae
ae
ae
ae
"}
(2,1,1) = {"
aP
aP
aP
aP
aP
aP
aP
aP
aP
aP
aP
ad
ad
ad
as
ae
ae
ae
ae
ae
ae
ae
ae
ae
ae
ae
ae
ae
ad
ad
ad
ad
ad
ad
ad
ad
ad
ad
ae
ae
ar
ae
"}
(3,1,1) = {"
aP
aP
aP
aP
aP
aP
aP
aP
aP
aP
aP
ad
ad
ad
as
ae
ae
ae
ae
ae
ae
ad
ad
ad
ad
ad
ae
ae
ae
ad
ad
ad
ad
ad
ad
ad
ad
ad
ae
ae
ae
ae
"}
(4,1,1) = {"
aP
ad
ad
ad
ad
aP
aP
aP
aP
aP
aP
aP
ad
ad
as
ae
ae
ae
ae
ae
ae
ad
ad
ad
ad
ad
aB
ae
ae
ae
ae
ae
ae
ae
ae
ad
aB
aB
ae
ae
ae
ae
"}
(5,1,1) = {"
aP
ad
ad
ad
ad
ad
ad
aP
aP
aP
aP
aP
aP
ad
as
ad
ae
aH
aW
aR
au
au
au
au
au
au
aW
aE
aH
ae
ae
ae
ae
ae
ae
aB
ae
ae
ae
ae
ae
ae
"}
(6,1,1) = {"
aP
aP
ad
ad
ad
ad
ad
ad
aP
aP
aP
aP
aP
ad
as
ad
ad
aW
ae
ad
ad
ad
ad
ad
ad
ae
ae
ae
aE
aB
ar
ae
ae
ae
ae
ae
ae
ae
ae
ae
ar
aB
"}
(7,1,1) = {"
aP
aP
aP
aP
aP
aP
aP
aP
aP
aP
aP
aP
aP
ad
as
ad
ad
aW
ae
ae
ae
ad
ae
ad
ad
ae
ar
ae
aW
ar
ae
ae
ae
ae
ae
ae
ae
ae
ae
ah
ae
aB
"}
(8,1,1) = {"
aP
aP
aP
aP
aP
aP
aP
aP
aP
aP
aP
aP
aP
ad
as
ad
ad
au
ae
ae
ae
ar
ae
ae
ar
ae
ae
ae
aW
ae
ae
ae
ae
ae
ae
ae
aB
ae
ae
ae
aB
ad
"}
(9,1,1) = {"
aP
aP
aP
aP
aP
aS
aP
aP
aP
aS
aP
aP
aP
ad
as
ad
ad
au
ae
ae
ae
ae
ae
ae
ae
ae
ae
ad
au
ad
ad
ad
ae
ae
ae
ae
ae
aB
ae
ae
ae
aB
"}
(10,1,1) = {"
aP
aP
aP
aP
aP
aP
aP
aP
aP
aP
aP
aP
ad
ad
as
ad
ad
au
ad
ad
ae
ae
ae
ae
ae
ad
ad
ad
au
ad
ad
ad
ad
ad
ad
ad
ae
ae
ae
ae
ae
aB
"}
(11,1,1) = {"
aP
aP
ad
aP
aP
aP
aP
aP
aP
aP
aP
ad
ad
ad
as
ad
ad
au
ad
ae
ae
ae
ae
ae
ae
ae
ad
ad
au
ad
ad
ad
ad
ad
ad
ad
ae
ae
ae
ae
ae
aB
"}
(12,1,1) = {"
aP
ad
ad
aP
aP
aP
aP
aP
aP
ad
ad
ad
ad
ad
as
ad
ad
au
ae
aB
ae
ae
aB
ae
ae
ae
ad
ad
au
ad
ad
ad
ad
ad
ad
ad
ae
ae
ae
ae
ae
aB
"}
(13,1,1) = {"
ad
ad
ad
aP
aP
aP
aP
aP
aP
ad
ad
ad
ad
ad
as
ad
ad
au
ae
ae
ae
ae
ae
ae
ae
ae
ad
ad
au
ad
ad
ad
ad
ad
ad
ad
aB
ae
ae
ae
aB
ad
"}
(14,1,1) = {"
ad
ad
aP
aP
aP
aP
aP
aP
aP
ad
ad
ad
ad
ad
as
ad
ad
au
ae
ae
ae
ar
aK
ae
ae
ae
ae
ad
au
ad
ad
ad
ad
ad
ad
ad
ae
ae
ae
ae
ar
aB
"}
(15,1,1) = {"
ad
aP
aP
aP
aP
aP
ad
ad
ad
ad
ad
ad
ad
ad
as
ad
ad
au
ae
ae
ae
ae
ae
ae
ae
ae
ad
ad
au
ad
ad
ad
ad
ad
ad
ad
ad
aB
ae
ae
ae
aB
"}
(16,1,1) = {"
aP
aP
aP
aP
aP
aS
ad
ad
ad
ad
ad
ad
ad
ad
as
ad
ad
au
ad
ae
ae
ae
ae
ae
ae
ad
ad
ad
au
ad
ad
ad
ad
ad
ad
ad
ad
ad
ae
ae
ae
ae
"}
(17,1,1) = {"
aP
aP
aP
aP
aP
aP
ad
ad
ad
ad
ad
ad
ad
ad
as
ad
ad
au
ad
ae
ae
uH
ae
ae
ad
ad
ad
ad
au
ad
ad
ad
ad
ad
ad
ad
ad
ad
ae
ae
ae
ae
"}
(18,1,1) = {"
ad
ad
ad
ad
ad
ad
ad
ad
ad
ad
ad
ad
ad
ad
as
ad
ad
aG
au
aW
aW
aW
aW
aW
au
au
au
au
aG
ad
ad
ad
ad
ad
ad
ad
ae
ae
ae
ae
ae
ae
"}
(19,1,1) = {"
as
as
as
as
as
as
as
as
as
as
as
as
as
as
as
ad
ad
ad
ad
ad
ad
ae
ae
ae
ad
ad
ad
ad
ad
ad
ad
ad
ad
ad
ad
ae
ae
ae
ae
ae
ae
ae
"}
(20,1,1) = {"
ad
ad
ad
ad
ad
ad
ad
ad
ad
ad
ad
ad
ad
ad
ad
ad
ad
ad
ad
ad
ad
ad
ad
ad
ad
aq
ad
ad
ad
ad
ad
ad
ad
ad
ae
ae
ae
ae
ae
ae
ae
ae
"}
(21,1,1) = {"
ad
ad
ad
ad
ad
ad
ad
ad
ad
ad
ad
ad
ad
ad
ad
ad
ad
ad
ad
ad
ad
ad
ad
ad
ad
ad
ad
ad
ad
ad
ad
ad
ad
ad
ae
ae
ae
ae
ae
aB
ae
ae
"}
(22,1,1) = {"
ad
aB
aB
wM
aB
aB
ad
ad
ad
ad
ad
ad
ad
ad
ad
ad
ad
ad
ad
ad
ad
ad
ad
ad
ad
ad
ad
ad
ad
ad
ad
ad
ad
ad
ae
ae
ae
ae
ae
ae
ae
ae
"}
(23,1,1) = {"
ad
ae
ae
ae
ae
ae
aB
ad
ad
ad
ad
ad
ad
ad
ad
ad
ad
ad
ad
ad
ad
ad
ad
ad
ad
ad
ad
ad
ad
ad
ad
ad
ad
ad
ae
ae
aB
ad
ad
ae
ae
ae
"}
(24,1,1) = {"
ad
aB
ae
ae
ae
ae
aB
ad
ad
ad
ad
ad
ad
ad
ad
ad
ad
ad
ad
ad
ad
ad
ad
ad
ad
ad
ad
ad
ad
ad
ad
ad
ad
ad
ad
ae
aB
ad
ad
ae
ae
ae
"}
(25,1,1) = {"
ad
ad
ad
wM
ae
ae
aB
ae
ar
ae
ae
ad
ad
ad
ad
ad
ad
ad
ad
ad
ad
ad
ad
ad
ad
ad
ad
ad
ad
ad
ad
ad
ad
ad
ad
ad
ad
ad
ad
ae
ae
ae
"}
(26,1,1) = {"
ad
ad
ad
ad
ad
ae
aB
ae
ae
ae
ae
ad
ad
ad
ad
ad
ad
ad
ad
ad
ad
ad
ad
ad
ad
au
au
au
au
au
au
au
au
au
au
au
ad
ad
ad
ad
ae
ae
"}
(27,1,1) = {"
aB
aB
aB
aB
aB
ae
aB
ae
ae
ae
ae
aB
ad
ad
ad
ad
ad
ad
ad
ad
ad
ad
ad
ad
ad
au
ad
ad
ad
ad
ad
ad
ad
ad
ad
au
ad
ad
ad
ad
ar
ae
"}
(28,1,1) = {"
ar
ae
ae
ae
ae
ar
ae
aB
wM
aB
aB
ae
ad
ad
ad
ad
ad
ad
ad
ad
ad
ad
ad
ad
ad
au
ad
ad
ad
ae
ae
ad
ad
ad
ad
au
ad
ad
ad
ad
ae
ae
"}
(29,1,1) = {"
ae
ae
ae
ae
ae
ae
ae
ae
ae
ae
ae
ad
ad
ad
ad
ad
ad
ad
ad
ad
ad
ad
ad
ad
ad
au
ad
ad
ae
ae
ae
ae
ad
ad
ad
au
ad
ad
ad
ad
ad
ae
"}
(30,1,1) = {"
ae
ae
ae
ae
ae
ae
ae
ae
ae
ae
ae
ad
ad
ad
ad
ad
ad
ad
ad
ad
ad
ad
ad
ad
ad
au
ad
ad
ae
ae
aK
ae
ae
ad
ad
au
ad
ad
ad
ad
ad
ad
"}
(31,1,1) = {"
ae
ae
ae
ae
ag
ae
ae
ae
ae
ad
ad
ad
ad
ad
ad
ad
ad
ad
ad
ad
ad
ad
ad
ad
ad
au
ad
ad
ae
ae
ae
ae
ae
ad
ad
au
ad
ad
ad
ad
ad
ad
"}
(32,1,1) = {"
aB
ae
ae
ae
ae
ae
ae
ad
ad
ad
ad
ad
ad
ad
ad
ad
ad
ad
ad
ad
ad
ad
ad
ad
ad
au
ad
ae
ae
ae
ae
ae
ae
uH
ad
au
ad
ad
ad
ad
ad
ad
"}
(33,1,1) = {"
ae
ae
ae
ae
ah
ae
ae
ad
ad
ad
ad
ad
ad
ad
ad
ad
ad
ad
ad
ae
ad
ad
ad
ad
ad
au
ad
ae
ae
ae
ae
ae
ae
ae
ad
au
ad
ad
ad
ad
ad
ad
"}
(34,1,1) = {"
aB
ae
ae
aB
ae
ae
ae
ad
ad
ad
ad
ae
ad
ad
ad
ad
ad
ad
ae
ae
ae
ad
ad
ad
ae
aW
ae
ae
ae
ae
ae
ae
ae
ae
ad
au
ad
ad
ad
ad
ad
ad
"}
(35,1,1) = {"
ad
aB
ae
ae
ae
ae
ae
ae
ad
ad
ad
ae
ae
ae
ad
ad
ad
ae
ae
ae
ae
ae
ae
ae
ae
aW
aW
aW
aW
aW
aW
aW
aW
aW
aW
au
ad
ad
ad
ad
ad
ad
"}
(36,1,1) = {"
ad
ad
ad
ae
ae
aB
ae
ae
ae
ad
ad
ae
ae
ae
ae
ae
ae
ae
ae
ae
ae
ae
ae
ae
ae
ae
ae
ae
ae
ae
ae
ae
ae
ae
ae
ae
ad
ad
ad
ad
ad
ae
"}
(37,1,1) = {"
ad
ad
ad
ae
ae
aB
ae
ae
aT
aB
ae
ae
ae
ae
ae
ae
ae
ae
ae
ae
ae
ae
ae
ae
ae
ae
ae
ae
ae
ae
ae
ae
ae
ae
ae
ae
ae
ae
ae
ae
ae
ae
"}
(38,1,1) = {"
ad
ad
ad
ae
ae
ar
ae
ae
ae
ae
ae
ae
ae
ae
ae
ae
ar
ae
ae
ae
ae
ae
ae
ar
ae
ae
ae
ae
ae
ae
ae
ar
ae
ag
ae
ae
ae
ae
ae
ar
ae
ae
"}
(39,1,1) = {"
ad
ad
ad
ad
ae
ae
ag
ae
ae
ae
ae
ae
ae
ae
ae
ae
ae
ae
ae
ae
ae
ae
ae
ae
ae
ae
ae
ae
ae
ae
ae
ae
ae
ae
ae
ae
ae
ae
ae
ae
ae
ae
"}
(40,1,1) = {"
ad
ad
ad
ad
ae
ae
ae
ae
ae
ae
ae
ae
ae
ae
ae
ae
ae
ae
ae
ae
ae
ae
ae
ae
ae
ae
ae
ae
ae
ae
ae
ae
ae
ae
ae
ae
ae
ae
ae
ae
ae
ae
"}
(41,1,1) = {"
ad
ad
ad
ae
ae
ae
ae
ae
ae
ae
ae
ae
ae
ae
ae
ag
ae
ae
ae
ae
ae
ae
ae
ae
ae
ae
ae
ae
ae
ae
ae
ae
ae
ae
ae
ae
ae
ae
ae
ae
ae
ae
"}
(42,1,1) = {"
ad
ad
ad
ae
ae
ae
ae
ao
ao
ao
ae
ae
ao
ae
ae
ao
ae
ae
ae
ao
ao
ae
ae
ae
ao
ae
ae
ao
ae
ae
ae
am
ae
ae
ae
ae
ao
ae
ae
ar
ae
ao
"}
(43,1,1) = {"
ad
ad
ao
ao
ao
am
ao
ao
ao
ao
ao
ao
ao
ao
ao
ao
am
ao
ao
ao
ao
ao
ao
am
ao
ao
ao
ao
ao
ao
ao
ao
ao
ao
ao
ao
ao
ao
ao
ao
ao
ao
"}
(44,1,1) = {"
ad
ad
ao
ao
ao
ao
ao
ao
ao
ao
ao
ao
ao
ao
ao
ao
ao
ao
ao
ao
ao
ao
ao
ao
ao
ao
ao
ao
ao
ao
ao
ao
ao
ao
ao
ao
ao
ao
ao
ao
ao
ao
"}
(45,1,1) = {"
ad
ad
ao
ao
ao
ao
ao
ao
ao
ao
ao
ao
ao
ao
ao
ao
ao
ao
ao
ao
ao
ao
ao
ao
ao
ao
ao
ao
ao
ao
ao
ao
ao
ao
ao
ao
ao
ao
ao
ao
ao
ao
"}
(46,1,1) = {"
ao
ao
ao
ao
ao
ao
ao
ao
ao
ao
ao
ao
ao
ao
ao
ao
ao
ao
ao
ao
ao
ao
ao
ao
ao
ao
aN
ao
ao
ao
ao
ao
ao
ao
ao
ao
ao
ao
ao
ao
ao
ao
"}
(47,1,1) = {"
ao
ao
ao
ao
ao
ao
am
ao
ao
ao
ao
ao
ao
ao
ao
ao
am
ao
ao
ao
ao
ao
am
ao
ao
ao
ao
ao
ao
ao
ao
ao
ao
ao
ao
ao
ao
ao
ao
ao
ao
ao
"}
(48,1,1) = {"
am
ao
ao
ao
ao
am
aN
ao
ao
ao
ao
ao
ao
ao
ao
ao
ao
ao
ao
ak
ao
ao
ao
am
ao
ao
ao
ao
ao
ao
ao
am
ao
ao
ao
ao
ao
ao
ao
am
ao
ao
"}
(49,1,1) = {"
ao
ao
ao
ao
ao
ao
ao
ao
ao
ao
ao
ao
ao
ao
ao
ao
ao
ao
ao
ao
ao
ao
ao
ao
ao
ao
ao
ao
ao
ao
ao
ao
ao
ao
ao
ao
ao
ao
ao
ao
ao
ao
"}
(50,1,1) = {"
ao
ao
ao
ao
ao
ao
ao
ao
ao
ad
ad
ad
ad
ao
ao
ao
ao
ao
ao
ao
ao
ao
ao
ao
ao
ao
ao
ao
ao
ao
ao
ao
ao
ao
ao
ao
ao
ao
ao
ao
ao
ao
"}
(51,1,1) = {"
ao
ao
ao
ao
ao
ao
ao
ao
ao
ad
ad
ad
ad
ad
ao
ao
ao
ao
ao
ao
ao
ao
ao
ao
ao
ao
ao
ao
ao
ao
ad
ad
ad
ao
ao
ao
ao
ao
ao
ao
ao
ao
"}
(52,1,1) = {"
ao
ap
ao
ao
ao
ao
ao
ad
ad
ad
ad
ad
ad
ad
ad
ad
ad
ad
ad
ad
ad
ad
ao
ao
ao
ao
ao
ao
ao
ad
ad
ad
ad
ad
ao
ao
aN
ao
ao
am
ao
ao
"}
(53,1,1) = {"
am
ao
ao
ao
ad
ad
ad
ad
ad
ad
ad
ad
ad
ad
ad
ad
ad
ad
ad
ad
ad
ad
ad
ap
ao
ao
ao
ao
ad
ad
ad
ad
ad
ad
ap
ao
ao
ao
ao
ao
ao
ao
"}
(54,1,1) = {"
ao
ao
ao
ao
ad
ad
ad
ad
ad
ad
ad
ad
ad
ad
ad
ad
ad
ad
ad
ad
ad
ad
ad
ad
ao
ao
ao
ao
ao
ad
ad
ad
ad
ad
ad
ad
ao
ao
ao
ao
ao
ao
"}
(55,1,1) = {"
ao
ao
ao
ad
ad
ad
ad
ad
ad
ad
ad
ad
ad
ad
ad
ad
ad
ad
ad
ad
ad
ad
ad
ad
ao
ao
ao
ao
ao
ao
ad
ad
ad
ad
ad
ad
ad
ad
ad
ao
ao
ao
"}
(56,1,1) = {"
ao
ao
ao
ad
ad
ad
ad
ad
ad
ad
ad
ad
ad
ad
ad
ad
ad
ad
ad
ad
ad
ad
ad
ad
ao
ao
ao
ao
ao
ao
ad
ad
ad
ad
ad
ad
ad
ad
ad
ad
ad
ad
"}
(57,1,1) = {"
ao
ao
ao
ad
ad
ad
ad
ad
ad
ad
ad
ad
ad
ad
ad
ad
ad
ad
ad
ad
ad
ad
ad
ad
ao
ao
ao
ao
ao
ao
ad
ad
ad
ad
ad
ad
ad
ad
ad
ad
ad
ad
"}
(58,1,1) = {"
ao
ao
ao
ad
ad
ad
ad
ad
ad
ad
ad
ad
ad
ad
ad
ad
ad
ad
ad
ad
ad
ad
ad
ad
ao
ao
ao
ao
ao
ad
ad
ad
ad
ad
ad
ad
ad
ad
ad
ad
ad
ad
"}
(59,1,1) = {"
am
ao
ad
ad
ad
ad
ad
ad
ad
ad
ad
ad
ad
ad
ad
ad
ad
ad
ad
ad
ad
ad
ad
ad
ad
ao
ao
ao
ad
ad
ad
ad
ad
ad
ad
ad
ad
ad
ad
ad
ad
ad
"}
(60,1,1) = {"
ad
ad
ad
ad
ad
ad
ad
ad
ad
ad
ad
ad
ad
ad
ad
ad
ad
ad
ad
ad
ad
ad
ad
ad
ad
ad
ad
ad
ad
ad
ad
ad
ad
ad
ad
ad
ad
ad
ad
ad
ad
ad
"}
(61,1,1) = {"
ad
ad
ad
ad
ad
ad
ad
ad
ad
ad
ad
ad
ad
ad
ad
ad
ad
ad
ad
ad
ad
ad
ad
ad
ad
ad
ad
ad
ad
ad
ad
ad
ad
ad
ad
ad
ad
ad
ad
ad
ad
ad
"}
(62,1,1) = {"
au
au
ad
ad
ad
ad
ad
ad
ad
ad
ad
ad
ad
ad
ad
ad
ad
ad
ad
ad
ad
ad
ad
ad
ad
ad
ad
ad
ad
ad
ad
ad
ad
ad
ad
ad
ad
ad
ad
ad
ad
ad
"}
(63,1,1) = {"
ad
au
au
ad
ad
ad
ad
ad
ad
ad
ad
ad
ad
ad
ad
ad
ad
ad
ad
ad
ad
ad
ad
ad
ad
ad
ad
ad
ad
ad
ad
ad
ad
ad
ad
ad
ad
ad
ad
ad
ad
ad
"}
(64,1,1) = {"
ad
ad
au
ad
ad
ad
ad
ad
ad
ad
ad
ad
ad
ad
ad
ad
ad
ad
ad
ad
ad
ad
ad
ad
ad
ad
ad
ad
ad
ad
ad
ad
ad
ad
ad
ad
ad
ad
ad
ad
ad
ad
"}
(65,1,1) = {"
ad
ad
au
ad
ad
ad
ad
ad
ad
ad
ad
ad
ad
ad
ad
ad
ad
ad
ad
ad
ad
ad
ad
ad
ad
ad
ad
ad
ad
ad
ad
ad
ad
ad
ad
ad
ad
ad
ad
ad
ad
ad
"}
(66,1,1) = {"
ao
ad
aZ
aZ
aZ
aZ
aZ
aZ
aZ
aZ
aZ
aZ
aZ
aZ
aZ
aZ
aZ
aZ
aZ
aZ
aZ
aZ
aZ
aZ
aZ
aZ
aZ
aZ
aZ
aZ
aZ
aZ
aZ
aZ
aZ
aZ
aZ
aZ
aZ
aZ
aZ
aZ
"}
