//MAP CONVERTED BY dmm2tgm.py THIS HEADER COMMENT PREVENTS RECONVERSION, DO NOT REMOVE
"aa" = (
/turf/open/floor/plating/ground/mars/random/cave/rock,
/area/bigredv2/caves/east/garbledradio)
"ab" = (
/obj/effect/ai_node,
/turf/open/floor/plating/ground/mars/random/cave,
/area/bigredv2/caves/east/garbledradio)
"ac" = (
/turf/open/floor/plating/ground/mars/random/cave,
/area/bigredv2/caves/east)
"ae" = (
/obj/machinery/miner/damaged/platinum,
/turf/open/floor/plating/ground/mars/random/cave,
/area/bigredv2/caves/east)
"af" = (
/turf/open/floor/plating/ground/mars/random/cave,
/area/bigredv2/caves/east/garbledradio)
"ag" = (
/obj/machinery/miner/damaged/platinum,
/turf/open/floor/plating/ground/mars/random/cave,
/area/bigredv2/caves/east/garbledradio)
"ah" = (
/obj/effect/landmark/excavation_site_spawner,
/turf/open/floor/plating/ground/mars/random/cave,
/area/bigredv2/caves/east/garbledradio)
"ak" = (
/obj/docking_port/stationary/crashmode,
/turf/closed/mineral/smooth/bigred,
/area/bigredv2/caves/rock)
"al" = (
/obj/effect/landmark/lv624/fog_blocker/xeno_spawn,
/obj/effect/landmark/lv624/fog_blocker/xeno_spawn,
/turf/closed/mineral/smooth/bigred,
/area/bigredv2/caves/rock)
"am" = (
/turf/closed/mineral/smooth/bigred/indestructible,
/area/space)
"an" = (
/obj/docking_port/stationary/crashmode,
/turf/open/floor/plating/ground/mars/random/cave,
/area/bigredv2/caves/east)
"ar" = (
/obj/effect/landmark/xeno_silo_spawn,
/turf/open/floor/plating/ground/mars/random/cave,
/area/bigredv2/caves/east/garbledradio)
"au" = (
/turf/open/floor/plating/ground/mars/random/cave/rock,
/area/bigredv2/caves/east)
"az" = (
/obj/effect/landmark/lv624/fog_blocker/xeno_spawn,
/obj/effect/landmark/lv624/fog_blocker/xeno_spawn,
/turf/open/floor/plating/ground/mars/random/cave,
/area/bigredv2/caves/east/garbledradio)
"aF" = (
/obj/effect/landmark/xeno_silo_spawn,
/turf/open/floor/plating/ground/mars/random/cave,
/area/bigredv2/caves/east)
"aK" = (
/obj/effect/ai_node,
/turf/open/floor/plating/ground/mars/random/cave,
/area/bigredv2/caves/east)
"aM" = (
/obj/effect/landmark/lv624/fog_blocker/xeno_spawn,
/turf/closed/mineral/smooth/bigred,
/area/bigredv2/caves/rock)
"aN" = (
/obj/effect/landmark/lv624/fog_blocker/xeno_spawn,
/turf/open/floor/plating/ground/mars/random/cave,
/area/bigredv2/caves/east)
"aP" = (
/obj/effect/landmark/lv624/fog_blocker/xeno_spawn,
/turf/open/floor/plating/ground/mars/random/cave,
/area/bigredv2/caves/east/garbledradio)
"aQ" = (
/obj/effect/ai_node,
/turf/open/floor/plating/ground/mars/random/cave/rock,
/area/bigredv2/caves/east/garbledradio)
"aR" = (
/turf/closed/mineral/smooth/bigred,
/area/bigredv2/caves/rock)
"aS" = (
/obj/effect/landmark/lv624/fog_blocker/xeno_spawn,
/turf/open/floor/plating/ground/mars/random/cave/rock,
/area/bigredv2/caves/east/garbledradio)
"aW" = (
/obj/structure/fence/standard/xenoproof,
/obj/effect/landmark/lv624/fog_blocker,
/turf/open/floor/plating/ground/mars/random/cave,
/area/bigredv2/caves/east/garbledradio)
"aX" = (
/obj/effect/landmark/excavation_site_spawner,
/turf/open/floor/plating/ground/mars/random/cave,
/area/bigredv2/caves/east)
"kb" = (
/obj/effect/landmark/lv624/fog_blocker,
/turf/closed/mineral/smooth/bigred,
/area/bigredv2/caves/rock)
"rp" = (
/obj/effect/landmark/xeno_tunnel_spawn,
/turf/open/floor/plating/ground/mars/random/cave,
/area/bigredv2/caves/east)
"zN" = (
/obj/effect/ai_node,
/turf/open/floor/plating/ground/mars/random/sand,
/area/bigredv2/outside/se)
"DH" = (
/obj/effect/landmark/xeno_tunnel_spawn,
/turf/open/floor/plating/ground/mars/random/cave,
/area/bigredv2/caves/east/garbledradio)
"SF" = (
/turf/open/floor/plating/ground/mars/random/sand,
/area/bigredv2/outside/se)

(1,1,1) = {"
SF
SF
SF
SF
SF
SF
SF
SF
SF
SF
SF
aR
aR
aR
aW
af
af
af
af
af
af
af
af
af
af
af
af
af
aR
aR
aR
aR
aR
aR
aR
aR
aR
af
af
af
af
af
"}
(2,1,1) = {"
SF
SF
SF
SF
SF
SF
SF
SF
SF
SF
SF
aR
aR
aR
kb
af
af
af
af
af
af
af
af
af
af
af
af
af
aR
aR
aR
aR
aR
aR
aR
aR
aR
aR
af
af
ab
af
"}
(3,1,1) = {"
SF
SF
SF
SF
SF
SF
SF
SF
SF
SF
SF
aR
aR
aR
kb
af
af
af
af
af
af
aR
aR
aR
aR
aR
af
af
af
aR
aR
aR
aR
aR
aR
aR
aR
aR
af
af
af
af
"}
(4,1,1) = {"
SF
aR
aR
aR
aR
SF
SF
SF
SF
SF
SF
SF
aR
aR
kb
af
af
af
af
af
af
aR
aR
aR
aR
aR
aa
af
af
af
af
af
af
af
af
aR
aa
aa
af
af
af
af
"}
(5,1,1) = {"
SF
aR
aR
aR
aR
aR
aR
SF
SF
SF
SF
SF
SF
aR
kb
aR
af
az
aP
aP
aM
aM
aM
aM
aM
aM
aP
aS
az
af
af
af
af
af
af
aa
af
af
af
af
af
af
"}
(6,1,1) = {"
SF
SF
aR
aR
aR
aR
aR
aR
SF
SF
SF
SF
SF
aR
kb
aR
aR
aP
af
aR
aR
aR
aR
aR
aR
af
af
af
aS
aa
ab
af
af
af
af
af
af
af
af
af
ab
aa
"}
(7,1,1) = {"
SF
SF
SF
SF
SF
SF
SF
SF
SF
SF
SF
SF
SF
aR
kb
aR
aR
aP
af
af
af
aR
af
aR
aR
af
ab
af
aP
ab
af
af
af
af
af
af
af
af
af
ag
af
aa
"}
(8,1,1) = {"
SF
SF
SF
SF
SF
SF
SF
SF
SF
SF
SF
SF
SF
aR
kb
aR
aR
aM
DH
af
af
ab
af
af
ab
ab
af
af
aP
af
af
af
af
af
af
af
aa
af
af
af
aa
aR
"}
(9,1,1) = {"
SF
SF
SF
SF
SF
zN
SF
SF
SF
zN
SF
SF
SF
aR
kb
aR
aR
aM
af
af
af
af
af
af
af
af
af
aR
aM
aR
aR
aR
af
af
af
af
af
aa
af
af
af
aa
"}
(10,1,1) = {"
SF
SF
SF
SF
SF
SF
SF
SF
SF
SF
SF
SF
aR
aR
kb
aR
aR
aM
aR
aR
af
af
af
af
af
aR
aR
aR
aM
aR
aR
aR
aR
aR
aR
aR
af
af
af
af
af
aa
"}
(11,1,1) = {"
SF
SF
aR
SF
SF
SF
SF
SF
SF
SF
SF
aR
aR
aR
kb
aR
aR
aM
aR
af
af
af
af
af
af
af
aR
aR
aM
aR
aR
aR
aR
aR
aR
aR
af
af
af
af
af
aa
"}
(12,1,1) = {"
SF
aR
aR
SF
SF
SF
SF
SF
SF
aR
aR
aR
aR
aR
kb
aR
aR
aM
af
aa
af
af
aa
af
af
af
aR
aR
aM
aR
aR
aR
aR
aR
aR
aR
af
af
af
af
af
aa
"}
(13,1,1) = {"
aR
aR
aR
SF
SF
SF
SF
SF
SF
aR
aR
aR
aR
aR
kb
aR
aR
aM
af
af
af
af
af
af
af
af
aR
aR
aM
aR
aR
aR
aR
aR
aR
aR
aa
af
af
af
aa
aR
"}
(14,1,1) = {"
aR
aR
SF
SF
SF
SF
SF
SF
SF
aR
aR
aR
aR
aR
kb
aR
aR
aM
af
af
af
ab
ar
af
af
af
af
aR
aM
aR
aR
aR
aR
aR
aR
aR
af
af
af
af
ab
aa
"}
(15,1,1) = {"
aR
SF
SF
SF
SF
SF
aR
aR
aR
aR
aR
aR
aR
aR
kb
aR
aR
aM
af
af
af
af
af
af
af
af
aR
aR
aM
aR
aR
aR
aR
aR
aR
aR
aR
aa
af
af
af
aa
"}
(16,1,1) = {"
SF
SF
SF
SF
SF
zN
aR
aR
aR
aR
aR
aR
aR
aR
kb
aR
aR
aM
aR
af
af
af
af
af
af
aR
aR
aR
aM
aR
aR
aR
aR
aR
aR
aR
aR
aR
af
af
af
af
"}
(17,1,1) = {"
SF
SF
SF
SF
SF
SF
aR
aR
aR
aR
aR
aR
aR
aR
kb
aR
aR
aM
aR
af
af
af
af
af
aR
aR
aR
aR
aM
aR
aR
aR
aR
aR
aR
aR
aR
aR
af
af
af
af
"}
(18,1,1) = {"
aR
aR
aR
aR
aR
aR
aR
aR
aR
aR
aR
aR
aR
aR
kb
aR
aR
al
aM
aP
aP
aP
aP
aP
aM
aM
aM
aM
al
aR
aR
aR
aR
aR
aR
aR
af
af
af
af
af
af
"}
(19,1,1) = {"
kb
kb
kb
kb
kb
kb
kb
kb
kb
kb
kb
kb
kb
kb
kb
aR
aR
aR
aR
af
af
af
af
af
aR
aR
aR
aR
aR
aR
aR
aR
aR
aR
aR
af
af
af
af
af
af
af
"}
(20,1,1) = {"
aR
aR
aR
aR
aR
aR
aR
aR
aR
aR
aR
aR
aR
aR
aR
aR
aR
aR
aR
aR
af
af
af
af
aR
ak
aR
aR
aR
aR
aR
aR
aR
aR
af
af
af
af
af
af
af
af
"}
(21,1,1) = {"
aR
aR
aR
aR
aR
aR
aR
aR
aR
aR
aR
aR
aR
aR
aR
aR
aR
aR
aR
aR
af
ab
af
af
af
aR
aR
aR
aR
aR
aR
aR
aR
aR
af
af
af
af
af
aa
af
af
"}
(22,1,1) = {"
aR
aa
aa
aQ
aa
aa
aR
aR
aR
aR
aR
aR
aR
aR
aR
aR
aR
aR
aR
aR
af
af
af
af
af
aR
aR
aR
aR
aR
aR
aR
aR
aR
ab
af
af
af
af
af
ab
af
"}
(23,1,1) = {"
aR
af
af
af
af
af
aa
aR
aR
aR
aR
aR
aR
aR
aR
aR
aR
aR
aR
aR
af
af
af
af
af
aR
aR
aR
aR
aR
aR
aR
aR
aR
af
af
aa
aR
aR
af
af
af
"}
(24,1,1) = {"
aR
aa
af
af
af
af
aa
aR
aR
aR
aR
aR
aR
aR
aR
aR
aR
aR
aR
aR
af
af
af
af
af
aR
aR
aR
aR
aR
aR
aR
aR
aa
af
af
aa
aR
aR
af
af
af
"}
(25,1,1) = {"
aR
aR
aR
aQ
af
af
aa
af
ab
af
af
aR
aR
aR
aR
aR
aR
aR
aR
aR
af
af
af
af
af
aR
aR
aR
aR
aR
aR
aR
aR
af
af
aa
aR
aR
aR
af
af
af
"}
(26,1,1) = {"
aR
aR
aR
aR
aR
af
aa
af
af
af
af
aR
aR
aR
aR
aa
aa
af
af
af
af
af
ah
af
af
aR
aR
aR
aR
aR
aR
aR
aR
af
aa
aR
aR
aR
aR
af
ab
af
"}
(27,1,1) = {"
aa
aa
aa
aa
aa
af
aa
af
af
af
af
af
af
af
af
af
af
af
af
af
af
af
af
af
af
af
aR
aR
aR
aR
aR
aR
aR
af
ab
aa
aR
aa
aa
af
af
af
"}
(28,1,1) = {"
ab
af
af
af
af
ab
af
aa
aQ
aa
aa
aa
aa
aa
af
af
aQ
af
af
af
af
ab
af
ab
af
af
aR
aR
aR
aR
aR
aR
aR
ab
af
af
aa
af
af
af
af
af
"}
(29,1,1) = {"
af
af
af
af
af
af
ah
af
af
af
af
af
af
af
af
af
aa
af
af
aa
af
af
af
af
af
af
aR
aR
aR
aR
aR
aR
aR
af
af
af
af
af
af
af
af
af
"}
(30,1,1) = {"
af
af
af
af
af
af
af
af
af
af
af
af
af
af
af
af
aa
af
af
af
af
af
af
af
af
aR
aR
aR
aR
aR
aR
aR
aR
aR
af
af
af
af
af
af
aQ
aR
"}
(31,1,1) = {"
af
af
af
af
af
af
af
af
af
af
af
aa
aR
aR
af
af
aa
af
af
af
af
af
af
af
aR
aR
aR
aR
aR
aR
aR
aR
aR
aR
aR
aR
af
af
af
af
aa
aR
"}
(32,1,1) = {"
aa
af
af
af
af
af
af
aR
aR
aR
aR
aR
aR
aR
aR
af
aa
af
af
af
af
af
af
aR
aR
aR
aR
aR
aR
aR
aR
aR
aR
aR
aR
aR
af
af
af
aa
af
aR
"}
(33,1,1) = {"
af
af
af
af
ag
af
af
aR
aR
aR
aR
aR
aR
aR
aR
af
aa
af
af
af
af
af
aR
aR
aR
aR
aR
aR
aR
aR
aR
aR
aR
aR
aR
aR
af
af
aa
af
af
af
"}
(34,1,1) = {"
aa
af
af
aa
af
af
af
aR
aR
aR
aR
aR
aR
aR
aa
af
af
af
af
af
aR
aR
aR
aR
aR
aR
aR
aR
aR
aR
aR
aR
aR
aR
aR
aR
aR
aR
aa
af
ab
af
"}
(35,1,1) = {"
aR
aa
af
ac
ac
ac
af
af
aR
aR
aR
aR
aR
aa
af
ac
ac
af
af
aR
aR
aR
aR
aR
aR
aR
aM
aM
aM
aM
aM
aM
aM
aM
aM
aM
aM
aR
aR
af
af
af
"}
(36,1,1) = {"
aR
aR
aR
ac
ac
au
ac
ac
ac
aR
aR
aR
au
ac
ac
ac
ac
ac
ac
aR
aR
aR
aR
aR
aR
aR
aM
aR
aR
aR
aR
aR
aR
aR
aR
aR
aM
aR
aR
aR
ab
ac
"}
(37,1,1) = {"
aR
aR
aR
ac
ac
au
ac
ac
an
au
ac
ac
ac
ac
ac
ac
ac
ac
aR
aR
aR
aR
aR
aR
aR
aR
aM
aR
rp
ac
ac
ac
aR
aR
aR
aR
aM
aR
aR
aR
ac
ac
"}
(38,1,1) = {"
aR
aR
aR
ac
ac
aK
ac
ac
ac
ac
ac
ac
ac
ac
ac
ac
aK
aR
aR
aR
aR
aR
aR
aR
aR
aR
aM
aR
ac
ac
aF
ac
ac
ac
aR
aR
aM
aR
aR
aR
aR
ac
"}
(39,1,1) = {"
aR
aR
aR
aR
ac
ac
ac
ac
ac
ac
ac
ac
ac
ac
ac
aR
aR
aR
aR
aR
aR
aR
aR
aR
aR
aR
aM
aR
ac
ac
ac
ac
ac
ac
ac
aR
aM
aR
aR
aR
aR
aR
"}
(40,1,1) = {"
aR
aR
aR
aR
ac
ac
ac
ac
ac
aX
ac
ac
ac
ac
aR
aR
aR
aR
aR
aR
aR
aR
aR
aR
aR
aR
aM
aR
ac
ac
ac
ac
ac
ac
ac
aR
aM
aR
aR
aR
aR
aR
"}
(41,1,1) = {"
aR
aR
aR
ac
ac
ac
ac
ac
ac
ac
ac
ac
aR
aR
aR
aR
aR
aR
aR
aR
aR
aR
aR
aR
aR
aR
aM
aR
ac
ac
ac
ac
ac
ac
ac
aR
aM
aR
aR
aR
aR
aR
"}
(42,1,1) = {"
aR
aR
aR
ac
ac
ac
ac
ac
ac
ac
ac
ac
aR
aR
aR
aR
aR
aR
aR
aR
ac
aR
aR
aR
ac
ac
aN
ac
ac
ac
ac
aK
ac
ac
ac
aR
aM
aR
aR
aR
aR
aR
"}
(43,1,1) = {"
aR
aR
ac
ac
ac
ac
ac
ac
ac
ac
ac
ac
ac
aR
aR
aR
aR
aR
aR
ac
ac
ac
aR
aR
ac
ac
aN
aN
aN
aN
aN
aN
aN
aN
aN
aM
aM
aR
aR
aR
aR
aR
"}
(44,1,1) = {"
aR
aR
ac
ac
ac
ac
aX
ac
ac
ac
ac
ac
ac
ac
ac
aR
aR
aR
ac
ac
ac
ac
ac
ac
ac
ac
ac
ac
ac
ac
ac
ac
ac
ac
ac
ac
aR
aR
aR
aR
aR
aR
"}
(45,1,1) = {"
aR
aR
ac
ac
ac
ac
ac
ac
ac
ac
ac
ac
ac
ac
ac
ac
ac
ac
ac
ac
ac
ac
ac
ac
ac
ac
ac
ac
ac
ac
ac
ac
ac
ac
ac
ac
ac
aR
aR
aR
aR
aR
"}
(46,1,1) = {"
ac
ac
ac
ac
ac
ac
ac
ac
ac
ac
ac
ac
ac
ac
ac
ac
ac
ac
ac
ac
ac
ac
ac
ac
ac
ac
ac
ac
ac
ac
ac
ac
ac
ac
ac
ac
ac
ac
ac
ac
ac
ac
"}
(47,1,1) = {"
ac
ac
ac
ac
ac
ac
ac
ac
ac
ac
ac
ac
ac
ac
ac
ac
ac
ac
ac
ac
ac
ac
ac
ac
ac
ac
ac
aX
ac
ac
ac
ac
ac
ac
ac
ac
ac
ac
ac
ac
ac
ac
"}
(48,1,1) = {"
aK
ac
ac
ac
ac
aK
ac
ac
ac
ac
ac
ac
ac
ac
aK
ac
ac
ac
ac
ae
ac
ac
ac
aK
ac
ac
ac
ac
ac
ac
ac
aK
ac
ac
ac
ac
ac
ac
ac
aK
ac
ac
"}
(49,1,1) = {"
ac
ac
ac
ac
ac
ac
ac
ac
ac
ac
ac
ac
ac
ac
ac
ac
ac
ac
ac
ac
ac
ac
ac
ac
ac
ac
ac
ac
ac
ac
ac
ac
ac
ac
ac
ac
ac
ac
ac
ac
ac
ac
"}
(50,1,1) = {"
ac
ac
ac
ac
ac
ac
ac
ac
ac
aR
aR
aR
aR
ac
ac
ac
ac
ac
ac
ac
ac
ac
ac
ac
ac
ac
ac
ac
ac
ac
ac
ac
ac
ac
ac
ac
ac
ac
ac
ac
ac
ac
"}
(51,1,1) = {"
ac
ac
ac
ac
ac
ac
ac
ac
ac
aR
aR
aR
aR
aR
ac
ac
ac
ac
ac
ac
ac
ac
ac
ac
ac
ac
ac
ac
ac
ac
aR
aR
aR
ac
ac
ac
ac
ac
ac
ac
ac
ac
"}
(52,1,1) = {"
ac
au
ac
ac
ac
ac
ac
aR
aR
aR
aR
aR
aR
aR
aR
aR
aR
aR
aR
aR
aR
aR
ac
ac
ac
ac
ac
ac
ac
aR
aR
aR
aR
aR
ac
ac
aX
ac
ac
aK
ac
ac
"}
(53,1,1) = {"
aK
ac
ac
ac
aR
aR
aR
aR
aR
aR
aR
aR
aR
aR
aR
aR
aR
aR
aR
aR
aR
aR
aR
au
ac
ac
ac
ac
aR
aR
aR
aR
aR
aR
au
ac
ac
ac
ac
ac
ac
ac
"}
(54,1,1) = {"
ac
ac
ac
ac
aR
aR
aR
aR
aR
aR
aR
aR
aR
aR
aR
aR
aR
aR
aR
aR
aR
aR
aR
aR
ac
ac
ac
ac
ac
aR
aR
aR
aR
aR
aR
aR
ac
ac
ac
ac
ac
ac
"}
(55,1,1) = {"
ac
ac
ac
aR
aR
aR
aR
aR
aR
aR
aR
aR
aR
aR
aR
aR
aR
aR
aR
aR
aR
aR
aR
aR
ac
ac
ac
ac
ac
ac
aR
aR
aR
aR
aR
aR
aR
aR
aR
ac
ac
ac
"}
(56,1,1) = {"
ac
ac
ac
aR
aR
aR
aR
aR
aR
aR
aR
aR
aR
aR
aR
aR
aR
aR
aR
aR
aR
aR
aR
aR
ac
ac
ac
ac
ac
ac
aR
aR
aR
aR
aR
aR
aR
aR
aR
aR
aR
aR
"}
(57,1,1) = {"
ac
ac
ac
aR
aR
aR
aR
aR
aR
aR
aR
aR
aR
aR
aR
aR
aR
aR
aR
aR
aR
aR
aR
aR
ac
ac
ac
ac
ac
ac
aR
aR
aR
aR
aR
aR
aR
aR
aR
aR
aR
aR
"}
(58,1,1) = {"
ac
ac
ac
aR
aR
aR
aR
aR
aR
aR
aR
aR
aR
aR
aR
aR
aR
aR
aR
aR
aR
aR
aR
aR
ac
ac
ac
ac
ac
aR
aR
aR
aR
aR
aR
aR
aR
aR
aR
aR
aR
aR
"}
(59,1,1) = {"
aK
ac
aR
aR
aR
aR
aR
aR
aR
aR
aR
aR
aR
aR
aR
aR
aR
aR
aR
aR
aR
aR
aR
aR
aR
ac
ac
ac
aR
aR
aR
aR
aR
aR
aR
aR
aR
aR
aR
aR
aR
aR
"}
(60,1,1) = {"
aR
aR
aR
aR
aR
aR
aR
aR
aR
aR
aR
aR
aR
aR
aR
aR
aR
aR
aR
aR
aR
aR
aR
aR
aR
aR
aR
aR
aR
aR
aR
aR
aR
aR
aR
aR
aR
aR
aR
aR
aR
aR
"}
(61,1,1) = {"
aR
aR
aR
aR
aR
aR
aR
aR
aR
aR
aR
aR
aR
aR
aR
aR
aR
aR
aR
aR
aR
aR
aR
aR
aR
aR
aR
aR
aR
aR
aR
aR
aR
aR
aR
aR
aR
aR
aR
aR
aR
aR
"}
(62,1,1) = {"
aM
aM
aR
aR
aR
aR
aR
aR
aR
aR
aR
aR
aR
aR
aR
aR
aR
aR
aR
aR
aR
aR
aR
aR
aR
aR
aR
aR
aR
aR
aR
aR
aR
aR
aR
aR
aR
aR
aR
aR
aR
aR
"}
(63,1,1) = {"
aR
aM
aM
aR
aR
aR
aR
aR
aR
aR
aR
aR
aR
aR
aR
aR
aR
aR
aR
aR
aR
aR
aR
aR
aR
aR
aR
aR
aR
aR
aR
aR
aR
aR
aR
aR
aR
aR
aR
aR
aR
aR
"}
(64,1,1) = {"
aR
aR
aM
aR
aR
aR
aR
aR
aR
aR
aR
aR
aR
aR
aR
aR
aR
aR
aR
aR
aR
aR
aR
aR
aR
aR
aR
aR
aR
aR
aR
aR
aR
aR
aR
aR
aR
aR
aR
aR
aR
aR
"}
(65,1,1) = {"
aR
aR
aM
aR
aR
aR
aR
aR
aR
aR
aR
aR
aR
aR
aR
aR
aR
aR
aR
aR
aR
aR
aR
aR
aR
aR
aR
aR
aR
aR
aR
aR
aR
aR
aR
aR
aR
aR
aR
aR
aR
aR
"}
(66,1,1) = {"
ac
aR
am
am
am
am
am
am
am
am
am
am
am
am
am
am
am
am
am
am
am
am
am
am
am
am
am
am
am
am
am
am
am
am
am
am
am
am
am
am
am
am
"}
