//MAP CONVERTED BY dmm2tgm.py THIS HEADER COMMENT PREVENTS RECONVERSION, DO NOT REMOVE
"a" = (
/obj/structure/cable,
/obj/machinery/atmospherics/pipe/simple/green/hidden{
	dir = 5
	},
/turf/open/floor/marking/asteroidwarning{
	dir = 10
	},
/area/bigredv3/outside/directions/central)
"b" = (
/obj/machinery/atmospherics/components/unary/vent_pump{
	dir = 1;
	on = 1
	},
/turf/open/floor,
/area/bigredv3/inside/secondary/auxstore)
"d" = (
/obj/machinery/atmospherics/pipe/simple/green/hidden{
	dir = 4
	},
/obj/structure/cable,
/obj/effect/spawner/random/misc/trash,
/turf/open/floor,
/area/bigredv3/inside/secondary/auxstore)
"e" = (
/turf/open/floor,
/area/bigredv3/inside/secondary/auxstore)
"f" = (
/obj/structure/sign/securearea,
/turf/open/floor/marking/asteroidwarning{
	dir = 1
	},
/area/bigredv3/outside/directions/central)
"g" = (
/obj/structure/rack,
/obj/effect/spawner/random/engineering/toolbox,
/turf/open/floor,
/area/bigredv3/inside/secondary/auxstore)
"h" = (
/obj/structure/cable,
/turf/open/floor,
/area/bigredv3/inside/secondary/auxstore)
"i" = (
/obj/machinery/atmospherics/pipe/simple/green/hidden{
	dir = 4
	},
/obj/structure/cable,
/turf/open/floor/marking/asteroidwarning,
/area/bigredv3/outside/directions/central)
"j" = (
/turf/open/floor/marking/asteroidwarning{
	dir = 9
	},
/area/bigredv3/outside/directions/central)
"k" = (
/obj/structure/cable,
/obj/machinery/power/apc/weak/ntf,
/obj/machinery/light{
	dir = 1
	},
/turf/open/floor,
/area/bigredv3/inside/secondary/auxstore)
"m" = (
/obj/structure/rack,
/obj/effect/spawner/random/misc/trash,
/turf/open/floor,
/area/bigredv3/inside/secondary/auxstore)
"o" = (
/obj/machinery/atmospherics/pipe/manifold/green/hidden{
	dir = 1
	},
/obj/structure/cable,
/obj/effect/ai_node,
/turf/open/floor/asteroidfloor,
/area/bigredv3/outside/directions/central)
"p" = (
/obj/machinery/atmospherics/pipe/simple/green/hidden{
	dir = 4
	},
/obj/structure/cable,
/turf/open/floor,
/area/bigredv3/inside/secondary/auxstore)
"q" = (
/obj/structure/rack,
/obj/effect/spawner/random/food_or_drink/kitchen,
/turf/open/floor,
/area/bigredv3/inside/secondary/auxstore)
"r" = (
/obj/machinery/atmospherics/pipe/simple/green/hidden{
	dir = 4
	},
/obj/structure/cable,
/obj/machinery/door/airlock/mainship/secure/locked/free_access{
	name = "\improper Emergency Vault"
	},
/turf/open/floor,
/area/bigredv3/inside/secondary/auxstore)
"s" = (
/obj/machinery/atmospherics/pipe/simple/green/hidden{
	dir = 9
	},
/obj/structure/cable,
/obj/effect/ai_node,
/turf/open/floor/marking/asteroidwarning{
	dir = 6
	},
/area/bigredv3/outside/directions/central)
"t" = (
/obj/structure/rack,
/obj/machinery/light{
	dir = 1
	},
/turf/open/floor,
/area/bigredv3/inside/secondary/auxstore)
"v" = (
/obj/structure/cable,
/obj/machinery/atmospherics/pipe/simple/green/hidden{
	dir = 6
	},
/turf/open/floor,
/area/bigredv3/inside/secondary/auxstore)
"w" = (
/turf/open/floor/marking/asteroidwarning{
	dir = 4
	},
/area/bigredv3/outside/directions/central)
"x" = (
/turf/open/floor/marking/asteroidwarning{
	dir = 5
	},
/area/bigredv3/outside/directions/central)
"y" = (
/turf/closed/wall/r_wall,
/area/bigredv3/inside/wall)
"A" = (
/obj/machinery/atmospherics/pipe/simple/green/hidden,
/obj/structure/cable,
/turf/open/floor/marking/asteroidwarning{
	dir = 4
	},
/area/bigredv3/outside/directions/central)
"B" = (
/obj/structure/rack,
/obj/machinery/light,
/turf/open/floor,
/area/bigredv3/inside/secondary/auxstore)
"C" = (
/obj/machinery/atmospherics/pipe/simple/green/hidden,
/obj/structure/cable,
/turf/open/floor/marking/asteroidwarning{
	dir = 8
	},
/area/bigredv3/outside/directions/central)
"E" = (
/obj/machinery/atmospherics/pipe/manifold/green/hidden{
	dir = 1
	},
/obj/structure/cable,
/turf/open/floor/asteroidfloor,
/area/bigredv3/outside/directions/central)
"G" = (
/obj/structure/rack,
/obj/structure/sign/securearea,
/turf/open/floor,
/area/bigredv3/inside/secondary/auxstore)
"H" = (
/obj/structure/rack,
/turf/open/floor,
/area/bigredv3/inside/secondary/auxstore)
"J" = (
/obj/machinery/atmospherics/pipe/simple/green/hidden,
/obj/structure/cable,
/turf/open/floor/asteroidfloor,
/area/bigredv3/outside/directions/central)
"K" = (
/obj/structure/rack,
/obj/effect/spawner/random/food_or_drink/kitchen,
/obj/machinery/light,
/turf/open/floor,
/area/bigredv3/inside/secondary/auxstore)
"L" = (
/turf/open/floor/marking/asteroidwarning{
	dir = 8
	},
/area/bigredv3/outside/directions/central)
"N" = (
/obj/structure/rack,
/obj/effect/spawner/random/engineering/toolbox,
/obj/structure/sign/securearea,
/turf/open/floor,
/area/bigredv3/inside/secondary/auxstore)
"O" = (
/turf/open/floor/marking/asteroidwarning{
	dir = 1
	},
/area/bigredv3/outside/directions/central)
"Q" = (
/obj/structure/cable,
/obj/machinery/atmospherics/pipe/simple/green/hidden,
/turf/open/floor/marking/asteroidwarning{
	dir = 8
	},
/area/bigredv3/outside/directions/central)
"S" = (
/obj/effect/ai_node,
/turf/open/floor,
/area/bigredv3/inside/secondary/auxstore)
"T" = (
/obj/effect/spawner/random/misc/trash,
/turf/open/floor,
/area/bigredv3/inside/secondary/auxstore)
"U" = (
/turf/open/floor/plating/ground/mars/random/sand,
/area/bigredv3/outside/directions/central)
"V" = (
/obj/effect/ai_node,
/obj/structure/cable,
/obj/machinery/atmospherics/pipe/manifold/green/hidden{
	dir = 1
	},
/turf/open/floor/asteroidfloor,
/area/bigredv3/outside/directions/central)
"W" = (
/turf/open/floor/asteroidfloor,
/area/bigredv3/outside/directions/central)
"X" = (
/obj/machinery/atmospherics/pipe/simple/green/hidden{
	dir = 4
	},
/obj/structure/cable,
/turf/open/floor/asteroidfloor,
/area/bigredv3/outside/directions/central)
"Z" = (
/obj/machinery/atmospherics/pipe/simple/green/hidden{
	dir = 10
	},
/obj/structure/cable,
/turf/open/floor/asteroidfloor,
/area/bigredv3/outside/directions/central)

(1,1,1) = {"
U
j
L
W
o
Z
C
Q
a
"}
(2,1,1) = {"
U
O
y
y
y
y
y
y
i
"}
(3,1,1) = {"
U
f
y
H
e
e
G
y
i
"}
(4,1,1) = {"
U
O
y
t
T
e
K
y
i
"}
(5,1,1) = {"
U
O
y
q
e
T
H
y
i
"}
(6,1,1) = {"
U
O
y
H
e
e
H
y
i
"}
(7,1,1) = {"
U
O
y
H
S
e
g
y
E
"}
(8,1,1) = {"
U
O
y
k
h
e
B
y
V
"}
(9,1,1) = {"
U
O
y
H
h
e
m
y
X
"}
(10,1,1) = {"
U
O
y
H
v
b
H
y
i
"}
(11,1,1) = {"
U
O
y
g
d
e
H
y
i
"}
(12,1,1) = {"
U
O
y
H
p
e
H
y
i
"}
(13,1,1) = {"
U
O
y
t
p
T
B
y
i
"}
(14,1,1) = {"
U
f
y
H
p
e
N
y
i
"}
(15,1,1) = {"
U
O
y
y
r
y
y
y
i
"}
(16,1,1) = {"
U
x
w
W
o
J
A
A
s
"}
