//MAP CONVERTED BY dmm2tgm.py THIS HEADER COMMENT PREVENTS RECONVERSION, DO NOT REMOVE
"au" = (
/obj/machinery/light{
	dir = 4
	},
/obj/effect/decal/cleanable/dirt,
/obj/effect/ai_node,
/turf/open/floor/tile/dark/red2/corner,
/area/bigredv3/inside/science/xenolab)
"aB" = (
/obj/item/target,
/turf/open/floor/tile/dark/red2{
	dir = 1
	},
/area/bigredv3/inside/science/xenolab)
"bN" = (
/obj/effect/decal/cleanable/blood/xeno,
/turf/open/floor/tile/dark/red2/corner{
	dir = 4
	},
/area/bigredv3/inside/science/xenolab)
"cj" = (
/obj/machinery/atmospherics/components/unary/vent_pump{
	dir = 4;
	on = 1
	},
/turf/open/floor/tile/dark,
/area/bigredv3/inside/science/xenolab)
"dE" = (
/obj/structure/xenoautopsy/tank/hugger,
/turf/open/floor/tile/dark/red2/corner{
	dir = 8
	},
/area/bigredv3/inside/science/xenolab)
"em" = (
/obj/effect/landmark/lv624/fog_blocker/xeno_spawn,
/turf/open/floor/plating/ground/mars/random/cave,
/area/bigredv3/caves/south)
"ff" = (
/turf/closed/wall/r_wall,
/area/bigredv3/inside/wall)
"gE" = (
/turf/open/floor/plating/ground/mars/random/cave,
/area/bigredv3/caves/south)
"hd" = (
/obj/structure/cable,
/obj/machinery/door/airlock/mainship/maint/free_access{
	name = "\improper Eta Lab Maintenance Storage"
	},
/turf/open/floor/tile/dark,
/area/bigredv3/inside/science/research_office)
"hA" = (
/turf/open/floor/tile/dark/red2/corner{
	dir = 8
	},
/area/bigredv3/inside/science/xenolab)
"hL" = (
/obj/machinery/light{
	dir = 1
	},
/turf/open/floor/tile/dark/red2{
	dir = 9
	},
/area/bigredv3/inside/science/xenolab)
"hN" = (
/obj/effect/decal/cleanable/blood/gibs,
/turf/open/floor/plating/ground/mars/random/cave,
/area/bigredv3/caves/south)
"if" = (
/obj/effect/spawner/random/engineering/structure/tank/fuelweighted,
/turf/open/floor/plating,
/area/bigredv3/inside/science/research_office)
"iC" = (
/obj/machinery/light{
	dir = 1
	},
/turf/open/floor/tile/dark/red2{
	dir = 5
	},
/area/bigredv3/inside/science/xenolab)
"jr" = (
/turf/open/floor/plating,
/area/bigredv3/inside/science/research_office)
"jx" = (
/obj/effect/ai_node,
/turf/open/floor/tile/dark,
/area/bigredv3/inside/science/xenolab)
"kb" = (
/obj/structure/window/framed/colony,
/turf/open/floor/plating,
/area/bigredv3/inside/wall)
"kB" = (
/obj/effect/spawner/random/engineering/structure/tank/fuelweighted,
/obj/machinery/light/small{
	dir = 1
	},
/turf/open/floor/plating,
/area/bigredv3/inside/science/research_office)
"kP" = (
/obj/effect/landmark/xeno_silo_spawn,
/turf/open/floor/plating/ground/mars/random/cave,
/area/bigredv3/caves/south)
"kW" = (
/turf/open/floor/tile/dark/red2{
	dir = 6
	},
/area/bigredv3/inside/science/xenolab)
"ln" = (
/obj/structure/fence/standard/xenoproof,
/turf/open/floor/plating/ground/mars/random/cave/rock,
/area/bigredv3/caves/south)
"lw" = (
/obj/machinery/light,
/turf/open/floor/tile/darkgreen/darkgreen2,
/area/bigredv3/inside/science/xenolab)
"mX" = (
/turf/open/floor/tile/darkgreen/darkgreen2{
	dir = 6
	},
/area/bigredv3/inside/science/xenolab)
"nk" = (
/obj/structure/cable,
/turf/open/floor/plating,
/area/bigredv3/inside/science/research_office)
"oC" = (
/obj/machinery/door/airlock/mainship/research/glass/free_access{
	name = "\improper Eta Lab Cell"
	},
/turf/open/floor/tile/dark,
/area/bigredv3/inside/science/xenolab)
"oN" = (
/obj/effect/landmark/lv624/fog_blocker/xeno_spawn,
/turf/closed/mineral/smooth/bigred,
/area/bigredv3/caves/rock)
"pA" = (
/obj/machinery/computer/security,
/turf/open/floor/tile/dark/red2/corner{
	dir = 4
	},
/area/bigredv3/inside/science/xenolab)
"qi" = (
/turf/open/floor/tile/dark/red2{
	dir = 4
	},
/area/bigredv3/inside/science/xenolab)
"qw" = (
/obj/effect/decal/cleanable/blood/oil,
/turf/open/floor/tile/dark,
/area/bigredv3/inside/science/xenolab)
"rj" = (
/obj/structure/table,
/obj/machinery/light,
/obj/effect/spawner/random/engineering/technology_scanner,
/obj/item/xenos_claw,
/turf/open/floor/tile/dark/red2/corner{
	dir = 8
	},
/area/bigredv3/inside/science/xenolab)
"rl" = (
/turf/open/floor/tile/darkgreen/darkgreen2{
	dir = 8
	},
/area/bigredv3/inside/science/xenolab)
"rU" = (
/obj/effect/landmark/lv624/fog_blocker,
/turf/closed/wall/r_wall,
/turf/open/floor/plating/ground/mars/cavetodirt{
	dir = 1
	})
"sg" = (
/turf/open/floor/tile/dark/red2,
/area/bigredv3/inside/science/xenolab)
"uA" = (
/turf/closed/mineral/smooth/bigred,
/area/bigredv3/caves/rock)
"uY" = (
/obj/machinery/atmospherics/pipe/simple/green/hidden{
	dir = 4
	},
/turf/open/floor/tile/dark,
/area/bigredv3/inside/science/xenolab)
"vf" = (
/obj/machinery/door/airlock/mainship/research/glass/free_access{
	dir = 1;
	name = "\improper Eta Lab Cell"
	},
/turf/open/floor/tile/dark,
/area/bigredv3/inside/science/xenolab)
"vx" = (
/turf/open/floor/tile/dark,
/area/bigredv3/inside/science/xenolab)
"wi" = (
/turf/open/floor/tile/darkgreen/darkgreen2{
	dir = 10
	},
/area/bigredv3/inside/science/xenolab)
"wS" = (
/turf/open/floor/tile/dark/red2{
	dir = 10
	},
/area/bigredv3/inside/science/xenolab)
"AU" = (
/obj/machinery/atmospherics/pipe/simple/green/hidden{
	dir = 4
	},
/obj/effect/ai_node,
/turf/open/floor/tile/dark,
/area/bigredv3/inside/science/xenolab)
"Bh" = (
/turf/open/floor/plating/ground/mars/random/sand,
/area/bigredv3/inside/science/xenolab)
"BM" = (
/obj/effect/landmark/lv624/fog_blocker/xeno_spawn,
/turf/open/floor/plating/ground/mars/random/cave/rock,
/area/bigredv3/caves/south)
"CD" = (
/obj/effect/ai_node,
/turf/open/floor/plating/ground/mars/random/cave/rock,
/area/bigredv3/caves/south)
"CS" = (
/obj/structure/cable,
/obj/machinery/power/apc/weak/ntf{
	dir = 1
	},
/turf/open/floor/plating,
/area/bigredv3/inside/science/research_office)
"CT" = (
/obj/structure/table,
/obj/effect/spawner/random/engineering/technology_scanner,
/turf/open/floor/tile/dark/red2/corner{
	dir = 4
	},
/area/bigredv3/inside/science/xenolab)
"DE" = (
/turf/closed/wall/r_wall)
"Ex" = (
/turf/open/floor/tile/dark/red2{
	dir = 8
	},
/area/bigredv3/inside/science/xenolab)
"Fc" = (
/obj/structure/window/framed/colony/reinforced,
/turf/open/floor/plating,
/area/bigredv3/inside/wall)
"Fe" = (
/obj/effect/decal/cleanable/blood,
/turf/open/floor/tile/dark,
/area/bigredv3/inside/science/xenolab)
"Fk" = (
/obj/structure/closet/firecloset,
/turf/open/floor/plating,
/area/bigredv3/inside/science/research_office)
"Fr" = (
/obj/machinery/light{
	dir = 8
	},
/turf/open/floor/tile/dark/red2/corner{
	dir = 8
	},
/area/bigredv3/inside/science/xenolab)
"FS" = (
/obj/structure/table,
/obj/effect/spawner/random/engineering/technology_scanner,
/turf/open/floor/tile/dark/red2/corner{
	dir = 8
	},
/area/bigredv3/inside/science/xenolab)
"Gf" = (
/obj/structure/table,
/obj/item/alienjar,
/turf/open/floor/tile/dark/red2/corner{
	dir = 4
	},
/area/bigredv3/inside/science/xenolab)
"Gg" = (
/obj/structure/table,
/obj/structure/xenoautopsy,
/turf/open/floor/tile/dark/red2/corner{
	dir = 4
	},
/area/bigredv3/inside/science/xenolab)
"He" = (
/obj/machinery/atmospherics/pipe/manifold/green/hidden{
	dir = 1
	},
/obj/effect/ai_node,
/turf/open/floor/tile/dark,
/area/bigredv3/inside/science/xenolab)
"HK" = (
/obj/structure/closet/l3closet/scientist,
/turf/open/floor/tile/darkgreen/darkgreen2{
	dir = 1
	},
/area/bigredv3/inside/science/xenolab)
"HN" = (
/obj/structure/table,
/obj/item/tool/pen,
/turf/open/floor/tile/dark/red2/corner{
	dir = 4
	},
/area/bigredv3/inside/science/xenolab)
"HP" = (
/turf/closed/mineral/smooth/bigred/indestructible,
/area/space)
"Is" = (
/obj/structure/fence/standard/xenoproof,
/turf/open/floor/plating/ground/mars/random/cave,
/area/bigredv3/caves/south)
"Jl" = (
/turf/open/floor/tile/darkgreen/darkgreen2{
	dir = 4
	},
/area/bigredv3/inside/science/xenolab)
"JC" = (
/obj/effect/decal/cleanable/dirt,
/turf/open/floor/tile/dark,
/area/bigredv3/inside/science/xenolab)
"JW" = (
/obj/structure/bed/chair{
	dir = 8
	},
/turf/open/floor/tile/dark/red2{
	dir = 8
	},
/area/bigredv3/inside/science/xenolab)
"LS" = (
/turf/open/floor/tile/dark/red2/corner,
/area/bigredv3/inside/science/xenolab)
"Nd" = (
/obj/structure/cable,
/obj/effect/ai_node,
/turf/open/floor/plating,
/area/bigredv3/inside/science/research_office)
"Nj" = (
/obj/structure/bed/chair{
	dir = 4
	},
/turf/open/floor/tile/dark/red2{
	dir = 4
	},
/area/bigredv3/inside/science/xenolab)
"NI" = (
/turf/open/floor/plating/ground/mars/random/cave/rock,
/area/bigredv3/caves/south)
"Pn" = (
/obj/structure/table,
/obj/item/paper,
/turf/open/floor/tile/dark/red2/corner,
/area/bigredv3/inside/science/xenolab)
"Pr" = (
/obj/effect/landmark/lv624/fog_blocker,
/turf/closed/wall/r_wall,
/turf/open/floor/plating/ground/mars/random/cave)
"Qq" = (
/obj/structure/window/framed/colony/reinforced/unbreakable,
/turf/open/floor/plating,
/area/bigredv3/inside/wall)
"Qr" = (
/turf/closed/wall,
/area/bigredv3/inside/wall)
"RW" = (
/obj/structure/closet/l3closet/scientist,
/turf/open/floor/tile/darkgreen/darkgreen2{
	dir = 9
	},
/area/bigredv3/inside/science/xenolab)
"Sk" = (
/obj/structure/window/framed/colony/reinforced/unbreakable,
/turf/open/floor/plating)
"Sp" = (
/obj/effect/decal/cleanable/dirt,
/turf/open/floor/tile/dark/red2/corner,
/area/bigredv3/inside/science/xenolab)
"Sv" = (
/obj/machinery/atmospherics/components/unary/vent_pump{
	dir = 1;
	on = 1
	},
/turf/open/floor/tile/dark,
/area/bigredv3/inside/science/xenolab)
"SS" = (
/obj/machinery/light{
	dir = 4
	},
/turf/open/ground/jungle/clear,
/area/bigredv3/inside/science/xenolab)
"Tq" = (
/turf/open/floor/tile/dark/red2{
	dir = 1
	},
/area/bigredv3/inside/science/xenolab)
"Uj" = (
/obj/structure/closet/l3closet/scientist,
/turf/open/floor/tile/darkgreen/darkgreen2{
	dir = 5
	},
/area/bigredv3/inside/science/xenolab)
"UN" = (
/obj/structure/xenoautopsy/tank,
/turf/open/floor/tile/dark/red2/corner{
	dir = 8
	},
/area/bigredv3/inside/science/xenolab)
"Vk" = (
/obj/effect/landmark/lv624/fog_blocker,
/turf/closed/wall/r_wall)
"Vl" = (
/obj/effect/landmark/lv624/fog_blocker,
/turf/closed/mineral/smooth/bigred,
/area/bigredv3/caves/rock)
"Vx" = (
/obj/structure/closet/crate/secure,
/turf/open/floor/tile/dark/red2/corner,
/area/bigredv3/inside/science/xenolab)
"VX" = (
/obj/machinery/atmospherics/pipe/simple/green/hidden{
	dir = 4
	},
/obj/machinery/door/airlock/mainship/research/glass/free_access{
	name = "\improper Eta Lab Xenobiology Lab"
	},
/turf/open/floor/tile/dark,
/area/bigredv3/inside/science/xenolab)
"XW" = (
/turf/open/ground/jungle/clear,
/area/bigredv3/inside/science/xenolab)
"Yi" = (
/obj/effect/ai_node,
/turf/open/floor/plating/ground/mars/random/cave,
/area/bigredv3/caves/south)
"Ym" = (
/obj/machinery/light{
	dir = 8
	},
/turf/open/floor/plating/ground/mars/random/sand,
/area/bigredv3/inside/science/xenolab)
"Yt" = (
/obj/structure/closet/toolcloset,
/turf/open/floor/plating,
/area/bigredv3/inside/science/research_office)

(1,1,1) = {"
HP
HP
HP
HP
HP
HP
HP
HP
HP
HP
HP
HP
HP
HP
HP
HP
HP
HP
HP
HP
HP
HP
HP
HP
HP
HP
HP
HP
HP
HP
HP
HP
HP
HP
HP
HP
HP
HP
"}
(2,1,1) = {"
HP
HP
HP
HP
HP
HP
HP
HP
HP
HP
HP
HP
HP
HP
HP
HP
HP
HP
HP
HP
HP
HP
HP
HP
HP
HP
HP
HP
HP
HP
HP
HP
HP
HP
HP
HP
HP
HP
"}
(3,1,1) = {"
HP
HP
HP
HP
HP
HP
HP
HP
HP
HP
HP
HP
HP
HP
HP
HP
HP
HP
HP
HP
HP
HP
HP
HP
HP
HP
HP
HP
HP
HP
HP
HP
HP
HP
HP
HP
HP
HP
"}
(4,1,1) = {"
HP
HP
HP
HP
HP
HP
HP
HP
HP
HP
HP
HP
HP
HP
HP
HP
HP
HP
HP
HP
HP
HP
HP
HP
HP
HP
HP
HP
HP
HP
HP
HP
HP
HP
HP
HP
HP
HP
"}
(5,1,1) = {"
HP
HP
HP
HP
HP
HP
HP
HP
HP
HP
HP
HP
HP
HP
HP
HP
HP
HP
HP
HP
HP
HP
HP
HP
HP
HP
HP
HP
HP
HP
HP
HP
HP
HP
HP
HP
HP
HP
"}
(6,1,1) = {"
HP
HP
HP
HP
HP
HP
HP
HP
HP
HP
HP
HP
HP
HP
HP
HP
HP
HP
HP
HP
HP
HP
HP
HP
HP
HP
HP
HP
HP
HP
HP
HP
HP
HP
HP
HP
HP
HP
"}
(7,1,1) = {"
HP
HP
HP
HP
HP
HP
HP
HP
HP
HP
HP
HP
HP
HP
HP
HP
HP
HP
HP
HP
HP
HP
HP
HP
HP
HP
HP
HP
HP
HP
HP
HP
HP
HP
HP
HP
HP
HP
"}
(8,1,1) = {"
HP
HP
HP
HP
HP
HP
HP
HP
HP
HP
HP
HP
HP
HP
HP
HP
HP
HP
HP
HP
HP
HP
HP
HP
HP
HP
HP
HP
HP
HP
HP
HP
HP
HP
HP
HP
HP
HP
"}
(9,1,1) = {"
HP
HP
HP
HP
HP
HP
HP
HP
HP
HP
HP
HP
HP
HP
HP
HP
HP
HP
HP
HP
HP
HP
HP
HP
HP
HP
HP
HP
HP
HP
HP
HP
HP
HP
HP
HP
HP
HP
"}
(10,1,1) = {"
HP
HP
HP
HP
HP
HP
HP
HP
HP
HP
HP
HP
HP
HP
HP
HP
HP
HP
HP
HP
HP
HP
HP
HP
HP
HP
HP
HP
HP
HP
HP
HP
HP
HP
HP
HP
HP
HP
"}
(11,1,1) = {"
HP
HP
HP
HP
HP
HP
HP
HP
HP
HP
HP
HP
HP
HP
HP
HP
HP
HP
HP
HP
HP
HP
HP
HP
HP
HP
HP
HP
HP
HP
HP
HP
HP
HP
HP
HP
HP
HP
"}
(12,1,1) = {"
HP
HP
HP
HP
HP
HP
HP
HP
HP
HP
HP
HP
HP
HP
HP
HP
HP
HP
HP
HP
HP
HP
HP
HP
HP
HP
HP
HP
HP
HP
HP
HP
HP
HP
HP
HP
HP
HP
"}
(13,1,1) = {"
HP
HP
HP
HP
HP
HP
HP
HP
HP
HP
HP
HP
HP
HP
HP
HP
HP
HP
HP
HP
HP
HP
HP
HP
HP
HP
HP
HP
HP
HP
HP
HP
HP
HP
HP
HP
HP
HP
"}
(14,1,1) = {"
HP
HP
HP
HP
HP
HP
HP
HP
HP
HP
HP
HP
HP
HP
HP
HP
HP
HP
HP
HP
HP
HP
HP
HP
HP
HP
HP
HP
HP
HP
HP
HP
HP
HP
HP
HP
HP
HP
"}
(15,1,1) = {"
HP
HP
HP
HP
HP
HP
HP
HP
HP
HP
HP
HP
HP
HP
HP
HP
HP
HP
HP
HP
HP
HP
HP
HP
HP
HP
HP
HP
HP
HP
HP
HP
HP
HP
HP
HP
HP
HP
"}
(16,1,1) = {"
HP
HP
HP
HP
HP
HP
HP
HP
HP
HP
HP
HP
HP
HP
HP
HP
HP
HP
HP
HP
HP
HP
HP
HP
HP
HP
HP
HP
HP
HP
HP
HP
HP
HP
HP
HP
HP
HP
"}
(17,1,1) = {"
HP
HP
HP
HP
HP
HP
HP
HP
HP
HP
HP
HP
HP
HP
HP
HP
HP
HP
HP
HP
HP
HP
HP
HP
HP
HP
HP
HP
HP
HP
HP
HP
HP
HP
HP
HP
HP
HP
"}
(18,1,1) = {"
HP
HP
HP
HP
HP
HP
HP
HP
HP
HP
HP
HP
HP
HP
HP
HP
HP
HP
HP
HP
HP
HP
HP
HP
HP
HP
HP
HP
HP
HP
HP
HP
HP
HP
HP
HP
HP
HP
"}
(19,1,1) = {"
HP
HP
HP
HP
HP
HP
HP
HP
HP
HP
HP
HP
HP
HP
HP
HP
HP
HP
HP
HP
HP
HP
HP
HP
HP
HP
HP
HP
HP
HP
HP
HP
HP
HP
HP
HP
HP
HP
"}
(20,1,1) = {"
HP
HP
HP
HP
HP
HP
HP
HP
HP
HP
HP
HP
HP
HP
HP
HP
HP
HP
HP
HP
HP
HP
HP
HP
HP
HP
HP
HP
HP
HP
HP
HP
HP
HP
HP
HP
HP
HP
"}
(21,1,1) = {"
HP
HP
HP
HP
HP
HP
HP
HP
HP
HP
HP
HP
HP
HP
HP
HP
HP
HP
HP
HP
HP
HP
HP
HP
HP
HP
HP
HP
HP
HP
HP
HP
HP
HP
HP
HP
HP
HP
"}
(22,1,1) = {"
HP
HP
HP
HP
HP
HP
HP
HP
HP
HP
HP
HP
HP
HP
HP
HP
HP
HP
HP
HP
HP
HP
HP
HP
HP
HP
HP
HP
HP
HP
HP
HP
HP
HP
HP
HP
HP
HP
"}
(23,1,1) = {"
HP
HP
HP
HP
HP
HP
HP
HP
HP
HP
HP
HP
HP
HP
HP
HP
HP
HP
HP
HP
HP
HP
HP
HP
HP
HP
HP
HP
HP
HP
HP
HP
HP
HP
HP
HP
HP
HP
"}
(24,1,1) = {"
HP
HP
HP
HP
HP
HP
HP
HP
HP
HP
HP
HP
HP
HP
HP
HP
HP
HP
HP
HP
HP
HP
HP
HP
HP
HP
HP
HP
HP
HP
HP
HP
HP
HP
HP
HP
HP
HP
"}
(25,1,1) = {"
HP
HP
HP
HP
HP
HP
HP
HP
HP
HP
HP
HP
HP
HP
HP
HP
HP
HP
HP
HP
HP
HP
HP
HP
HP
HP
HP
HP
HP
HP
HP
HP
HP
HP
HP
HP
HP
HP
"}
(26,1,1) = {"
HP
HP
HP
HP
HP
HP
HP
HP
HP
HP
HP
HP
HP
HP
HP
HP
HP
HP
HP
HP
HP
HP
HP
HP
HP
HP
HP
HP
HP
HP
HP
HP
HP
HP
HP
HP
HP
HP
"}
(27,1,1) = {"
HP
HP
HP
HP
HP
HP
HP
HP
HP
HP
HP
HP
HP
HP
HP
HP
HP
HP
HP
HP
HP
HP
HP
HP
HP
HP
HP
HP
HP
HP
HP
HP
HP
HP
HP
HP
HP
HP
"}
(28,1,1) = {"
HP
HP
HP
HP
HP
HP
HP
HP
HP
HP
HP
HP
HP
HP
HP
HP
HP
HP
HP
HP
HP
HP
HP
HP
HP
HP
HP
HP
HP
HP
HP
HP
HP
HP
HP
HP
HP
HP
"}
(29,1,1) = {"
HP
HP
HP
HP
HP
HP
HP
HP
HP
HP
HP
HP
HP
HP
HP
HP
HP
HP
HP
HP
HP
HP
HP
HP
HP
HP
HP
HP
HP
HP
HP
HP
HP
HP
HP
HP
HP
HP
"}
(30,1,1) = {"
uA
uA
uA
uA
uA
uA
uA
uA
uA
uA
uA
uA
uA
uA
uA
uA
uA
uA
uA
uA
uA
uA
uA
uA
uA
uA
uA
uA
uA
uA
uA
uA
uA
uA
uA
uA
uA
HP
"}
(31,1,1) = {"
uA
uA
oN
oN
oN
oN
oN
oN
oN
oN
oN
oN
oN
oN
oN
uA
uA
uA
uA
uA
uA
uA
uA
uA
uA
uA
uA
uA
uA
uA
uA
uA
uA
uA
uA
uA
uA
HP
"}
(32,1,1) = {"
uA
uA
oN
uA
uA
uA
uA
uA
uA
NI
NI
uA
uA
uA
oN
uA
uA
uA
uA
uA
uA
uA
uA
uA
uA
uA
uA
uA
uA
uA
uA
uA
uA
uA
uA
uA
uA
HP
"}
(33,1,1) = {"
uA
uA
oN
uA
uA
uA
uA
uA
NI
gE
gE
NI
uA
uA
oN
uA
uA
uA
uA
uA
uA
uA
uA
uA
uA
uA
uA
uA
uA
uA
uA
uA
uA
uA
uA
uA
uA
HP
"}
(34,1,1) = {"
uA
uA
oN
uA
uA
uA
uA
NI
gE
gE
kP
gE
NI
NI
oN
uA
uA
uA
uA
uA
uA
uA
uA
uA
uA
uA
uA
uA
uA
uA
uA
uA
uA
uA
uA
uA
uA
HP
"}
(35,1,1) = {"
uA
uA
oN
uA
uA
uA
NI
gE
gE
gE
gE
gE
gE
NI
oN
uA
uA
uA
uA
uA
uA
uA
uA
uA
uA
uA
uA
uA
uA
uA
uA
uA
uA
uA
uA
uA
uA
HP
"}
(36,1,1) = {"
uA
uA
oN
uA
uA
uA
gE
gE
gE
gE
gE
gE
gE
gE
oN
uA
uA
uA
uA
uA
uA
uA
uA
uA
uA
uA
uA
uA
uA
uA
uA
uA
uA
uA
uA
uA
uA
HP
"}
(37,1,1) = {"
uA
uA
oN
uA
gE
gE
gE
gE
gE
gE
gE
gE
gE
gE
oN
uA
uA
uA
uA
uA
uA
uA
uA
uA
uA
uA
uA
uA
uA
uA
uA
uA
uA
uA
uA
uA
uA
HP
"}
(38,1,1) = {"
uA
uA
oN
gE
gE
gE
gE
gE
gE
gE
gE
gE
gE
gE
em
gE
uA
uA
uA
uA
uA
uA
uA
uA
uA
uA
uA
uA
uA
uA
uA
uA
uA
uA
uA
uA
uA
HP
"}
(39,1,1) = {"
gE
gE
em
gE
gE
gE
gE
gE
gE
gE
gE
gE
gE
gE
em
gE
gE
gE
gE
gE
gE
gE
uA
uA
uA
uA
uA
uA
uA
uA
uA
uA
uA
uA
uA
uA
uA
HP
"}
(40,1,1) = {"
gE
NI
em
gE
NI
NI
gE
gE
gE
gE
gE
NI
gE
gE
em
gE
gE
gE
gE
gE
gE
gE
gE
uA
uA
uA
uA
uA
uA
uA
uA
uA
uA
uA
uA
uA
uA
HP
"}
(41,1,1) = {"
gE
gE
em
gE
gE
gE
gE
gE
gE
Yi
gE
gE
NI
NI
BM
NI
NI
NI
gE
NI
CD
NI
gE
gE
gE
Yi
uA
uA
uA
uA
uA
uA
uA
uA
uA
uA
uA
HP
"}
(42,1,1) = {"
gE
gE
em
gE
gE
gE
gE
gE
gE
gE
gE
gE
gE
gE
em
gE
gE
gE
gE
gE
gE
gE
NI
gE
gE
gE
gE
uA
uA
uA
uA
uA
uA
uA
uA
uA
uA
HP
"}
(43,1,1) = {"
gE
uA
oN
uA
uA
uA
uA
NI
gE
gE
gE
gE
gE
gE
em
gE
gE
gE
gE
gE
gE
gE
gE
gE
gE
gE
gE
gE
uA
uA
uA
uA
uA
uA
uA
uA
uA
HP
"}
(44,1,1) = {"
uA
uA
oN
oN
oN
oN
oN
oN
oN
oN
oN
oN
oN
oN
oN
uA
uA
gE
uA
uA
NI
NI
uA
NI
gE
gE
gE
gE
uA
uA
uA
uA
uA
uA
uA
uA
uA
HP
"}
(45,1,1) = {"
uA
uA
uA
uA
uA
uA
uA
uA
uA
uA
uA
uA
uA
uA
uA
uA
uA
uA
uA
uA
uA
uA
uA
uA
gE
gE
gE
gE
gE
uA
uA
uA
uA
uA
uA
uA
uA
HP
"}
(46,1,1) = {"
Vl
Vl
Vl
Vl
Vl
Vl
Vl
Vl
Vl
Vl
Vl
Vl
Vl
Vl
Vl
Vl
Vl
Vl
Vl
Vl
Vl
Vl
uA
uA
NI
gE
gE
gE
gE
gE
uA
uA
uA
uA
uA
uA
uA
HP
"}
(47,1,1) = {"
DE
DE
DE
DE
ff
ff
ff
ff
ff
ff
ff
ff
ff
ff
ff
ff
ff
ff
ff
ff
ff
ff
Vk
uA
gE
gE
gE
gE
gE
gE
gE
uA
uA
uA
uA
uA
uA
HP
"}
(48,1,1) = {"
hL
Ex
Ex
wS
ff
dE
UN
dE
UN
dE
ff
Bh
Ym
Bh
ff
Bh
Ym
Bh
ff
Bh
Ym
Bh
Vk
uA
Is
Yi
gE
gE
gE
gE
gE
uA
uA
uA
uA
uA
uA
HP
"}
(49,1,1) = {"
Tq
jx
vx
vx
vf
vx
vx
jx
vx
hA
ff
Bh
Bh
Bh
ff
Bh
Bh
Bh
ff
Bh
Bh
Bh
rU
NI
ln
gE
gE
gE
gE
gE
gE
uA
uA
uA
uA
uA
uA
HP
"}
(50,1,1) = {"
Tq
vx
vx
sg
ff
bN
JC
JC
vx
FS
ff
Bh
Bh
Bh
ff
Bh
Bh
Bh
ff
Bh
Bh
Bh
Vk
gE
Is
gE
gE
gE
gE
gE
gE
uA
uA
uA
uA
uA
uA
HP
"}
(51,1,1) = {"
aB
vx
vx
sg
Fc
pA
JC
JC
vx
rj
ff
Qq
oC
Qq
ff
Qq
oC
Qq
ff
Qq
oC
Qq
Vk
gE
Is
gE
gE
NI
gE
gE
gE
gE
uA
uA
uA
uA
uA
HP
"}
(52,1,1) = {"
Tq
vx
vx
sg
Fc
CT
JC
JC
vx
hA
Qr
JW
vx
JW
Qr
JW
vx
JW
Qr
JW
vx
JW
Vk
gE
Is
gE
gE
NI
gE
gE
gE
gE
gE
uA
uA
uA
uA
HP
"}
(53,1,1) = {"
aB
vx
vx
sg
Fc
Gf
vx
JC
JC
vx
hA
hA
vx
hA
Fr
hA
vx
hA
hA
hA
JC
hA
Vk
gE
Is
gE
gE
NI
gE
gE
gE
gE
gE
uA
uA
uA
uA
HP
"}
(54,1,1) = {"
Tq
jx
vx
sg
Fc
Gg
vx
cj
JC
JC
Fe
JC
JC
JC
vx
JC
JC
JC
vx
JC
vx
vx
Vk
gE
Is
gE
gE
NI
gE
gE
gE
gE
gE
uA
uA
uA
uA
HP
"}
(55,1,1) = {"
Tq
vx
vx
sg
Fc
HN
qw
AU
JC
JC
au
Sp
JC
Sp
Sp
Sp
JC
Sp
au
LS
vx
LS
Pr
gE
Is
Yi
gE
gE
gE
gE
gE
gE
Yi
uA
uA
uA
uA
HP
"}
(56,1,1) = {"
iC
qi
qi
kW
Fc
Pn
LS
uY
LS
Vx
Qr
Nj
vx
Nj
Qr
Nj
vx
Nj
Qr
Nj
vx
Nj
Vk
uA
ln
gE
gE
gE
gE
gE
gE
gE
gE
gE
uA
uA
uA
HP
"}
(57,1,1) = {"
ff
ff
ff
ff
ff
Qr
kb
VX
kb
Qr
ff
Qq
oC
Sk
ff
Qq
oC
Qq
ff
Qq
oC
Qq
Vk
uA
uA
uA
uA
gE
gE
gE
gE
gE
gE
gE
uA
uA
uA
HP
"}
(58,1,1) = {"
if
nk
nk
CS
Qr
RW
rl
uY
rl
wi
ff
XW
XW
XW
ff
XW
XW
XW
ff
XW
XW
XW
Vk
uA
uA
uA
uA
gE
uA
uA
gE
gE
gE
gE
gE
uA
uA
HP
"}
(59,1,1) = {"
kB
Nd
jr
Fk
Qr
HK
vx
He
Sv
lw
ff
XW
XW
XW
ff
XW
XW
XW
ff
XW
XW
XW
Vk
uA
uA
uA
uA
uA
uA
uA
uA
gE
gE
gE
gE
uA
uA
HP
"}
(60,1,1) = {"
if
nk
jr
Yt
Qr
Uj
Jl
uY
Jl
mX
ff
XW
SS
XW
ff
XW
SS
XW
ff
XW
SS
XW
Vk
Vl
Vl
Vl
Vl
Vl
Vl
Vl
uA
gE
Yi
hN
gE
uA
uA
HP
"}
(61,1,1) = {"
Qr
hd
Qr
Qr
Qr
Qr
kb
VX
kb
Qr
ff
ff
ff
ff
ff
ff
ff
ff
ff
ff
ff
ff
ff
ff
ff
ff
ff
ff
ff
Vl
uA
gE
gE
gE
gE
uA
uA
HP
"}
