//MAP CONVERTED BY dmm2tgm.py THIS HEADER COMMENT PREVENTS RECONVERSION, DO NOT REMOVE
"ak" = (
/obj/structure/closet/crate/secure,
/turf/open/floor/tile/dark/red2/corner,
/area/bigredv2/outside/nanotrasen_lab/inside)
"aW" = (
/obj/effect/landmark/lv624/fog_blocker/xeno_spawn,
/turf/open/floor/plating/ground/mars/random/cave,
/area/bigredv2/caves/south)
"cQ" = (
/obj/structure/table,
/obj/effect/spawner/random/engineering/technology_scanner,
/turf/open/floor/tile/dark/red2/corner{
	dir = 8
	},
/area/bigredv2/outside/nanotrasen_lab/inside)
"dB" = (
/obj/structure/xenoautopsy/tank/hugger,
/turf/open/floor/tile/dark/red2/corner{
	dir = 8
	},
/area/bigredv2/outside/nanotrasen_lab/inside)
"dM" = (
/obj/effect/spawner/random/engineering/structure/tank/fuelweighted,
/turf/open/floor/plating,
/area/bigredv2/outside/nanotrasen_lab/inside)
"eY" = (
/obj/structure/bed/chair{
	dir = 8
	},
/turf/open/floor/tile/dark/red2{
	dir = 8
	},
/area/bigredv2/outside/nanotrasen_lab/inside)
"gD" = (
/turf/open/floor/tile/darkgreen/darkgreen2{
	dir = 4
	},
/area/bigredv2/outside/nanotrasen_lab/inside)
"hf" = (
/turf/open/floor/tile/darkgreen/darkgreen2{
	dir = 8
	},
/area/bigredv2/outside/nanotrasen_lab/inside)
"hY" = (
/obj/machinery/door/airlock/mainship/research/glass/free_access{
	name = "\improper Eta Lab Cell"
	},
/turf/open/floor/tile/dark,
/area/bigredv2/outside/nanotrasen_lab/inside)
"iN" = (
/turf/closed/wall/r_wall,
/area/bigredv2/outside/nanotrasen_lab/inside)
"jy" = (
/obj/structure/cable,
/obj/machinery/door/airlock/mainship/maint/free_access{
	name = "\improper Eta Lab Maintenance Storage"
	},
/turf/open/floor/tile/dark,
/area/bigredv2/outside/nanotrasen_lab/inside)
"kg" = (
/obj/machinery/atmospherics/pipe/simple/green/hidden{
	dir = 4
	},
/obj/machinery/door/airlock/mainship/research/glass/free_access{
	name = "\improper Eta Lab Xenobiology Lab"
	},
/turf/open/floor/tile/dark,
/area/bigredv2/outside/nanotrasen_lab/inside)
"kv" = (
/obj/machinery/computer/security,
/turf/open/floor/tile/dark/red2/corner{
	dir = 4
	},
/area/bigredv2/outside/nanotrasen_lab/inside)
"lH" = (
/obj/effect/ai_node,
/turf/open/ground/jungle/clear,
/area/bigredv2/outside/nanotrasen_lab/inside)
"lQ" = (
/obj/effect/decal/cleanable/dirt,
/turf/open/floor/tile/dark/red2/corner,
/area/bigredv2/outside/nanotrasen_lab/inside)
"nN" = (
/obj/effect/ai_node,
/turf/open/floor/plating/ground/mars/random/sand,
/area/bigredv2/outside/nanotrasen_lab/inside)
"op" = (
/obj/effect/landmark/lv624/fog_blocker,
/turf/open/floor/plating/ground/mars/random/cave,
/area/bigredv2/caves/rock)
"ow" = (
/turf/open/floor/tile/dark/red2/corner{
	dir = 4
	},
/area/bigredv2/outside/nanotrasen_lab/inside)
"oG" = (
/turf/open/floor/tile/dark,
/area/bigredv2/outside/nanotrasen_lab/inside)
"pk" = (
/obj/structure/cable,
/obj/effect/ai_node,
/turf/open/floor/plating,
/area/bigredv2/outside/nanotrasen_lab/inside)
"qE" = (
/obj/machinery/light{
	dir = 1
	},
/turf/open/floor/tile/dark/red2{
	dir = 9
	},
/area/bigredv2/outside/nanotrasen_lab/inside)
"rV" = (
/turf/open/floor/tile/dark/red2{
	dir = 8
	},
/area/bigredv2/outside/nanotrasen_lab/inside)
"sd" = (
/obj/structure/window/framed/colony,
/turf/open/floor/plating,
/area/bigredv2/outside/nanotrasen_lab/inside)
"sx" = (
/turf/open/floor/tile/darkgreen/darkgreen2{
	dir = 10
	},
/area/bigredv2/outside/nanotrasen_lab/inside)
"sP" = (
/turf/open/floor/tile/dark/red2{
	dir = 1
	},
/area/bigredv2/outside/nanotrasen_lab/inside)
"th" = (
/turf/open/floor/tile/darkgreen/darkgreen2{
	dir = 6
	},
/area/bigredv2/outside/nanotrasen_lab/inside)
"tn" = (
/turf/open/ground/jungle/clear,
/area/bigredv2/outside/nanotrasen_lab/inside)
"tF" = (
/obj/effect/decal/cleanable/blood/gibs,
/turf/open/floor/plating/ground/mars/random/cave,
/area/bigredv2/caves/south)
"tW" = (
/obj/effect/decal/cleanable/dirt,
/turf/open/floor/tile/dark,
/area/bigredv2/outside/nanotrasen_lab/inside)
"um" = (
/obj/effect/landmark/excavation_site_spawner,
/turf/open/floor/plating/ground/mars/random/cave,
/area/bigredv2/caves/south)
"uI" = (
/obj/machinery/light{
	dir = 8
	},
/turf/open/floor/plating/ground/mars/random/sand,
/area/bigredv2/outside/nanotrasen_lab/inside)
"uV" = (
/obj/structure/closet/toolcloset,
/turf/open/floor/plating,
/area/bigredv2/outside/nanotrasen_lab/inside)
"ve" = (
/obj/structure/table,
/obj/item/tool/pen,
/turf/open/floor/tile/dark/red2/corner{
	dir = 4
	},
/area/bigredv2/outside/nanotrasen_lab/inside)
"vV" = (
/obj/machinery/light{
	dir = 4
	},
/obj/effect/decal/cleanable/dirt,
/obj/effect/ai_node,
/turf/open/floor/tile/dark/red2/corner,
/area/bigredv2/outside/nanotrasen_lab/inside)
"wj" = (
/obj/effect/landmark/lv624/fog_blocker/xeno_spawn,
/turf/open/floor/plating/ground/mars/random/cave/rock,
/area/bigredv2/caves/south)
"wO" = (
/obj/effect/landmark/xeno_silo_spawn,
/turf/open/floor/plating/ground/mars/random/cave,
/area/bigredv2/caves/south)
"xc" = (
/obj/structure/table,
/obj/effect/spawner/random/engineering/technology_scanner,
/turf/open/floor/tile/dark/red2/corner{
	dir = 4
	},
/area/bigredv2/outside/nanotrasen_lab/inside)
"xw" = (
/turf/open/floor/tile/dark/red2{
	dir = 10
	},
/area/bigredv2/outside/nanotrasen_lab/inside)
"xT" = (
/obj/machinery/light{
	dir = 8
	},
/turf/open/floor/tile/dark/red2/corner{
	dir = 8
	},
/area/bigredv2/outside/nanotrasen_lab/inside)
"zh" = (
/obj/machinery/light{
	dir = 1
	},
/turf/open/floor/tile/dark/red2{
	dir = 5
	},
/area/bigredv2/outside/nanotrasen_lab/inside)
"zy" = (
/obj/structure/table,
/obj/structure/xenoautopsy,
/turf/open/floor/tile/dark/red2/corner{
	dir = 4
	},
/area/bigredv2/outside/nanotrasen_lab/inside)
"zH" = (
/obj/machinery/atmospherics/components/unary/vent_pump{
	dir = 4;
	on = 1
	},
/turf/open/floor/tile/dark,
/area/bigredv2/outside/nanotrasen_lab/inside)
"BJ" = (
/turf/open/floor/plating/ground/mars/random/sand,
/area/bigredv2/outside/nanotrasen_lab/inside)
"Ck" = (
/obj/structure/table,
/obj/item/alienjar,
/turf/open/floor/tile/dark/red2/corner{
	dir = 4
	},
/area/bigredv2/outside/nanotrasen_lab/inside)
"CR" = (
/turf/closed/mineral/smooth/bigred,
/area/bigredv2/caves/rock)
"Dm" = (
/turf/open/floor/tile/dark/red2/corner{
	dir = 8
	},
/area/bigredv2/outside/nanotrasen_lab/inside)
"DF" = (
/obj/machinery/atmospherics/pipe/simple/green/hidden{
	dir = 4
	},
/turf/open/floor/tile/dark,
/area/bigredv2/outside/nanotrasen_lab/inside)
"DS" = (
/obj/effect/decal/cleanable/dirt,
/obj/effect/ai_node,
/turf/open/floor/tile/dark,
/area/bigredv2/outside/nanotrasen_lab/inside)
"DY" = (
/turf/open/floor/tile/dark/red2,
/area/bigredv2/outside/nanotrasen_lab/inside)
"EK" = (
/turf/open/floor/plating,
/area/bigredv2/outside/nanotrasen_lab/inside)
"Fp" = (
/obj/structure/xenoautopsy/tank,
/turf/open/floor/tile/dark/red2/corner{
	dir = 8
	},
/area/bigredv2/outside/nanotrasen_lab/inside)
"GM" = (
/obj/structure/table,
/obj/machinery/light,
/obj/effect/spawner/random/engineering/technology_scanner,
/obj/item/xenos_claw,
/turf/open/floor/tile/dark/red2/corner{
	dir = 8
	},
/area/bigredv2/outside/nanotrasen_lab/inside)
"HX" = (
/obj/machinery/light,
/turf/open/floor/tile/darkgreen/darkgreen2,
/area/bigredv2/outside/nanotrasen_lab/inside)
"Ii" = (
/turf/open/floor/plating/ground/mars/random/cave,
/area/bigredv2/caves/rock)
"JN" = (
/turf/open/floor/plating/ground/mars/random/cave/rock,
/area/bigredv2/caves/south)
"JW" = (
/obj/effect/landmark/lv624/fog_blocker/xeno_spawn,
/turf/closed/mineral/smooth/bigred,
/area/bigredv2/caves/rock)
"Kh" = (
/turf/open/floor/tile/dark/red2/corner,
/area/bigredv2/outside/nanotrasen_lab/inside)
"Kp" = (
/turf/open/floor/plating/ground/mars/random/cave,
/area/bigredv2/caves/south)
"KJ" = (
/obj/effect/landmark/lv624/fog_blocker/xeno_spawn,
/turf/open/floor/plating/ground/mars/random/cave,
/area/bigredv2/caves/rock)
"KK" = (
/obj/structure/cable,
/obj/machinery/power/apc/high/ntf{
	dir = 1
	},
/turf/open/floor/plating,
/area/bigredv2/outside/nanotrasen_lab/inside)
"Ly" = (
/obj/effect/ai_node,
/turf/open/floor/tile/dark,
/area/bigredv2/outside/nanotrasen_lab/inside)
"LP" = (
/obj/effect/ai_node,
/turf/open/floor/plating/ground/mars/random/cave/rock,
/area/bigredv2/caves/south)
"LZ" = (
/obj/effect/decal/cleanable/dirt,
/turf/open/floor/tile/dark/red2/corner{
	dir = 8
	},
/area/bigredv2/outside/nanotrasen_lab/inside)
"NK" = (
/obj/structure/cable,
/turf/open/floor/plating,
/area/bigredv2/outside/nanotrasen_lab/inside)
"NL" = (
/obj/structure/fence/standard/xenoproof,
/turf/open/floor/plating/ground/mars/random/cave/rock,
/area/bigredv2/caves/south)
"NO" = (
/obj/structure/table,
/obj/item/paper,
/turf/open/floor/tile/dark/red2/corner,
/area/bigredv2/outside/nanotrasen_lab/inside)
"Oh" = (
/obj/structure/fence/standard/xenoproof,
/turf/open/floor/plating/ground/mars/random/cave,
/area/bigredv2/caves/south)
"Ot" = (
/obj/structure/bed/chair{
	dir = 4
	},
/turf/open/floor/tile/dark/red2{
	dir = 4
	},
/area/bigredv2/outside/nanotrasen_lab/inside)
"Oz" = (
/obj/structure/closet/l3closet/scientist,
/turf/open/floor/tile/darkgreen/darkgreen2{
	dir = 5
	},
/area/bigredv2/outside/nanotrasen_lab/inside)
"PE" = (
/turf/closed/mineral/smooth/bigred/indestructible,
/area/space)
"QU" = (
/obj/structure/closet/firecloset,
/turf/open/floor/plating,
/area/bigredv2/outside/nanotrasen_lab/inside)
"Rw" = (
/obj/structure/closet/l3closet/scientist,
/turf/open/floor/tile/darkgreen/darkgreen2{
	dir = 1
	},
/area/bigredv2/outside/nanotrasen_lab/inside)
"RA" = (
/obj/item/target,
/turf/open/floor/tile/dark/red2{
	dir = 1
	},
/area/bigredv2/outside/nanotrasen_lab/inside)
"RE" = (
/obj/machinery/light{
	dir = 4
	},
/turf/open/ground/jungle/clear,
/area/bigredv2/outside/nanotrasen_lab/inside)
"Sc" = (
/obj/structure/window/framed/colony/reinforced,
/turf/open/floor/plating,
/area/bigredv2/outside/nanotrasen_lab/inside)
"Sm" = (
/obj/machinery/atmospherics/components/unary/vent_pump{
	dir = 1;
	on = 1
	},
/turf/open/floor/tile/dark,
/area/bigredv2/outside/nanotrasen_lab/inside)
"TA" = (
/turf/open/floor/tile/dark/red2{
	dir = 4
	},
/area/bigredv2/outside/nanotrasen_lab/inside)
"TN" = (
/obj/structure/xenoautopsy/tank/broken,
/turf/open/floor/tile/dark/red2/corner{
	dir = 8
	},
/area/bigredv2/outside/nanotrasen_lab/inside)
"TT" = (
/obj/effect/ai_node,
/turf/open/floor/plating/ground/mars/random/cave,
/area/bigredv2/caves/south)
"UT" = (
/obj/machinery/atmospherics/pipe/manifold/green/hidden{
	dir = 1
	},
/obj/effect/ai_node,
/turf/open/floor/tile/dark,
/area/bigredv2/outside/nanotrasen_lab/inside)
"Vq" = (
/obj/effect/landmark/lv624/fog_blocker,
/turf/closed/mineral/smooth/bigred,
/area/bigredv2/caves/rock)
"VI" = (
/obj/structure/bed/chair{
	dir = 4
	},
/obj/effect/landmark/excavation_site_spawner,
/turf/open/floor/tile/dark/red2{
	dir = 4
	},
/area/bigredv2/outside/nanotrasen_lab/inside)
"Wa" = (
/obj/effect/landmark/lv624/fog_blocker,
/turf/closed/wall/r_wall,
/area/bigredv2/outside/nanotrasen_lab/inside)
"Yn" = (
/obj/machinery/atmospherics/pipe/simple/green/hidden{
	dir = 4
	},
/obj/effect/ai_node,
/turf/open/floor/tile/dark,
/area/bigredv2/outside/nanotrasen_lab/inside)
"Yp" = (
/obj/structure/closet/l3closet/scientist,
/turf/open/floor/tile/darkgreen/darkgreen2{
	dir = 9
	},
/area/bigredv2/outside/nanotrasen_lab/inside)
"YI" = (
/turf/open/floor/tile/dark/red2{
	dir = 6
	},
/area/bigredv2/outside/nanotrasen_lab/inside)
"YK" = (
/turf/closed/wall,
/area/bigredv2/outside/nanotrasen_lab/inside)
"YO" = (
/obj/machinery/miner/damaged/platinum,
/turf/open/floor/plating/ground/mars/random/cave/rock,
/area/bigredv2/caves/south)
"ZR" = (
/obj/machinery/door/airlock/mainship/research/glass/free_access{
	dir = 1;
	name = "\improper Eta Lab Cell"
	},
/turf/open/floor/tile/dark,
/area/bigredv2/outside/nanotrasen_lab/inside)

(1,1,1) = {"
PE
PE
PE
PE
PE
PE
PE
PE
PE
PE
PE
PE
PE
PE
PE
PE
PE
PE
PE
PE
PE
PE
PE
PE
PE
PE
PE
PE
PE
PE
PE
PE
PE
PE
PE
PE
PE
PE
"}
(2,1,1) = {"
PE
PE
PE
PE
PE
PE
PE
PE
PE
PE
PE
PE
PE
PE
PE
PE
PE
PE
PE
PE
PE
PE
PE
PE
PE
PE
PE
PE
PE
PE
PE
PE
PE
PE
PE
PE
PE
PE
"}
(3,1,1) = {"
PE
PE
PE
PE
PE
PE
PE
PE
PE
PE
PE
PE
PE
PE
PE
PE
PE
PE
PE
PE
PE
PE
PE
PE
PE
PE
PE
PE
PE
PE
PE
PE
PE
PE
PE
PE
PE
PE
"}
(4,1,1) = {"
PE
PE
PE
PE
PE
PE
PE
PE
PE
PE
PE
PE
PE
PE
PE
PE
PE
PE
PE
PE
PE
PE
PE
PE
PE
PE
PE
PE
PE
PE
PE
PE
PE
PE
PE
PE
PE
PE
"}
(5,1,1) = {"
PE
PE
PE
PE
PE
PE
PE
PE
PE
PE
PE
PE
PE
PE
PE
PE
PE
PE
PE
PE
PE
PE
PE
PE
PE
PE
PE
PE
PE
PE
PE
PE
PE
PE
PE
PE
PE
PE
"}
(6,1,1) = {"
PE
PE
PE
PE
PE
PE
PE
PE
PE
PE
PE
PE
PE
PE
PE
PE
PE
PE
PE
PE
PE
PE
PE
PE
PE
PE
PE
PE
PE
PE
PE
PE
PE
PE
PE
PE
PE
PE
"}
(7,1,1) = {"
PE
PE
PE
PE
PE
PE
PE
PE
PE
PE
PE
PE
PE
PE
PE
PE
PE
PE
PE
PE
PE
PE
PE
PE
PE
PE
PE
PE
PE
PE
PE
PE
PE
PE
PE
PE
PE
PE
"}
(8,1,1) = {"
PE
PE
PE
PE
PE
PE
PE
PE
PE
PE
PE
PE
PE
PE
PE
PE
PE
PE
PE
PE
PE
PE
PE
PE
PE
PE
PE
PE
PE
PE
PE
PE
PE
PE
PE
PE
PE
PE
"}
(9,1,1) = {"
PE
PE
PE
PE
PE
PE
PE
PE
PE
PE
PE
PE
PE
PE
PE
PE
PE
PE
PE
PE
PE
PE
PE
PE
PE
PE
PE
PE
PE
PE
PE
PE
PE
PE
PE
PE
PE
PE
"}
(10,1,1) = {"
PE
PE
PE
PE
PE
PE
PE
PE
PE
PE
PE
PE
PE
PE
PE
PE
PE
PE
PE
PE
PE
PE
PE
PE
PE
PE
PE
PE
PE
PE
PE
PE
PE
PE
PE
PE
PE
PE
"}
(11,1,1) = {"
PE
PE
PE
PE
PE
PE
PE
PE
PE
PE
PE
PE
PE
PE
PE
PE
PE
PE
PE
PE
PE
PE
PE
PE
PE
PE
PE
PE
PE
PE
PE
PE
PE
PE
PE
PE
PE
PE
"}
(12,1,1) = {"
PE
PE
PE
PE
PE
PE
PE
PE
PE
PE
PE
PE
PE
PE
PE
PE
PE
PE
PE
PE
PE
PE
PE
PE
PE
PE
PE
PE
PE
PE
PE
PE
PE
PE
PE
PE
PE
PE
"}
(13,1,1) = {"
PE
PE
PE
PE
PE
PE
PE
PE
PE
PE
PE
PE
PE
PE
PE
PE
PE
PE
PE
PE
PE
PE
PE
PE
PE
PE
PE
PE
PE
PE
PE
PE
PE
PE
PE
PE
PE
PE
"}
(14,1,1) = {"
PE
PE
PE
PE
PE
PE
PE
PE
PE
PE
PE
PE
PE
PE
PE
PE
PE
PE
PE
PE
PE
PE
PE
PE
PE
PE
PE
PE
PE
PE
PE
PE
PE
PE
PE
PE
PE
PE
"}
(15,1,1) = {"
PE
PE
PE
PE
PE
PE
PE
PE
PE
PE
PE
PE
PE
PE
PE
PE
PE
PE
PE
PE
PE
PE
PE
PE
PE
PE
PE
PE
PE
PE
PE
PE
PE
PE
PE
PE
PE
PE
"}
(16,1,1) = {"
PE
PE
PE
PE
PE
PE
PE
PE
PE
PE
PE
PE
PE
PE
PE
PE
PE
PE
PE
PE
PE
PE
PE
PE
PE
PE
PE
PE
PE
PE
PE
PE
PE
PE
PE
PE
PE
PE
"}
(17,1,1) = {"
PE
PE
PE
PE
PE
PE
PE
PE
PE
PE
PE
PE
PE
PE
PE
PE
PE
PE
PE
PE
PE
PE
PE
PE
PE
PE
PE
PE
PE
PE
PE
PE
PE
PE
PE
PE
PE
PE
"}
(18,1,1) = {"
PE
PE
PE
PE
PE
PE
PE
PE
PE
PE
PE
PE
PE
PE
PE
PE
PE
PE
PE
PE
PE
PE
PE
PE
PE
PE
PE
PE
PE
PE
PE
PE
PE
PE
PE
PE
PE
PE
"}
(19,1,1) = {"
PE
PE
PE
PE
PE
PE
PE
PE
PE
PE
PE
PE
PE
PE
PE
PE
PE
PE
PE
PE
PE
PE
PE
PE
PE
PE
PE
PE
PE
PE
PE
PE
PE
PE
PE
PE
PE
PE
"}
(20,1,1) = {"
PE
PE
PE
PE
PE
PE
PE
PE
PE
PE
PE
PE
PE
PE
PE
PE
PE
PE
PE
PE
PE
PE
PE
PE
PE
PE
PE
PE
PE
PE
PE
PE
PE
PE
PE
PE
PE
PE
"}
(21,1,1) = {"
PE
PE
PE
PE
PE
PE
PE
PE
PE
PE
PE
PE
PE
PE
PE
PE
PE
PE
PE
PE
PE
PE
PE
PE
PE
PE
PE
PE
PE
PE
PE
PE
PE
PE
PE
PE
PE
PE
"}
(22,1,1) = {"
PE
PE
PE
PE
PE
PE
PE
PE
PE
PE
PE
PE
PE
PE
PE
PE
PE
PE
PE
PE
PE
PE
PE
PE
PE
PE
PE
PE
PE
PE
PE
PE
PE
PE
PE
PE
PE
PE
"}
(23,1,1) = {"
PE
PE
PE
PE
PE
PE
PE
PE
PE
PE
PE
PE
PE
PE
PE
PE
PE
PE
PE
PE
PE
PE
PE
PE
PE
PE
PE
PE
PE
PE
PE
PE
PE
PE
PE
PE
PE
PE
"}
(24,1,1) = {"
PE
PE
PE
PE
PE
PE
PE
PE
PE
PE
PE
PE
PE
PE
PE
PE
PE
PE
PE
PE
PE
PE
PE
PE
PE
PE
PE
PE
PE
PE
PE
PE
PE
PE
PE
PE
PE
PE
"}
(25,1,1) = {"
PE
PE
PE
PE
PE
PE
PE
PE
PE
PE
PE
PE
PE
PE
PE
PE
PE
PE
PE
PE
PE
PE
PE
PE
PE
PE
PE
PE
PE
PE
PE
PE
PE
PE
PE
PE
PE
PE
"}
(26,1,1) = {"
PE
PE
PE
PE
PE
PE
PE
PE
PE
PE
PE
PE
PE
PE
PE
PE
PE
PE
PE
PE
PE
PE
PE
PE
PE
PE
PE
PE
PE
PE
PE
PE
PE
PE
PE
PE
PE
PE
"}
(27,1,1) = {"
PE
PE
PE
PE
PE
PE
PE
PE
PE
PE
PE
PE
PE
PE
PE
PE
PE
PE
PE
PE
PE
PE
PE
PE
PE
PE
PE
PE
PE
PE
PE
PE
PE
PE
PE
PE
PE
PE
"}
(28,1,1) = {"
PE
PE
PE
PE
PE
PE
PE
PE
PE
PE
PE
PE
PE
PE
PE
PE
PE
PE
PE
PE
PE
PE
PE
PE
PE
PE
PE
PE
PE
PE
PE
PE
PE
PE
PE
PE
PE
PE
"}
(29,1,1) = {"
PE
PE
PE
PE
PE
PE
PE
PE
PE
PE
PE
PE
PE
PE
PE
PE
PE
PE
PE
PE
PE
PE
PE
PE
PE
PE
PE
PE
PE
PE
PE
PE
PE
PE
PE
PE
PE
PE
"}
(30,1,1) = {"
CR
CR
CR
CR
CR
CR
CR
CR
CR
CR
CR
CR
CR
CR
CR
CR
CR
CR
CR
CR
CR
CR
CR
CR
CR
CR
CR
CR
CR
CR
CR
CR
CR
CR
CR
CR
CR
PE
"}
(31,1,1) = {"
CR
CR
JW
JW
JW
JW
JW
JW
JW
JW
JW
JW
JW
JW
JW
CR
CR
CR
CR
CR
CR
CR
CR
CR
CR
CR
CR
CR
CR
CR
CR
CR
CR
CR
CR
CR
CR
PE
"}
(32,1,1) = {"
CR
CR
JW
CR
CR
CR
CR
CR
CR
JN
JN
CR
CR
CR
JW
CR
CR
CR
CR
CR
CR
CR
CR
CR
CR
CR
CR
CR
CR
CR
CR
CR
CR
CR
CR
CR
CR
PE
"}
(33,1,1) = {"
CR
CR
JW
CR
CR
CR
CR
CR
JN
Kp
Kp
JN
CR
CR
JW
CR
CR
CR
CR
CR
CR
CR
CR
CR
CR
CR
CR
CR
CR
CR
CR
CR
CR
CR
CR
CR
CR
PE
"}
(34,1,1) = {"
CR
CR
JW
CR
CR
CR
CR
JN
Kp
Kp
wO
Kp
JN
JN
JW
CR
CR
CR
CR
CR
CR
CR
CR
CR
CR
CR
CR
CR
CR
CR
CR
CR
CR
CR
CR
CR
CR
PE
"}
(35,1,1) = {"
CR
CR
JW
CR
CR
CR
JN
Kp
Kp
Kp
Kp
Kp
Kp
JN
JW
CR
CR
CR
CR
CR
CR
CR
CR
CR
CR
CR
CR
CR
CR
CR
CR
CR
CR
CR
CR
CR
CR
PE
"}
(36,1,1) = {"
CR
CR
JW
CR
CR
CR
Kp
Kp
Kp
Kp
Kp
Kp
Kp
Kp
JW
CR
CR
CR
CR
CR
CR
CR
CR
CR
CR
CR
CR
CR
CR
CR
CR
CR
CR
CR
CR
CR
CR
PE
"}
(37,1,1) = {"
CR
CR
JW
CR
Kp
Kp
Kp
um
Kp
Kp
Kp
Kp
Kp
Kp
JW
CR
CR
CR
CR
CR
CR
CR
CR
CR
CR
CR
CR
CR
CR
CR
CR
CR
CR
CR
CR
CR
CR
PE
"}
(38,1,1) = {"
CR
CR
JW
Kp
Kp
Kp
Kp
Kp
Kp
Kp
Kp
Kp
Kp
Kp
aW
Kp
CR
CR
CR
CR
CR
CR
CR
CR
CR
CR
CR
CR
CR
CR
CR
CR
CR
CR
CR
CR
CR
PE
"}
(39,1,1) = {"
Kp
Kp
aW
Kp
Kp
Kp
Kp
Kp
Kp
Kp
Kp
Kp
Kp
Kp
aW
Kp
Kp
Kp
Kp
Kp
Kp
Kp
CR
CR
CR
CR
CR
CR
CR
CR
CR
CR
CR
CR
CR
CR
CR
PE
"}
(40,1,1) = {"
Kp
JN
aW
Kp
JN
JN
Kp
Kp
Kp
Kp
Kp
JN
Kp
Kp
aW
Kp
Kp
Kp
Kp
Kp
Kp
Kp
Kp
CR
CR
CR
CR
CR
CR
CR
CR
CR
CR
CR
CR
CR
CR
PE
"}
(41,1,1) = {"
Kp
Kp
aW
Kp
Kp
Kp
Kp
Kp
Kp
TT
Kp
Kp
JN
JN
wj
JN
JN
JN
Kp
JN
LP
JN
Kp
Kp
Kp
TT
CR
CR
CR
CR
CR
CR
CR
CR
CR
CR
CR
PE
"}
(42,1,1) = {"
Kp
Kp
aW
Kp
Kp
Kp
Kp
Kp
Kp
Kp
Kp
Kp
Kp
Kp
aW
Kp
Kp
Kp
Kp
Kp
Kp
Kp
JN
Kp
Kp
Kp
Kp
CR
CR
CR
CR
CR
CR
CR
CR
CR
CR
PE
"}
(43,1,1) = {"
Kp
CR
JW
CR
CR
CR
CR
JN
Kp
Kp
Kp
Kp
Kp
Kp
aW
Kp
Kp
Kp
Kp
Kp
Kp
Kp
Kp
Kp
Kp
Kp
Kp
Kp
CR
CR
CR
CR
CR
CR
CR
CR
CR
PE
"}
(44,1,1) = {"
CR
CR
JW
JW
JW
JW
JW
JW
JW
JW
KJ
KJ
KJ
KJ
JW
CR
CR
Kp
CR
CR
JN
JN
CR
JN
Kp
Kp
Kp
Kp
CR
CR
CR
CR
CR
CR
CR
CR
CR
PE
"}
(45,1,1) = {"
CR
CR
CR
CR
CR
CR
CR
CR
CR
CR
Ii
Ii
Ii
Ii
CR
CR
CR
CR
CR
CR
CR
CR
CR
CR
Kp
Kp
Kp
Kp
Kp
CR
CR
CR
CR
CR
CR
CR
CR
PE
"}
(46,1,1) = {"
Vq
Vq
Vq
Vq
Vq
Vq
Vq
Vq
Vq
Vq
Vq
op
op
op
Vq
Vq
Vq
Vq
Vq
Vq
Vq
Vq
CR
CR
JN
Kp
Kp
Kp
Kp
Kp
CR
CR
CR
CR
CR
CR
CR
PE
"}
(47,1,1) = {"
iN
iN
iN
iN
iN
iN
iN
iN
iN
iN
iN
iN
iN
iN
iN
iN
iN
iN
iN
iN
iN
iN
Wa
CR
Kp
Kp
Kp
Kp
Kp
Kp
Kp
CR
CR
CR
CR
CR
CR
PE
"}
(48,1,1) = {"
qE
rV
rV
xw
iN
Fp
TN
dB
dB
dB
iN
BJ
uI
BJ
iN
BJ
uI
BJ
iN
BJ
uI
BJ
Wa
CR
Oh
TT
Kp
um
Kp
Kp
Kp
CR
CR
CR
CR
CR
CR
PE
"}
(49,1,1) = {"
sP
Ly
oG
oG
ZR
oG
oG
Ly
oG
LZ
iN
BJ
nN
BJ
iN
BJ
nN
BJ
iN
BJ
nN
BJ
Wa
JN
NL
Kp
Kp
Kp
Kp
Kp
Kp
CR
CR
CR
CR
CR
CR
PE
"}
(50,1,1) = {"
sP
oG
oG
DY
iN
ow
tW
tW
tW
cQ
iN
BJ
BJ
BJ
iN
BJ
BJ
BJ
iN
BJ
BJ
BJ
Wa
Kp
Oh
Kp
Kp
Kp
Kp
Kp
Kp
CR
CR
CR
CR
CR
CR
PE
"}
(51,1,1) = {"
RA
oG
oG
DY
Sc
kv
tW
tW
oG
GM
iN
Sc
hY
Sc
iN
Sc
hY
Sc
iN
Sc
hY
Sc
Wa
Kp
Oh
Kp
Kp
JN
Kp
Kp
Kp
Kp
CR
CR
CR
CR
CR
PE
"}
(52,1,1) = {"
sP
oG
oG
DY
Sc
xc
tW
tW
oG
Dm
YK
eY
tW
eY
YK
eY
oG
eY
YK
eY
oG
eY
Wa
Kp
Oh
Kp
Kp
YO
Kp
Kp
Kp
Kp
Kp
CR
CR
CR
CR
PE
"}
(53,1,1) = {"
RA
oG
oG
DY
Sc
Ck
oG
tW
tW
oG
Dm
LZ
oG
Dm
xT
Dm
oG
Dm
Dm
Dm
tW
Dm
Wa
Kp
Oh
Kp
Kp
JN
Kp
Kp
Kp
Kp
Kp
CR
CR
CR
CR
PE
"}
(54,1,1) = {"
sP
Ly
oG
DY
Sc
zy
oG
zH
tW
tW
oG
tW
tW
tW
oG
tW
tW
tW
oG
tW
oG
tW
Wa
Kp
Oh
Kp
Kp
JN
Kp
Kp
Kp
Kp
Kp
CR
CR
CR
CR
PE
"}
(55,1,1) = {"
sP
oG
oG
DY
Sc
ve
oG
Yn
tW
tW
vV
lQ
DS
lQ
lQ
lQ
DS
lQ
vV
Kh
Ly
Kh
Wa
Kp
Oh
TT
Kp
Kp
Kp
Kp
Kp
Kp
TT
CR
CR
CR
CR
PE
"}
(56,1,1) = {"
zh
TA
TA
YI
Sc
NO
Kh
DF
Kh
ak
YK
Ot
oG
VI
YK
Ot
oG
Ot
YK
Ot
tW
Ot
Wa
CR
NL
Kp
Kp
Kp
Kp
Kp
Kp
Kp
Kp
Kp
CR
CR
CR
PE
"}
(57,1,1) = {"
iN
iN
iN
iN
iN
YK
sd
kg
sd
YK
iN
Sc
hY
Sc
iN
Sc
hY
Sc
iN
Sc
hY
Sc
Wa
CR
CR
CR
CR
Kp
Kp
Kp
Kp
Kp
Kp
Kp
CR
CR
CR
PE
"}
(58,1,1) = {"
dM
NK
NK
KK
YK
Yp
hf
DF
hf
sx
iN
tn
tn
tn
iN
tn
tn
tn
iN
tn
tn
tn
Wa
CR
CR
CR
CR
Kp
CR
CR
Kp
Kp
Kp
Kp
Kp
CR
CR
PE
"}
(59,1,1) = {"
dM
pk
EK
QU
YK
Rw
oG
UT
Sm
HX
iN
tn
lH
tn
iN
tn
lH
tn
iN
tn
lH
tn
Wa
CR
CR
CR
CR
CR
CR
CR
CR
Kp
Kp
Kp
Kp
CR
CR
PE
"}
(60,1,1) = {"
dM
NK
EK
uV
YK
Oz
gD
DF
gD
th
iN
tn
RE
tn
iN
tn
RE
tn
iN
tn
RE
tn
Wa
Vq
Vq
Vq
Vq
Vq
Vq
Vq
CR
Kp
TT
tF
Kp
CR
CR
PE
"}
(61,1,1) = {"
YK
jy
YK
YK
YK
YK
sd
kg
sd
YK
iN
iN
iN
iN
iN
iN
iN
iN
iN
iN
iN
iN
iN
iN
iN
iN
iN
iN
iN
Vq
CR
Kp
Kp
Kp
Kp
CR
CR
PE
"}
