//MAP CONVERTED BY dmm2tgm.py THIS HEADER COMMENT PREVENTS RECONVERSION, DO NOT REMOVE
"aL" = (
/obj/structure/table,
/obj/effect/spawner/random/engineering/technology_scanner,
/turf/open/floor/tile/dark/red2/corner{
	dir = 8
	},
/area/bigredv3/inside/science/xenolab)
"cG" = (
/obj/structure/closet/l3closet/scientist,
/turf/open/floor/tile/darkgreen/darkgreen2{
	dir = 9
	},
/area/bigredv3/inside/science/xenolab)
"cQ" = (
/turf/closed/mineral/smooth/bigred/indestructible,
/area/bigredv3/inside/wall)
"eI" = (
/obj/effect/spawner/random/engineering/structure/tank/fuelweighted,
/obj/machinery/light/small{
	dir = 1
	},
/turf/open/floor/plating,
/area/bigredv3/inside/science/research_office)
"fd" = (
/obj/machinery/atmospherics/pipe/simple/green/hidden{
	dir = 4
	},
/obj/effect/ai_node,
/turf/open/floor/tile/dark,
/area/bigredv3/inside/science/xenolab)
"fR" = (
/obj/effect/ai_node,
/turf/open/floor/tile/dark,
/area/bigredv3/inside/science/xenolab)
"fX" = (
/turf/closed/mineral/smooth/bigred/indestructible,
/area/bigredv3/inside/science/research_office)
"ht" = (
/obj/structure/table,
/obj/machinery/light,
/obj/effect/spawner/random/engineering/technology_scanner,
/obj/item/xenos_claw,
/turf/open/floor/tile/dark/red2/corner{
	dir = 8
	},
/area/bigredv3/inside/science/xenolab)
"hR" = (
/obj/structure/table,
/obj/item/paper,
/turf/open/floor/tile/dark/red2/corner,
/area/bigredv3/inside/science/xenolab)
"ja" = (
/turf/open/floor/tile/dark/red2/corner{
	dir = 8
	},
/area/bigredv3/inside/science/xenolab)
"jr" = (
/obj/structure/cable,
/obj/effect/ai_node,
/turf/open/floor/plating,
/area/bigredv3/inside/science/research_office)
"kg" = (
/turf/closed/wall,
/area/bigredv3/inside/wall)
"kF" = (
/obj/effect/landmark/lv624/fog_blocker/xeno_spawn,
/turf/closed/mineral/smooth/bigred,
/area/bigredv3/caves/rock)
"kJ" = (
/obj/machinery/door/airlock/mainship/research/glass/free_access{
	dir = 1;
	name = "\improper Eta Lab Cell"
	},
/turf/open/floor/tile/dark,
/area/bigredv3/inside/science/xenolab)
"lX" = (
/turf/open/floor/tile/dark/red2{
	dir = 1
	},
/area/bigredv3/inside/science/xenolab)
"ok" = (
/obj/machinery/light{
	dir = 4
	},
/turf/open/ground/jungle/clear,
/area/bigredv3/inside/science/xenolab)
"or" = (
/obj/structure/cable,
/obj/machinery/power/apc/weak/ntf{
	dir = 1
	},
/turf/open/floor/plating,
/area/bigredv3/inside/science/research_office)
"oL" = (
/obj/structure/closet/crate/secure,
/turf/open/floor/tile/dark/red2/corner,
/area/bigredv3/inside/science/xenolab)
"pY" = (
/turf/open/ground/jungle/clear,
/area/bigredv3/inside/science/xenolab)
"qc" = (
/turf/open/floor/tile/dark/red2/corner,
/area/bigredv3/inside/science/xenolab)
"rS" = (
/obj/effect/decal/cleanable/dirt,
/turf/open/floor/tile/dark/red2/corner,
/area/bigredv3/inside/science/xenolab)
"sp" = (
/turf/open/floor/plating/ground/mars/random/cave,
/area/bigredv3/caves/south)
"tk" = (
/turf/open/floor/plating/ground/mars/random/sand,
/area/bigredv3/inside/science/xenolab)
"tq" = (
/obj/structure/fence/standard/xenoproof,
/turf/open/floor/plating/ground/mars/random/cave,
/area/bigredv3/caves/south)
"tu" = (
/obj/effect/ai_node,
/obj/effect/landmark/lv624/fog_blocker/xeno_spawn,
/turf/open/floor/plating/ground/mars/random/cave,
/area/bigredv3/caves/south)
"tB" = (
/obj/effect/decal/cleanable/blood/xeno,
/turf/open/floor/tile/dark/red2/corner{
	dir = 4
	},
/area/bigredv3/inside/science/xenolab)
"tM" = (
/obj/machinery/door/airlock/mainship/research/glass/free_access{
	name = "\improper Eta Lab Cell"
	},
/turf/open/floor/tile/dark,
/area/bigredv3/inside/science/xenolab)
"un" = (
/turf/open/floor/tile/dark/red2{
	dir = 4
	},
/area/bigredv3/inside/science/xenolab)
"ux" = (
/obj/machinery/light,
/turf/open/floor/tile/darkgreen/darkgreen2,
/area/bigredv3/inside/science/xenolab)
"vX" = (
/obj/structure/cable,
/turf/open/floor/plating,
/area/bigredv3/inside/science/research_office)
"vY" = (
/turf/closed/mineral/smooth/bigred/indestructible,
/area/space)
"wH" = (
/obj/effect/decal/cleanable/blood/oil,
/turf/open/floor/tile/dark,
/area/bigredv3/inside/science/xenolab)
"xw" = (
/obj/machinery/light{
	dir = 8
	},
/turf/open/floor/tile/dark/red2/corner{
	dir = 8
	},
/area/bigredv3/inside/science/xenolab)
"xB" = (
/turf/closed/wall/r_wall,
/area/bigredv3/inside/wall)
"xJ" = (
/turf/open/floor/tile/darkgreen/darkgreen2{
	dir = 6
	},
/area/bigredv3/inside/science/xenolab)
"xQ" = (
/turf/open/floor/tile/dark,
/area/bigredv3/inside/science/xenolab)
"yR" = (
/obj/machinery/atmospherics/components/unary/vent_pump{
	dir = 4;
	on = 1
	},
/turf/open/floor/tile/dark,
/area/bigredv3/inside/science/xenolab)
"zb" = (
/obj/effect/landmark/xeno_silo_spawn,
/turf/open/floor/plating/ground/mars/random/cave,
/area/bigredv3/caves/south)
"zD" = (
/turf/open/floor/tile/dark/red2{
	dir = 6
	},
/area/bigredv3/inside/science/xenolab)
"zQ" = (
/obj/structure/closet/l3closet/scientist,
/turf/open/floor/tile/darkgreen/darkgreen2{
	dir = 1
	},
/area/bigredv3/inside/science/xenolab)
"Am" = (
/turf/open/floor/tile/dark/red2{
	dir = 8
	},
/area/bigredv3/inside/science/xenolab)
"Ay" = (
/obj/structure/closet/toolcloset,
/turf/open/floor/plating,
/area/bigredv3/inside/science/research_office)
"Bc" = (
/turf/open/floor/tile/dark/red2,
/area/bigredv3/inside/science/xenolab)
"By" = (
/obj/structure/closet/firecloset,
/turf/open/floor/plating,
/area/bigredv3/inside/science/research_office)
"BK" = (
/obj/machinery/computer/security,
/turf/open/floor/tile/dark/red2/corner{
	dir = 4
	},
/area/bigredv3/inside/science/xenolab)
"DG" = (
/obj/machinery/light{
	dir = 1
	},
/turf/open/floor/tile/dark/red2{
	dir = 9
	},
/area/bigredv3/inside/science/xenolab)
"DM" = (
/turf/open/floor/plating/ground/mars/random/cave/rock,
/area/bigredv3/caves/south)
"EH" = (
/obj/machinery/light{
	dir = 8
	},
/turf/open/floor/plating/ground/mars/random/sand,
/area/bigredv3/inside/science/xenolab)
"Fi" = (
/obj/structure/table,
/obj/effect/spawner/random/engineering/technology_scanner,
/turf/open/floor/tile/dark/red2/corner{
	dir = 4
	},
/area/bigredv3/inside/science/xenolab)
"Gc" = (
/turf/open/floor/tile/darkgreen/darkgreen2{
	dir = 4
	},
/area/bigredv3/inside/science/xenolab)
"Gi" = (
/obj/structure/bed/chair{
	dir = 8
	},
/turf/open/floor/tile/dark/red2{
	dir = 8
	},
/area/bigredv3/inside/science/xenolab)
"Gt" = (
/obj/effect/landmark/lv624/fog_blocker,
/turf/closed/wall/r_wall,
/turf/open/floor/plating/ground/mars/random/cave,
/area/bigredv3/inside/wall)
"GY" = (
/obj/effect/landmark/lv624/fog_blocker,
/turf/closed/wall/r_wall,
/turf/open/floor/plating/ground/mars/cavetodirt{
	dir = 1
	},
/area/bigredv3/inside/wall)
"He" = (
/obj/structure/closet/l3closet/scientist,
/turf/open/floor/tile/darkgreen/darkgreen2{
	dir = 5
	},
/area/bigredv3/inside/science/xenolab)
"IP" = (
/obj/effect/decal/cleanable/blood/gibs,
/turf/open/floor/plating/ground/mars/random/cave,
/area/bigredv3/caves/south)
"IU" = (
/turf/open/floor/plating,
/area/bigredv3/inside/science/research_office)
"IZ" = (
/obj/effect/landmark/lv624/fog_blocker,
/turf/closed/mineral/smooth/bigred,
/area/bigredv3/caves/rock)
"JF" = (
/obj/structure/window/framed/colony,
/turf/open/floor/plating,
/area/bigredv3/inside/wall)
"JW" = (
/obj/effect/decal/cleanable/dirt,
/turf/open/floor/tile/dark,
/area/bigredv3/inside/science/xenolab)
"KC" = (
/obj/effect/landmark/lv624/fog_blocker/xeno_spawn,
/turf/open/floor/plating/ground/mars/random/cave,
/area/bigredv3/caves/south)
"KG" = (
/obj/structure/bed/chair{
	dir = 4
	},
/turf/open/floor/tile/dark/red2{
	dir = 4
	},
/area/bigredv3/inside/science/xenolab)
"KR" = (
/obj/effect/spawner/random/engineering/structure/tank/fuelweighted,
/turf/open/floor/plating,
/area/bigredv3/inside/science/research_office)
"Mz" = (
/obj/machinery/light{
	dir = 4
	},
/obj/effect/decal/cleanable/dirt,
/obj/effect/ai_node,
/turf/open/floor/tile/dark/red2/corner,
/area/bigredv3/inside/science/xenolab)
"MG" = (
/obj/structure/cable,
/obj/machinery/door/airlock/mainship/maint/free_access{
	name = "\improper Eta Lab Maintenance Storage"
	},
/turf/open/floor/tile/dark,
/area/bigredv3/inside/science/research_office)
"NX" = (
/turf/open/floor/tile/darkgreen/darkgreen2{
	dir = 8
	},
/area/bigredv3/inside/science/xenolab)
"Ok" = (
/obj/effect/decal/cleanable/blood,
/turf/open/floor/tile/dark,
/area/bigredv3/inside/science/xenolab)
"Op" = (
/obj/structure/window/framed/colony/reinforced/unbreakable,
/turf/open/floor/plating,
/area/bigredv3/inside/wall)
"Or" = (
/obj/structure/table,
/obj/structure/xenoautopsy,
/turf/open/floor/tile/dark/red2/corner{
	dir = 4
	},
/area/bigredv3/inside/science/xenolab)
"Pg" = (
/obj/effect/ai_node,
/turf/open/floor/plating/ground/mars/random/cave/rock,
/area/bigredv3/caves/south)
"PG" = (
/obj/structure/xenoautopsy/tank,
/turf/open/floor/tile/dark/red2/corner{
	dir = 8
	},
/area/bigredv3/inside/science/xenolab)
"PY" = (
/obj/structure/xenoautopsy/tank/hugger,
/turf/open/floor/tile/dark/red2/corner{
	dir = 8
	},
/area/bigredv3/inside/science/xenolab)
"QX" = (
/turf/open/floor/tile/darkgreen/darkgreen2{
	dir = 10
	},
/area/bigredv3/inside/science/xenolab)
"Rr" = (
/turf/closed/mineral/smooth/bigred,
/area/bigredv3/caves/rock)
"RJ" = (
/obj/effect/ai_node,
/turf/open/floor/plating/ground/mars/random/cave,
/area/bigredv3/caves/south)
"SV" = (
/obj/machinery/atmospherics/pipe/simple/green/hidden{
	dir = 4
	},
/obj/machinery/door/airlock/mainship/research/glass/free_access{
	name = "\improper Eta Lab Xenobiology Lab"
	},
/turf/open/floor/tile/dark,
/area/bigredv3/inside/science/xenolab)
"Tc" = (
/obj/structure/fence/standard/xenoproof,
/turf/open/floor/plating/ground/mars/random/cave/rock,
/area/bigredv3/caves/south)
"Tp" = (
/obj/machinery/atmospherics/pipe/simple/green/hidden{
	dir = 4
	},
/turf/open/floor/tile/dark,
/area/bigredv3/inside/science/xenolab)
"TH" = (
/obj/item/target,
/turf/open/floor/tile/dark/red2{
	dir = 1
	},
/area/bigredv3/inside/science/xenolab)
"Uk" = (
/turf/open/floor/tile/dark/red2{
	dir = 10
	},
/area/bigredv3/inside/science/xenolab)
"UT" = (
/obj/structure/table,
/obj/item/alienjar,
/turf/open/floor/tile/dark/red2/corner{
	dir = 4
	},
/area/bigredv3/inside/science/xenolab)
"Vk" = (
/obj/machinery/atmospherics/pipe/manifold/green/hidden{
	dir = 1
	},
/obj/effect/ai_node,
/turf/open/floor/tile/dark,
/area/bigredv3/inside/science/xenolab)
"Ww" = (
/obj/structure/table,
/obj/item/tool/pen,
/turf/open/floor/tile/dark/red2/corner{
	dir = 4
	},
/area/bigredv3/inside/science/xenolab)
"WD" = (
/obj/machinery/atmospherics/components/unary/vent_pump{
	dir = 1;
	on = 1
	},
/turf/open/floor/tile/dark,
/area/bigredv3/inside/science/xenolab)
"Xq" = (
/obj/effect/landmark/lv624/fog_blocker,
/turf/closed/wall/r_wall,
/area/bigredv3/inside/wall)
"YW" = (
/obj/machinery/light{
	dir = 1
	},
/turf/open/floor/tile/dark/red2{
	dir = 5
	},
/area/bigredv3/inside/science/xenolab)
"ZO" = (
/obj/structure/window/framed/colony/reinforced,
/turf/open/floor/plating,
/area/bigredv3/inside/wall)

(1,1,1) = {"
vY
vY
vY
vY
vY
vY
vY
vY
vY
vY
vY
vY
vY
vY
vY
vY
vY
vY
vY
vY
vY
vY
vY
vY
vY
vY
vY
vY
vY
vY
vY
vY
vY
vY
vY
vY
vY
vY
"}
(2,1,1) = {"
vY
vY
vY
vY
vY
vY
vY
vY
vY
vY
vY
vY
vY
vY
vY
vY
vY
vY
vY
vY
vY
vY
vY
vY
vY
vY
vY
vY
vY
vY
vY
vY
vY
vY
vY
vY
vY
vY
"}
(3,1,1) = {"
vY
vY
vY
vY
vY
vY
vY
vY
vY
vY
vY
vY
vY
vY
vY
vY
vY
vY
vY
vY
vY
vY
vY
vY
vY
vY
vY
vY
vY
vY
vY
vY
vY
vY
vY
vY
vY
vY
"}
(4,1,1) = {"
vY
vY
vY
vY
vY
vY
vY
vY
vY
vY
vY
vY
vY
vY
vY
vY
vY
vY
vY
vY
vY
vY
vY
vY
vY
vY
vY
vY
vY
vY
vY
vY
vY
vY
vY
vY
vY
vY
"}
(5,1,1) = {"
vY
vY
vY
vY
vY
vY
vY
vY
vY
vY
vY
vY
vY
vY
vY
vY
vY
vY
vY
vY
vY
vY
vY
vY
vY
vY
vY
vY
vY
vY
vY
vY
vY
vY
vY
vY
vY
vY
"}
(6,1,1) = {"
vY
vY
vY
vY
vY
vY
vY
vY
vY
vY
vY
vY
vY
vY
vY
vY
vY
vY
vY
vY
vY
vY
vY
vY
vY
vY
vY
vY
vY
vY
vY
vY
vY
vY
vY
vY
vY
vY
"}
(7,1,1) = {"
vY
vY
vY
vY
vY
vY
vY
vY
vY
vY
vY
vY
vY
vY
vY
vY
vY
vY
vY
vY
vY
vY
vY
vY
vY
vY
vY
vY
vY
vY
vY
vY
vY
vY
vY
vY
vY
vY
"}
(8,1,1) = {"
vY
vY
vY
vY
vY
vY
vY
vY
vY
vY
vY
vY
vY
vY
vY
vY
vY
vY
vY
vY
vY
vY
vY
vY
vY
vY
vY
vY
vY
vY
vY
vY
vY
vY
vY
vY
vY
vY
"}
(9,1,1) = {"
vY
vY
vY
vY
vY
vY
vY
vY
vY
vY
vY
vY
vY
vY
vY
vY
vY
vY
vY
vY
vY
vY
vY
vY
vY
vY
vY
vY
vY
vY
vY
vY
vY
vY
vY
vY
vY
vY
"}
(10,1,1) = {"
vY
vY
vY
vY
vY
vY
vY
vY
vY
vY
vY
vY
vY
vY
vY
vY
vY
vY
vY
vY
vY
vY
vY
vY
vY
vY
vY
vY
vY
vY
vY
vY
vY
vY
vY
vY
vY
vY
"}
(11,1,1) = {"
vY
vY
vY
vY
vY
vY
vY
fX
vY
vY
vY
vY
vY
vY
vY
vY
vY
vY
vY
vY
vY
vY
vY
vY
vY
vY
vY
vY
vY
vY
vY
vY
vY
vY
vY
vY
vY
vY
"}
(12,1,1) = {"
vY
vY
vY
vY
vY
vY
vY
vY
vY
vY
vY
vY
vY
vY
vY
vY
vY
vY
vY
vY
vY
vY
vY
vY
vY
vY
vY
vY
vY
vY
vY
vY
vY
vY
vY
vY
vY
vY
"}
(13,1,1) = {"
vY
vY
vY
vY
vY
vY
vY
cQ
vY
vY
vY
vY
vY
vY
vY
vY
vY
vY
vY
vY
vY
vY
vY
vY
vY
vY
vY
vY
vY
vY
vY
vY
vY
vY
vY
vY
vY
vY
"}
(14,1,1) = {"
vY
vY
vY
vY
vY
vY
vY
vY
vY
vY
vY
vY
vY
vY
vY
vY
vY
vY
vY
vY
vY
vY
vY
vY
vY
vY
vY
vY
vY
vY
vY
vY
vY
vY
vY
vY
vY
vY
"}
(15,1,1) = {"
vY
vY
vY
vY
vY
vY
vY
vY
vY
vY
vY
vY
vY
vY
vY
vY
vY
vY
vY
vY
vY
vY
vY
vY
vY
vY
vY
vY
vY
vY
vY
vY
vY
vY
vY
vY
vY
vY
"}
(16,1,1) = {"
vY
vY
vY
vY
vY
vY
vY
vY
vY
vY
vY
vY
vY
vY
vY
vY
vY
vY
vY
vY
vY
vY
vY
vY
vY
vY
vY
vY
vY
vY
vY
vY
vY
vY
vY
vY
vY
vY
"}
(17,1,1) = {"
vY
vY
vY
vY
vY
vY
vY
vY
vY
vY
vY
vY
vY
vY
vY
vY
vY
vY
vY
vY
vY
vY
vY
vY
vY
vY
vY
vY
vY
vY
vY
vY
vY
vY
vY
vY
vY
vY
"}
(18,1,1) = {"
vY
vY
vY
vY
vY
vY
vY
vY
vY
vY
vY
vY
vY
vY
vY
vY
vY
vY
vY
vY
vY
vY
vY
vY
vY
vY
vY
vY
vY
vY
vY
vY
vY
vY
vY
vY
vY
vY
"}
(19,1,1) = {"
vY
vY
vY
vY
vY
vY
vY
vY
vY
vY
vY
vY
vY
vY
vY
vY
vY
vY
vY
vY
vY
vY
vY
vY
vY
vY
vY
vY
vY
vY
vY
vY
vY
vY
vY
vY
vY
vY
"}
(20,1,1) = {"
vY
vY
vY
vY
vY
vY
vY
vY
vY
vY
vY
vY
vY
vY
vY
vY
vY
vY
vY
vY
vY
vY
vY
vY
vY
vY
vY
vY
vY
vY
vY
vY
vY
vY
vY
vY
vY
vY
"}
(21,1,1) = {"
vY
vY
vY
vY
vY
vY
vY
vY
vY
vY
vY
vY
vY
vY
vY
vY
vY
vY
vY
vY
vY
vY
vY
vY
vY
vY
vY
vY
vY
vY
vY
vY
vY
vY
vY
vY
vY
vY
"}
(22,1,1) = {"
vY
vY
vY
vY
vY
vY
vY
vY
vY
vY
vY
vY
vY
vY
vY
vY
vY
vY
vY
vY
vY
vY
vY
vY
vY
vY
vY
vY
vY
vY
vY
vY
vY
vY
vY
vY
vY
vY
"}
(23,1,1) = {"
vY
vY
vY
vY
vY
vY
vY
vY
vY
vY
vY
vY
vY
vY
vY
vY
vY
vY
vY
vY
vY
vY
vY
vY
vY
vY
vY
vY
vY
vY
vY
vY
vY
vY
vY
vY
vY
vY
"}
(24,1,1) = {"
vY
vY
vY
vY
vY
vY
vY
vY
vY
vY
vY
vY
vY
vY
vY
vY
vY
vY
vY
vY
vY
vY
vY
vY
vY
vY
vY
vY
vY
vY
vY
vY
vY
vY
vY
vY
vY
vY
"}
(25,1,1) = {"
vY
vY
vY
vY
vY
vY
vY
vY
vY
vY
vY
vY
vY
vY
vY
vY
vY
vY
vY
vY
vY
vY
vY
vY
vY
vY
vY
vY
vY
vY
vY
vY
vY
vY
vY
vY
vY
vY
"}
(26,1,1) = {"
Rr
Rr
Rr
Rr
Rr
Rr
Rr
Rr
Rr
Rr
Rr
Rr
Rr
Rr
Rr
Rr
Rr
Rr
Rr
Rr
Rr
Rr
Rr
Rr
Rr
Rr
Rr
Rr
Rr
Rr
Rr
Rr
Rr
Rr
Rr
Rr
Rr
vY
"}
(27,1,1) = {"
Rr
Rr
Rr
Rr
Rr
Rr
Rr
Rr
Rr
Rr
Rr
Rr
Rr
Rr
Rr
Rr
Rr
Rr
Rr
Rr
Rr
Rr
Rr
Rr
Rr
Rr
Rr
Rr
Rr
Rr
Rr
Rr
Rr
Rr
Rr
Rr
Rr
vY
"}
(28,1,1) = {"
Rr
Rr
Rr
Rr
Rr
Rr
Rr
Rr
Rr
Rr
Rr
Rr
Rr
Rr
Rr
Rr
Rr
Rr
Rr
Rr
Rr
Rr
Rr
Rr
Rr
Rr
Rr
Rr
Rr
Rr
Rr
Rr
Rr
Rr
Rr
Rr
Rr
vY
"}
(29,1,1) = {"
Rr
Rr
Rr
Rr
Rr
Rr
Rr
Rr
Rr
Rr
Rr
Rr
Rr
Rr
Rr
Rr
Rr
Rr
Rr
Rr
Rr
Rr
kF
kF
kF
kF
kF
kF
kF
kF
kF
kF
kF
kF
kF
kF
Rr
vY
"}
(30,1,1) = {"
Rr
Rr
Rr
Rr
Rr
Rr
Rr
Rr
Rr
Rr
Rr
Rr
Rr
Rr
Rr
Rr
Rr
Rr
Rr
Rr
Rr
Rr
kF
Rr
Rr
Rr
Rr
Rr
Rr
Rr
Rr
Rr
Rr
Rr
Rr
kF
Rr
vY
"}
(31,1,1) = {"
Rr
Rr
Rr
Rr
Rr
Rr
Rr
Rr
Rr
Rr
Rr
Rr
Rr
Rr
Rr
Rr
Rr
Rr
Rr
Rr
Rr
Rr
kF
Rr
Rr
Rr
sp
sp
RJ
sp
sp
Rr
Rr
Rr
Rr
kF
Rr
vY
"}
(32,1,1) = {"
Rr
Rr
Rr
Rr
Rr
Rr
Rr
Rr
Rr
Rr
Rr
Rr
Rr
Rr
Rr
Rr
Rr
Rr
Rr
Rr
Rr
Rr
kF
Rr
RJ
sp
sp
sp
sp
sp
sp
sp
Rr
Rr
Rr
kF
Rr
vY
"}
(33,1,1) = {"
Rr
Rr
Rr
Rr
Rr
Rr
Rr
Rr
Rr
Rr
Rr
DM
sp
Rr
Rr
Rr
Rr
Rr
Rr
Rr
Rr
Rr
kF
Rr
sp
sp
sp
sp
sp
zb
sp
Rr
Rr
Rr
Rr
kF
Rr
vY
"}
(34,1,1) = {"
Rr
Rr
Rr
Rr
Rr
Rr
Rr
DM
sp
sp
sp
sp
sp
sp
RJ
sp
Rr
Rr
Rr
Rr
Rr
Rr
KC
sp
sp
sp
sp
sp
sp
sp
sp
sp
Rr
Rr
Rr
kF
Rr
vY
"}
(35,1,1) = {"
Rr
Rr
Rr
Rr
Rr
Rr
sp
sp
sp
sp
sp
sp
sp
sp
sp
sp
sp
Rr
Rr
Rr
Rr
Rr
KC
sp
sp
sp
sp
sp
sp
sp
sp
sp
sp
Rr
Rr
kF
Rr
vY
"}
(36,1,1) = {"
Rr
Rr
Rr
Rr
sp
sp
sp
sp
sp
RJ
sp
sp
sp
sp
RJ
sp
sp
sp
sp
sp
RJ
sp
KC
sp
RJ
sp
sp
sp
RJ
sp
sp
sp
sp
Rr
Rr
kF
Rr
vY
"}
(37,1,1) = {"
Rr
Rr
sp
RJ
sp
sp
sp
sp
RJ
sp
sp
sp
sp
sp
sp
sp
sp
sp
sp
sp
sp
sp
KC
sp
sp
sp
sp
sp
sp
sp
sp
sp
sp
Rr
Rr
kF
Rr
vY
"}
(38,1,1) = {"
Rr
sp
sp
sp
sp
sp
sp
sp
sp
sp
sp
sp
sp
sp
sp
sp
sp
sp
sp
sp
sp
sp
KC
sp
sp
sp
sp
sp
sp
sp
sp
sp
sp
Rr
Rr
kF
Rr
vY
"}
(39,1,1) = {"
sp
sp
sp
sp
sp
sp
sp
sp
sp
sp
sp
sp
sp
sp
sp
sp
sp
sp
sp
sp
sp
sp
KC
sp
sp
sp
sp
sp
RJ
sp
sp
sp
RJ
sp
Rr
kF
Rr
vY
"}
(40,1,1) = {"
sp
DM
sp
sp
DM
DM
sp
sp
sp
sp
sp
DM
sp
sp
sp
sp
sp
sp
sp
sp
sp
sp
KC
sp
sp
sp
sp
sp
sp
sp
sp
sp
sp
sp
Rr
kF
Rr
vY
"}
(41,1,1) = {"
sp
sp
sp
RJ
sp
sp
sp
sp
sp
RJ
sp
sp
DM
DM
DM
DM
DM
DM
sp
DM
Pg
DM
KC
KC
KC
tu
KC
KC
KC
KC
KC
KC
KC
KC
kF
kF
Rr
vY
"}
(42,1,1) = {"
sp
sp
sp
sp
sp
sp
sp
sp
sp
sp
sp
sp
sp
sp
sp
sp
sp
sp
sp
sp
sp
sp
DM
sp
sp
sp
sp
sp
sp
sp
sp
sp
sp
sp
Rr
Rr
Rr
vY
"}
(43,1,1) = {"
sp
Rr
Rr
Rr
Rr
Rr
Rr
DM
sp
sp
sp
sp
sp
sp
sp
sp
sp
sp
sp
sp
sp
sp
sp
sp
sp
sp
sp
sp
sp
sp
sp
sp
sp
sp
Rr
Rr
Rr
vY
"}
(44,1,1) = {"
Rr
Rr
Rr
Rr
Rr
Rr
Rr
Rr
Rr
Rr
Rr
Rr
Rr
Rr
Rr
Rr
Rr
sp
Rr
Rr
DM
DM
Rr
DM
sp
sp
sp
sp
sp
sp
sp
sp
sp
sp
Rr
Rr
Rr
vY
"}
(45,1,1) = {"
Rr
Rr
Rr
Rr
Rr
Rr
Rr
Rr
Rr
Rr
Rr
Rr
Rr
Rr
Rr
Rr
Rr
Rr
Rr
Rr
Rr
Rr
Rr
Rr
sp
sp
sp
sp
sp
sp
sp
sp
sp
sp
Rr
Rr
Rr
vY
"}
(46,1,1) = {"
IZ
IZ
IZ
IZ
IZ
IZ
IZ
IZ
IZ
IZ
IZ
IZ
IZ
IZ
IZ
IZ
IZ
IZ
IZ
IZ
IZ
IZ
Rr
Rr
DM
sp
sp
sp
sp
sp
sp
sp
sp
Rr
Rr
Rr
Rr
vY
"}
(47,1,1) = {"
xB
xB
xB
xB
xB
xB
xB
xB
xB
xB
xB
xB
xB
xB
xB
xB
xB
xB
xB
xB
xB
xB
Xq
Rr
sp
sp
sp
sp
sp
sp
sp
sp
sp
Rr
Rr
Rr
Rr
vY
"}
(48,1,1) = {"
DG
Am
Am
Uk
xB
PY
PG
PG
PY
PY
xB
tk
EH
tk
xB
tk
EH
tk
xB
tk
EH
tk
Xq
Rr
tq
RJ
sp
sp
RJ
sp
sp
sp
RJ
Rr
Rr
Rr
Rr
vY
"}
(49,1,1) = {"
lX
fR
xQ
xQ
kJ
xQ
xQ
fR
xQ
ja
xB
tk
tk
tk
xB
tk
tk
tk
xB
tk
tk
tk
GY
DM
Tc
sp
sp
sp
sp
sp
sp
sp
sp
sp
Rr
Rr
Rr
vY
"}
(50,1,1) = {"
lX
xQ
xQ
Bc
xB
tB
JW
JW
xQ
aL
xB
tk
tk
tk
xB
tk
tk
tk
xB
tk
tk
tk
Xq
sp
tq
sp
sp
sp
sp
sp
sp
sp
sp
sp
Rr
Rr
Rr
vY
"}
(51,1,1) = {"
TH
xQ
xQ
Bc
ZO
BK
JW
JW
xQ
ht
xB
Op
tM
Op
xB
Op
tM
Op
xB
Op
tM
Op
Xq
sp
tq
sp
sp
DM
sp
sp
sp
sp
sp
sp
Rr
Rr
Rr
vY
"}
(52,1,1) = {"
lX
xQ
xQ
Bc
ZO
Fi
JW
JW
xQ
ja
kg
Gi
xQ
Gi
kg
Gi
xQ
Gi
kg
Gi
xQ
Gi
Xq
sp
tq
sp
sp
DM
sp
sp
sp
sp
sp
sp
sp
Rr
Rr
vY
"}
(53,1,1) = {"
TH
xQ
xQ
Bc
ZO
UT
xQ
JW
JW
xQ
ja
ja
xQ
ja
xw
ja
xQ
ja
ja
ja
JW
ja
Xq
sp
tq
sp
sp
DM
sp
sp
sp
sp
sp
sp
sp
Rr
Rr
vY
"}
(54,1,1) = {"
lX
fR
xQ
Bc
ZO
Or
xQ
yR
JW
JW
Ok
JW
JW
JW
xQ
JW
JW
JW
xQ
JW
xQ
xQ
Xq
sp
tq
sp
sp
DM
sp
sp
sp
sp
sp
sp
sp
Rr
Rr
vY
"}
(55,1,1) = {"
lX
xQ
xQ
Bc
ZO
Ww
wH
fd
JW
JW
Mz
rS
JW
rS
rS
rS
JW
rS
Mz
qc
xQ
qc
Gt
sp
tq
RJ
sp
sp
sp
RJ
sp
sp
RJ
sp
sp
Rr
Rr
vY
"}
(56,1,1) = {"
YW
un
un
zD
ZO
hR
qc
Tp
qc
oL
kg
KG
xQ
KG
kg
KG
xQ
KG
kg
KG
xQ
KG
Xq
Rr
Tc
sp
sp
sp
sp
sp
sp
sp
sp
sp
sp
Rr
Rr
vY
"}
(57,1,1) = {"
xB
xB
xB
xB
xB
kg
JF
SV
JF
kg
xB
Op
tM
Op
xB
Op
tM
Op
xB
Op
tM
Op
Xq
Rr
Rr
Rr
Rr
sp
sp
sp
sp
sp
sp
sp
sp
Rr
Rr
vY
"}
(58,1,1) = {"
KR
vX
vX
or
kg
cG
NX
Tp
NX
QX
xB
pY
pY
pY
xB
pY
pY
pY
xB
pY
pY
pY
Xq
Rr
Rr
Rr
Rr
sp
Rr
Rr
sp
sp
sp
sp
sp
Rr
Rr
vY
"}
(59,1,1) = {"
eI
jr
IU
By
kg
zQ
xQ
Vk
WD
ux
xB
pY
pY
pY
xB
pY
pY
pY
xB
pY
pY
pY
Xq
Rr
Rr
Rr
Rr
Rr
Rr
Rr
Rr
sp
sp
sp
sp
Rr
Rr
vY
"}
(60,1,1) = {"
KR
vX
IU
Ay
kg
He
Gc
Tp
Gc
xJ
xB
pY
ok
pY
xB
pY
ok
pY
xB
pY
ok
pY
Xq
IZ
IZ
IZ
IZ
IZ
IZ
IZ
Rr
sp
RJ
IP
sp
Rr
Rr
vY
"}
(61,1,1) = {"
kg
MG
kg
kg
kg
kg
JF
SV
JF
kg
xB
xB
xB
xB
xB
xB
xB
xB
xB
xB
xB
xB
xB
xB
xB
xB
xB
xB
xB
IZ
Rr
sp
sp
sp
sp
Rr
Rr
vY
"}
