//MAP CONVERTED BY dmm2tgm.py THIS HEADER COMMENT PREVENTS RECONVERSION, DO NOT REMOVE
"aa" = (
/obj/machinery/vending/snack,
/turf/open/floor,
/area/bigredv3/inside/engi/west)
"ax" = (
/obj/machinery/door_control{
	dir = 1;
	id = "Engineering";
	name = "Storm Shutters"
	},
/turf/open/floor,
/area/bigredv3/inside/engi/west)
"bb" = (
/obj/structure/rack,
/obj/item/camera_film,
/turf/open/floor,
/area/bigredv3/inside/engi/west)
"bq" = (
/obj/machinery/light{
	dir = 4
	},
/obj/effect/decal/cleanable/dirt,
/turf/open/floor,
/area/bigredv3/inside/engi/west)
"bN" = (
/obj/structure/table,
/obj/item/tool/lighter/random,
/turf/open/floor,
/area/bigredv3/inside/engi/fabrication)
"cD" = (
/obj/effect/decal/cleanable/dirt,
/obj/machinery/air_alarm{
	dir = 1
	},
/turf/open/floor,
/area/bigredv3/inside/engi/west)
"cL" = (
/turf/open/floor/marking/asteroidwarning{
	dir = 4
	},
/area/bigredv3/outside/directions/central)
"cP" = (
/obj/structure/table,
/obj/effect/spawner/random/engineering/tool,
/obj/effect/spawner/random/engineering/technology_scanner,
/turf/open/floor,
/area/bigredv3/inside/engi/west)
"dw" = (
/obj/machinery/atmospherics/pipe/simple/green/hidden{
	dir = 5
	},
/obj/effect/ai_node,
/obj/structure/cable,
/turf/open/floor,
/area/bigredv3/inside/engi/west)
"dF" = (
/turf/open/floor,
/area/bigredv3/inside/engi/west)
"dY" = (
/turf/open/floor/plating/ground/mars/cavetodirt{
	dir = 10
	},
/area/bigredv3/caves/southwest)
"eh" = (
/obj/structure/bed/chair{
	dir = 8
	},
/turf/open/floor,
/area/bigredv3/inside/engi/west)
"en" = (
/obj/effect/decal/cleanable/dirt,
/obj/machinery/atmospherics/pipe/simple/green/hidden{
	dir = 4
	},
/obj/structure/cable,
/turf/open/floor,
/area/bigredv3/inside/engi/west)
"eu" = (
/obj/machinery/atmospherics/pipe/simple/green/hidden,
/obj/machinery/door/airlock/mainship/engineering/free_access{
	dir = 1;
	name = "\improper Chief Engineer's Office"
	},
/obj/structure/cable,
/turf/open/floor,
/area/bigredv3/inside/engi/ceo)
"fr" = (
/obj/structure/bed/chair{
	dir = 4
	},
/turf/open/floor,
/area/bigredv3/inside/engi/west)
"fJ" = (
/obj/machinery/floodlight/outpost/bigred,
/turf/open/floor/plating/ground/mars/random/sand,
/area/bigredv3/caves/southwest)
"ge" = (
/obj/effect/decal/cleanable/dirt,
/obj/structure/sign/safety/electronics{
	dir = 1
	},
/turf/open/floor,
/area/bigredv3/inside/engi/fabrication)
"gv" = (
/turf/open/floor/plating/ground/mars/dirttosand/autosmooth{
	dir = 5
	},
/area/bigredv3/caves/southwest)
"gF" = (
/obj/structure/closet/radiation,
/turf/open/floor,
/area/bigredv3/inside/engi/west)
"hE" = (
/obj/machinery/atmospherics/pipe/simple/green/hidden,
/obj/machinery/door/airlock/mainship/engineering/free_access{
	dir = 1;
	name = "\improper Engineering Tool Storage"
	},
/obj/structure/cable,
/turf/open/floor,
/area/bigredv3/inside/engi/fabrication)
"hL" = (
/obj/machinery/atmospherics/pipe/simple/green/hidden{
	dir = 10
	},
/obj/structure/cable,
/turf/open/floor,
/area/bigredv3/inside/engi/west)
"hV" = (
/obj/machinery/computer/atmos_alert,
/obj/structure/table,
/turf/open/floor,
/area/bigredv3/inside/engi)
"iu" = (
/obj/effect/decal/cleanable/dirt,
/obj/structure/cable,
/turf/open/floor,
/area/bigredv3/inside/engi/fabrication)
"iz" = (
/obj/effect/ai_node,
/turf/open/floor/plating/ground/mars/dirttosand/autosmooth{
	dir = 5
	},
/area/bigredv3/caves/southwest)
"jf" = (
/obj/machinery/door/airlock/mainship/engineering/free_access{
	name = "\improper Engine Reactor Control"
	},
/turf/open/floor,
/area/bigredv3/inside/engi)
"jo" = (
/obj/effect/decal/cleanable/dirt,
/obj/effect/spawner/random/machinery/machine_frame,
/turf/open/floor,
/area/bigredv3/inside/engi/west)
"jG" = (
/obj/structure/table,
/obj/effect/spawner/random/engineering/tool,
/obj/effect/spawner/random/engineering/technology_scanner,
/turf/open/floor,
/area/bigredv3/inside/engi/fabrication)
"kp" = (
/obj/effect/spawner/random/machinery/machine_frame,
/turf/open/floor,
/area/bigredv3/inside/engi/west)
"kq" = (
/obj/structure/table,
/obj/machinery/light,
/obj/effect/spawner/random/engineering/tool,
/turf/open/floor,
/area/bigredv3/inside/engi/west)
"kF" = (
/turf/open/floor/plating/ground/mars/dirttosand/autosmooth{
	dir = 9
	},
/area/bigredv3/caves/southwest)
"kX" = (
/turf/open/floor,
/area/bigredv3/inside/engi/fabrication)
"lf" = (
/obj/structure/table,
/obj/effect/spawner/random/engineering/toolbox,
/obj/effect/decal/cleanable/dirt,
/turf/open/floor,
/area/bigredv3/inside/engi/west)
"lo" = (
/obj/machinery/light{
	dir = 8
	},
/turf/open/floor,
/area/bigredv3/inside/engi/fabrication)
"lA" = (
/obj/effect/ai_node,
/turf/open/floor/plating/ground/mars/random/dirt,
/area/bigredv3/outside/directions/sw)
"mr" = (
/obj/structure/table,
/obj/effect/decal/cleanable/dirt,
/obj/item/tool/pen,
/turf/open/floor,
/area/bigredv3/inside/engi/west)
"mV" = (
/turf/closed/wall/r_wall,
/area/bigredv3/inside/wall)
"nC" = (
/obj/structure/table,
/obj/effect/decal/cleanable/dirt,
/obj/item/clothing/glasses/welding,
/turf/open/floor,
/area/bigredv3/inside/engi/west)
"nW" = (
/obj/structure/table,
/obj/effect/spawner/random/engineering/toolbox,
/turf/open/floor,
/area/bigredv3/inside/engi/fabrication)
"ox" = (
/obj/effect/ai_node,
/turf/open/floor/plating/ground/mars/random/sand,
/area/bigredv3/caves/southwest)
"oC" = (
/obj/effect/decal/cleanable/dirt,
/obj/machinery/atmospherics/components/unary/vent_pump{
	dir = 1;
	on = 1
	},
/turf/open/floor,
/area/bigredv3/inside/engi/west)
"oH" = (
/obj/effect/decal/cleanable/dirt,
/turf/open/floor,
/area/bigredv3/inside/engi/west)
"oK" = (
/obj/machinery/light{
	dir = 8
	},
/obj/effect/spawner/random/misc/structure/supplycrate,
/turf/open/floor,
/area/bigredv3/inside/engi/fabrication)
"oN" = (
/obj/effect/decal/cleanable/dirt,
/obj/machinery/atmospherics/pipe/simple/green/hidden,
/turf/open/floor,
/area/bigredv3/inside/engi/west)
"pZ" = (
/obj/effect/spawner/random/engineering/structure/tank/waterweighted,
/obj/effect/decal/cleanable/dirt,
/obj/machinery/light{
	dir = 4
	},
/turf/open/floor,
/area/bigredv3/inside/engi/fabrication)
"ql" = (
/obj/effect/decal/cleanable/dirt,
/obj/effect/ai_node,
/turf/open/floor,
/area/bigredv3/inside/engi/west)
"qm" = (
/turf/open/floor/plating/ground/mars/random/cave/rock,
/area/bigredv3/caves/southwest)
"qO" = (
/obj/effect/decal/cleanable/dirt,
/obj/item/lightreplacer,
/turf/open/floor,
/area/bigredv3/inside/engi/west)
"ry" = (
/obj/machinery/atmospherics/pipe/simple/green/hidden{
	dir = 4
	},
/obj/structure/cable,
/turf/open/floor,
/area/bigredv3/inside/engi/west)
"sd" = (
/obj/effect/decal/cleanable/dirt,
/obj/item/clothing/mask/breath,
/turf/open/floor,
/area/bigredv3/inside/engi/west)
"sg" = (
/obj/machinery/atmospherics/pipe/simple/green/hidden{
	dir = 4
	},
/obj/machinery/door/airlock/multi_tile/mainship/generic{
	dir = 1;
	name = "\improper Engineering Complex"
	},
/obj/structure/cable,
/turf/open/floor,
/area/bigredv3/inside/engi/west)
"sw" = (
/turf/open/floor,
/area/bigredv3/inside/engi)
"sZ" = (
/obj/machinery/atmospherics/pipe/manifold/green/hidden,
/obj/effect/ai_node,
/obj/structure/cable,
/turf/open/floor,
/area/bigredv3/inside/engi/west)
"tt" = (
/obj/structure/table,
/obj/effect/spawner/random/misc/earmuffs,
/turf/open/floor,
/area/bigredv3/inside/engi/west)
"tv" = (
/turf/open/floor,
/area/bigredv3/inside/engi/locker_room)
"tR" = (
/obj/machinery/bot/mulebot,
/turf/open/floor,
/area/bigredv3/inside/engi/west)
"tV" = (
/turf/open/floor/plating/ground/mars/random/dirt,
/area/bigredv3/outside/directions/s)
"uD" = (
/obj/machinery/atmospherics/pipe/manifold/green/hidden{
	dir = 4
	},
/obj/structure/cable,
/turf/open/floor,
/area/bigredv3/inside/engi/locker_room)
"uO" = (
/turf/open/floor/plating/ground/mars/random/dirt,
/area/bigredv3/caves/southwest)
"vk" = (
/turf/open/floor/plating/ground/mars/dirttosand/autosmooth,
/area/bigredv3/caves/southwest)
"vR" = (
/obj/effect/decal/cleanable/dirt,
/obj/machinery/atmospherics/pipe/simple/green/hidden{
	dir = 4
	},
/obj/effect/ai_node,
/obj/structure/cable,
/turf/open/floor,
/area/bigredv3/inside/engi/west)
"we" = (
/obj/machinery/floodlight/outpost/bigred,
/turf/open/floor/plating/ground/mars/random/dirt,
/area/bigredv3/outside/directions/sw)
"wm" = (
/turf/open/floor/plating/ground/mars/random/sand,
/area/bigredv3/outside/directions/s)
"wo" = (
/obj/effect/decal/cleanable/dirt,
/obj/machinery/atmospherics/components/unary/vent_pump{
	dir = 1;
	on = 1
	},
/turf/open/floor,
/area/bigredv3/inside/engi)
"wr" = (
/obj/machinery/atmospherics/pipe/simple/green/hidden,
/obj/effect/ai_node,
/obj/structure/cable,
/turf/open/floor,
/area/bigredv3/inside/engi/west)
"wt" = (
/obj/structure/window/framed/colony,
/turf/open/floor/plating)
"wI" = (
/obj/structure/table,
/obj/effect/spawner/random/engineering/tool,
/turf/open/floor,
/area/bigredv3/inside/engi/fabrication)
"xf" = (
/turf/open/floor/plating/ground/mars/cavetodirt{
	dir = 8
	},
/area/bigredv3/caves/southwest)
"xn" = (
/obj/structure/rack,
/obj/item/tool/analyzer,
/turf/open/floor,
/area/bigredv3/inside/engi/west)
"xI" = (
/turf/closed/wall/r_wall,
/area/bigredv3/outside/directions/s)
"yb" = (
/obj/machinery/door/airlock/mainship/engineering/free_access{
	dir = 1;
	name = "\improper Engine Reactor Control"
	},
/obj/machinery/atmospherics/pipe/simple/green/hidden,
/turf/open/floor,
/area/bigredv3/inside/engi)
"yf" = (
/turf/open/floor/plating/ground/mars/random/dirt,
/area/bigredv3/outside/directions/sw)
"yz" = (
/obj/machinery/atmospherics/pipe/simple/green/hidden,
/obj/machinery/power/apc/weak/ntf{
	dir = 8
	},
/obj/structure/cable,
/turf/open/floor,
/area/bigredv3/inside/engi/west)
"yB" = (
/obj/machinery/computer/station_alert,
/obj/structure/table,
/turf/open/floor,
/area/bigredv3/inside/engi)
"zj" = (
/obj/structure/table,
/obj/effect/spawner/random/engineering/toolbox,
/turf/open/floor,
/area/bigredv3/inside/engi/west)
"zo" = (
/turf/open/floor,
/area/bigredv3/inside/engi/ceo)
"Ak" = (
/obj/machinery/floodlight/outpost/bigred,
/turf/open/floor/plating/ground/mars/random/cave,
/area/bigredv3/caves/southwest)
"Ao" = (
/turf/closed/wall)
"At" = (
/obj/machinery/door_control{
	desc = "A remote control-switch for opening the engines blast doors.";
	dir = 8;
	id = "rad_door";
	name = "Reactor Radiation Shielding control"
	},
/turf/open/floor,
/area/bigredv3/inside/engi)
"Ax" = (
/obj/machinery/atmospherics/pipe/simple/green/hidden,
/obj/effect/decal/cleanable/dirt,
/obj/structure/cable,
/turf/open/floor,
/area/bigredv3/inside/engi/west)
"Az" = (
/obj/effect/decal/cleanable/dirt,
/obj/machinery/door/airlock/mainship/secure/free_access{
	name = "\improper Engineering Secure Storage"
	},
/obj/structure/cable,
/turf/open/floor,
/area/bigredv3/inside/engi/fabrication)
"AQ" = (
/obj/effect/decal/cleanable/dirt,
/obj/item/clothing/head/welding,
/turf/open/floor,
/area/bigredv3/inside/engi/west)
"Bi" = (
/turf/open/floor/plating/ground/mars/random/cave,
/area/bigredv3/caves/southwest)
"Bn" = (
/obj/effect/ai_node,
/turf/open/floor/plating/ground/mars/random/cave,
/area/bigredv3/caves/southwest)
"Ca" = (
/turf/open/floor/plating/ground/mars/random/sand,
/area/bigredv3/outside/directions/central)
"Ci" = (
/obj/machinery/atmospherics/pipe/simple/green/hidden,
/obj/structure/cable,
/turf/open/floor,
/area/bigredv3/inside/engi/west)
"Cj" = (
/turf/open/floor/plating/ground/mars/dirttosand/autosmooth{
	dir = 8
	},
/area/bigredv3/outside/directions/sw)
"CN" = (
/obj/structure/table,
/obj/item/tool/lighter/random,
/obj/item/lightreplacer,
/turf/open/floor,
/area/bigredv3/inside/engi/west)
"CS" = (
/turf/open/floor/plating/ground/mars/cavetodirt{
	dir = 5
	},
/area/bigredv3/caves/southwest)
"Dh" = (
/obj/machinery/atmospherics/pipe/simple/green/hidden,
/obj/structure/cable,
/turf/open/floor,
/area/bigredv3/inside/engi/fabrication)
"Dx" = (
/obj/machinery/computer/arcade,
/turf/open/floor,
/area/bigredv3/inside/engi/west)
"DQ" = (
/turf/open/floor/plating/ground/mars/cavetodirt{
	dir = 1
	},
/area/bigredv3/caves/southwest)
"Ew" = (
/obj/structure/table,
/obj/effect/spawner/random/engineering/tool,
/obj/machinery/light{
	dir = 4
	},
/turf/open/floor,
/area/bigredv3/inside/engi/fabrication)
"EH" = (
/obj/machinery/atmospherics/pipe/simple/green/hidden{
	dir = 4
	},
/obj/machinery/door/airlock/mainship/engineering/free_access{
	name = "\improper Engineering Workshop"
	},
/obj/structure/cable,
/turf/open/floor,
/area/bigredv3/inside/engi/west)
"Fi" = (
/obj/effect/ai_node,
/turf/open/floor/plating/ground/mars/cavetodirt{
	dir = 8
	},
/area/bigredv3/caves/southwest)
"Gp" = (
/obj/effect/landmark/start/job/survivor,
/obj/effect/landmark/start/latejoinsurvivor,
/turf/open/floor,
/area/bigredv3/inside/engi/west)
"GE" = (
/obj/effect/decal/cleanable/dirt,
/obj/structure/sign/safety/electronics{
	dir = 1
	},
/obj/structure/cable,
/turf/open/floor,
/area/bigredv3/inside/engi/fabrication)
"GH" = (
/turf/closed/wall/r_wall)
"HC" = (
/obj/machinery/atmospherics/pipe/simple/green/hidden,
/turf/open/floor,
/area/bigredv3/inside/engi/west)
"HS" = (
/obj/machinery/atmospherics/pipe/simple/green/hidden,
/obj/structure/cable,
/turf/open/floor,
/area/bigredv3/inside/engi/ceo)
"Ie" = (
/obj/machinery/atmospherics/pipe/simple/green/hidden{
	dir = 4
	},
/obj/effect/decal/cleanable/dirt,
/obj/structure/cable,
/turf/open/floor,
/area/bigredv3/inside/engi/west)
"Jb" = (
/turf/open/floor/plating/ground/mars/dirttosand/autosmooth{
	dir = 9
	},
/area/bigredv3/outside/directions/s)
"Jc" = (
/obj/machinery/atmospherics/components/unary/vent_pump,
/turf/open/floor,
/area/bigredv3/inside/engi/locker_room)
"Jl" = (
/turf/open/floor/plating/ground/mars/cavetodirt{
	dir = 9
	},
/area/bigredv3/caves/southwest)
"JU" = (
/obj/machinery/atmospherics/pipe/simple/green/hidden,
/turf/open/floor,
/area/bigredv3/inside/engi)
"JW" = (
/obj/structure/bed/chair/office/light{
	dir = 4
	},
/turf/open/floor,
/area/bigredv3/inside/engi/west)
"Kt" = (
/obj/machinery/door/airlock/mainship/engineering/free_access{
	dir = 1;
	name = "\improper Engineering SMES"
	},
/turf/open/floor/plating,
/area/bigredv3/inside/engi/fabrication)
"KS" = (
/obj/machinery/atmospherics/pipe/manifold/green/hidden{
	dir = 4
	},
/obj/effect/ai_node,
/obj/structure/cable,
/turf/open/floor,
/area/bigredv3/inside/engi/west)
"LF" = (
/turf/closed/mineral/smooth/bigred,
/area/bigredv3/caves/rock)
"LM" = (
/obj/effect/spawner/random/engineering/structure/tank/fuelweighted,
/turf/open/floor,
/area/bigredv3/inside/engi/fabrication)
"LR" = (
/obj/effect/ai_node,
/turf/open/floor/plating/ground/mars/random/dirt,
/area/bigredv3/outside/directions/s)
"MD" = (
/obj/machinery/atmospherics/pipe/simple/green/hidden,
/obj/machinery/door/airlock/mainship/engineering/free_access{
	dir = 1;
	name = "\improper Engineering Lockers"
	},
/obj/structure/cable,
/turf/open/floor,
/area/bigredv3/inside/engi/locker_room)
"Ns" = (
/obj/effect/ai_node,
/obj/structure/cable,
/turf/open/floor,
/area/bigredv3/inside/engi/fabrication)
"Oc" = (
/obj/effect/decal/cleanable/dirt,
/turf/open/floor,
/area/bigredv3/inside/engi/fabrication)
"Ow" = (
/obj/structure/bed/chair/office/light,
/turf/open/floor,
/area/bigredv3/inside/engi)
"OF" = (
/obj/machinery/computer/area_atmos,
/turf/open/floor,
/area/bigredv3/inside/engi/west)
"OH" = (
/turf/open/floor/plating/ground/mars/dirttosand/autosmooth{
	dir = 8
	},
/area/bigredv3/caves/southwest)
"OK" = (
/obj/machinery/vending/cigarette/colony,
/turf/open/floor,
/area/bigredv3/inside/engi/west)
"ON" = (
/obj/machinery/atmospherics/components/unary/vent_pump{
	dir = 8;
	on = 1
	},
/turf/open/floor,
/area/bigredv3/inside/engi/west)
"Pc" = (
/obj/machinery/atmospherics/pipe/manifold/green/hidden{
	dir = 8
	},
/obj/structure/cable,
/turf/open/floor,
/area/bigredv3/inside/engi/west)
"Pp" = (
/turf/open/floor/plating/ground/mars/dirttosand/autosmooth{
	dir = 4
	},
/area/bigredv3/caves/southwest)
"Pt" = (
/turf/closed/wall,
/area/bigredv3/inside/wall)
"Px" = (
/obj/effect/decal/cleanable/dirt,
/obj/machinery/door/airlock/multi_tile/mainship/generic{
	name = "\improper Engineering Complex"
	},
/turf/open/floor,
/area/bigredv3/inside/engi/west)
"Qd" = (
/obj/machinery/floodlight/outpost/bigred,
/turf/open/floor/plating/ground/mars/random/dirt,
/area/bigredv3/caves/southwest)
"Qn" = (
/obj/machinery/atmospherics/pipe/manifold/green/hidden{
	dir = 1
	},
/obj/effect/ai_node,
/obj/structure/cable,
/turf/open/floor,
/area/bigredv3/inside/engi/west)
"Qt" = (
/obj/effect/decal/cleanable/dirt,
/obj/machinery/atmospherics/pipe/simple/green/hidden{
	dir = 5
	},
/obj/structure/cable,
/turf/open/floor,
/area/bigredv3/inside/engi/west)
"Qv" = (
/obj/structure/bed/chair/office/light{
	dir = 8
	},
/turf/open/floor,
/area/bigredv3/inside/engi)
"RU" = (
/obj/machinery/atmospherics/pipe/simple/green/hidden,
/obj/effect/ai_node,
/obj/structure/cable,
/turf/open/floor,
/area/bigredv3/inside/engi/fabrication)
"Sp" = (
/turf/open/floor/plating/ground/mars/random/sand,
/area/bigredv3/outside/directions/sw)
"Sr" = (
/obj/structure/table,
/obj/effect/spawner/random/engineering/powercell,
/turf/open/floor,
/area/bigredv3/inside/engi/west)
"Sv" = (
/obj/machinery/light{
	dir = 8
	},
/turf/open/floor,
/area/bigredv3/inside/engi/west)
"Sx" = (
/obj/structure/table,
/obj/item/tool/lighter/random,
/turf/open/floor,
/area/bigredv3/inside/engi/west)
"SP" = (
/obj/structure/cable,
/turf/open/floor,
/area/bigredv3/inside/engi/fabrication)
"Tg" = (
/turf/open/floor/plating/ground/mars/random/sand,
/area/bigredv3/caves/southwest)
"TD" = (
/obj/structure/bed/chair{
	dir = 4
	},
/obj/effect/decal/cleanable/dirt,
/turf/open/floor,
/area/bigredv3/inside/engi/west)
"TL" = (
/obj/machinery/power/monitor{
	name = "Main Power Grid Monitoring"
	},
/turf/open/floor,
/area/bigredv3/inside/engi)
"UB" = (
/obj/structure/table,
/obj/machinery/light{
	dir = 8
	},
/obj/effect/spawner/random/engineering/technology_scanner,
/turf/open/floor,
/area/bigredv3/inside/engi)
"Vj" = (
/obj/structure/table,
/obj/item/tool/analyzer,
/turf/open/floor,
/area/bigredv3/inside/engi)
"Vs" = (
/obj/machinery/atmospherics/pipe/simple/green/hidden{
	dir = 9
	},
/obj/effect/ai_node,
/obj/structure/cable,
/turf/open/floor,
/area/bigredv3/inside/engi/west)
"VC" = (
/obj/effect/decal/cleanable/dirt,
/obj/item/tool/weldpack,
/turf/open/floor,
/area/bigredv3/inside/engi/west)
"VI" = (
/obj/effect/decal/cleanable/dirt,
/obj/effect/decal/cleanable/blood/oil,
/turf/open/floor,
/area/bigredv3/inside/engi/west)
"Wi" = (
/obj/effect/decal/cleanable/dirt,
/turf/open/floor,
/area/bigredv3/inside/engi)
"WD" = (
/obj/machinery/light{
	dir = 1
	},
/obj/machinery/atmospherics/pipe/simple/green/hidden{
	dir = 4
	},
/obj/structure/cable,
/turf/open/floor,
/area/bigredv3/inside/engi/west)
"Xk" = (
/obj/effect/ai_node,
/turf/open/floor/plating/ground/mars/random/dirt,
/area/bigredv3/caves/southwest)
"XH" = (
/turf/open/floor/plating/ground/mars/dirttosand/autosmooth{
	dir = 1
	},
/area/bigredv3/caves/southwest)
"XS" = (
/obj/machinery/atmospherics/pipe/manifold/green/hidden{
	dir = 8
	},
/obj/effect/ai_node,
/obj/structure/cable,
/turf/open/floor,
/area/bigredv3/inside/engi/west)
"Yq" = (
/obj/machinery/vending/cola,
/turf/open/floor,
/area/bigredv3/inside/engi/west)
"Yy" = (
/obj/structure/table,
/turf/open/floor,
/area/bigredv3/inside/engi/ceo)
"YE" = (
/obj/structure/table,
/obj/effect/spawner/random/engineering/tool,
/turf/open/floor,
/area/bigredv3/inside/engi)
"YG" = (
/turf/open/floor/plating/ground/mars/cavetodirt{
	dir = 4
	},
/area/bigredv3/caves/southwest)
"Zq" = (
/obj/structure/window/framed/colony,
/turf/open/floor/plating,
/area/bigredv3/inside/wall)
"Zt" = (
/obj/machinery/power/apc/weak/ntf{
	dir = 4
	},
/obj/structure/cable,
/turf/open/floor,
/area/bigredv3/inside/engi/fabrication)
"ZV" = (
/obj/structure/table,
/obj/effect/spawner/random/engineering/tool,
/obj/item/stack/sheet/metal{
	amount = 30
	},
/turf/open/floor,
/area/bigredv3/inside/engi/west)

(1,1,1) = {"
tv
Jc
uD
MD
Ci
XS
oN
HC
oN
oC
kp
mV
Sp
Sp
Sp
LF
LF
Bi
Bi
Bi
Bi
Bi
Bi
Bi
Bi
Bi
Bi
"}
(2,1,1) = {"
mV
mV
mV
mV
Pt
ry
oH
dF
oH
dF
jo
mV
Cj
Cj
Cj
yf
LF
YG
YG
YG
YG
YG
YG
Bi
qm
Ak
Bi
"}
(3,1,1) = {"
Pt
ge
oK
Zt
Pt
ry
dF
JW
dF
dF
kq
mV
lA
yf
yf
yf
yf
Xk
uO
uO
uO
uO
Xk
DQ
Bn
qm
Bi
"}
(4,1,1) = {"
Kt
Ns
SP
iu
Pt
ry
lf
Sr
mr
oH
ZV
mV
yf
yf
we
yf
yf
uO
uO
uO
Qd
uO
uO
DQ
Bi
Bi
Bi
"}
(5,1,1) = {"
Pt
GE
kX
kX
Pt
EH
wt
wt
wt
GH
GH
mV
LF
yf
yf
yf
yf
uO
uO
uO
uO
uO
Jl
Bi
Bi
LF
LF
"}
(6,1,1) = {"
Pt
SP
pZ
LM
Pt
ry
dF
oH
dF
gF
gF
mV
LF
LF
LF
LF
LF
Pp
Pp
Pp
uO
uO
DQ
Bi
LF
LF
LF
"}
(7,1,1) = {"
Pt
Az
Pt
Pt
Pt
vR
dF
dF
ql
dF
dF
mV
LF
LF
LF
LF
LF
Tg
Tg
Tg
XH
uO
CS
YG
LF
LF
LF
"}
(8,1,1) = {"
lo
iu
Pt
xn
bb
ry
dF
dF
dF
dF
dF
mV
LF
LF
LF
LF
LF
Tg
Tg
Tg
XH
uO
uO
uO
CS
Bi
LF
"}
(9,1,1) = {"
kX
iu
Zq
dF
dF
en
tR
dF
tR
dF
dF
mV
LF
LF
LF
LF
Tg
ox
kF
OH
uO
Xk
uO
uO
uO
CS
Bi
"}
(10,1,1) = {"
kX
iu
Zq
dF
sd
en
VC
dF
dF
dF
dF
mV
LF
LF
LF
fJ
Tg
kF
uO
Pp
Pp
LF
Fi
dY
uO
Xk
CS
"}
(11,1,1) = {"
Dh
RU
hE
XS
Ci
Vs
dF
dF
dF
dF
dF
mV
LF
LF
Tg
Tg
kF
Xk
vk
Tg
Tg
LF
LF
Ak
xf
dY
uO
"}
(12,1,1) = {"
Oc
Oc
Zq
Ie
oH
oH
oH
bq
oH
gF
gF
mV
LF
LF
Tg
Tg
XH
uO
vk
Tg
LF
LF
LF
LF
Bi
Bi
xf
"}
(13,1,1) = {"
Oc
bN
Zq
Ie
oH
Ao
Ao
Ao
jf
Ao
Ao
mV
LF
LF
Tg
Tg
XH
uO
vk
LF
LF
LF
LF
LF
qm
Bi
qm
"}
(14,1,1) = {"
kX
wI
Pt
ry
dF
Ao
UB
YE
sw
sw
yB
mV
LF
LF
LF
Tg
XH
uO
vk
LF
LF
LF
LF
LF
LF
Bi
Bi
"}
(15,1,1) = {"
kX
nW
Zq
Ie
qO
Ao
sw
Qv
Wi
Ow
YE
mV
LF
LF
LF
Tg
XH
uO
vk
LF
LF
LF
LF
LF
LF
Bn
Bi
"}
(16,1,1) = {"
Ew
jG
Zq
Qn
oN
yb
JU
JU
wo
sw
TL
mV
LF
LF
LF
Tg
XH
uO
vk
LF
LF
LF
LF
LF
LF
Bi
Bi
"}
(17,1,1) = {"
Pt
Pt
Pt
WD
cD
Ao
Wi
Wi
Wi
Ow
Vj
mV
LF
LF
LF
LF
XH
uO
vk
LF
LF
LF
LF
LF
qm
Bi
Bi
"}
(18,1,1) = {"
Yy
Zq
Sv
ry
oH
Ao
sw
At
sw
sw
hV
mV
LF
LF
LF
fJ
XH
uO
vk
Tg
LF
LF
LF
LF
Bi
qm
Bi
"}
(19,1,1) = {"
zo
Zq
dF
ry
ax
Ao
Ao
Ao
jf
Ao
Ao
mV
LF
LF
Tg
Tg
XH
uO
vk
Tg
LF
LF
LF
Ak
Bi
Bi
Bi
"}
(20,1,1) = {"
zo
Zq
dF
ry
oH
dF
dF
Sv
dF
oH
dF
mV
LF
Tg
Tg
Tg
gv
uO
uO
OH
CS
Bi
qm
Bi
Bi
Bi
Bi
"}
(21,1,1) = {"
HS
eu
Ci
sZ
TD
fr
fr
oH
dF
oH
dF
mV
LF
ox
Tg
Tg
Tg
iz
uO
uO
Xk
CS
YG
YG
YG
Bn
Bi
"}
(22,1,1) = {"
zo
Zq
dF
ry
nC
cP
CN
oH
dF
dF
dF
mV
LF
Tg
Tg
Tg
Tg
Tg
gv
Pp
uO
uO
uO
uO
uO
DQ
Bi
"}
(23,1,1) = {"
Pt
Pt
Gp
ry
zj
tt
Sx
dF
dF
dF
OF
mV
LF
Tg
Tg
Tg
LF
LF
Tg
Tg
XH
uO
uO
uO
uO
DQ
Bi
"}
(24,1,1) = {"
oH
Px
dF
ry
eh
eh
eh
oH
oH
dF
dF
mV
LF
LF
fJ
Tg
LF
LF
LF
Tg
XH
uO
uO
uO
uO
DQ
Bi
"}
(25,1,1) = {"
Ax
Ax
Ci
KS
yz
Ci
Pc
Qt
ql
dF
dF
mV
mV
LF
LF
LF
LF
LF
LF
Tg
XH
uO
uO
Jl
xf
Bi
qm
"}
(26,1,1) = {"
mV
mV
mV
mV
mV
Dx
ON
en
oH
dF
dF
mV
mV
mV
LF
LF
LF
LF
fJ
Tg
XH
uO
uO
DQ
Bi
Bi
Bi
"}
(27,1,1) = {"
cL
cL
cL
cL
mV
mV
OK
en
AQ
dF
dF
mV
mV
mV
mV
LF
LF
LF
Tg
kF
uO
uO
uO
DQ
Ak
Bi
Bi
"}
(28,1,1) = {"
Ca
Ca
Ca
Ca
Ca
mV
aa
hL
wr
Ci
Ci
Ci
Ci
dw
mV
LF
LF
wm
Tg
XH
uO
uO
uO
DQ
Bi
qm
Bi
"}
(29,1,1) = {"
Ca
Ca
Ca
Ca
Ca
mV
Yq
dF
VI
bq
oH
dF
dF
ry
mV
wm
wm
wm
Jb
tV
LR
uO
uO
DQ
Bi
Bn
Bi
"}
(30,1,1) = {"
Ca
Ca
Ca
Ca
Ca
mV
mV
mV
mV
mV
mV
mV
dF
sg
mV
wm
wm
Jb
tV
tV
tV
xI
xI
xI
xI
xI
xI
"}
