//MAP CONVERTED BY dmm2tgm.py THIS HEADER COMMENT PREVENTS RECONVERSION, DO NOT REMOVE
"ak" = (
/obj/structure/closet/crate/secure,
/turf/open/floor/tile/dark/red2/corner,
/area/bigredv3/inside/science/xenolab)
"aW" = (
/obj/effect/landmark/lv624/fog_blocker/xeno_spawn,
/turf/open/floor/plating/ground/mars/random/cave,
/area/bigredv3/caves/south)
"cQ" = (
/obj/structure/table,
/obj/effect/spawner/random/engineering/technology_scanner,
/turf/open/floor/tile/dark/red2/corner{
	dir = 8
	},
/area/bigredv3/inside/science/xenolab)
"dB" = (
/obj/structure/xenoautopsy/tank/hugger,
/turf/open/floor/tile/dark/red2/corner{
	dir = 8
	},
/area/bigredv3/inside/science/xenolab)
"dM" = (
/obj/effect/spawner/random/engineering/structure/tank/fuelweighted,
/turf/open/floor/plating,
/area/bigredv3/inside/science/research_office)
"eB" = (
/turf/closed/mineral/smooth/bigred/indestructible,
/area/bigredv3/inside/wall)
"eY" = (
/obj/structure/bed/chair{
	dir = 8
	},
/turf/open/floor/tile/dark/red2{
	dir = 8
	},
/area/bigredv3/inside/science/xenolab)
"gD" = (
/turf/open/floor/tile/darkgreen/darkgreen2{
	dir = 4
	},
/area/bigredv3/inside/science/xenolab)
"hf" = (
/turf/open/floor/tile/darkgreen/darkgreen2{
	dir = 8
	},
/area/bigredv3/inside/science/xenolab)
"hY" = (
/obj/machinery/door/airlock/mainship/research/glass/free_access{
	name = "\improper Eta Lab Cell"
	},
/turf/open/floor/tile/dark,
/area/bigredv3/inside/science/xenolab)
"iN" = (
/turf/closed/wall/r_wall,
/area/bigredv3/inside/wall)
"jy" = (
/obj/structure/cable,
/obj/machinery/door/airlock/mainship/maint/free_access{
	name = "\improper Eta Lab Maintenance Storage"
	},
/turf/open/floor/tile/dark,
/area/bigredv3/inside/science/research_office)
"kg" = (
/obj/machinery/atmospherics/pipe/simple/green/hidden{
	dir = 4
	},
/obj/machinery/door/airlock/mainship/research/glass/free_access{
	name = "\improper Eta Lab Xenobiology Lab"
	},
/turf/open/floor/tile/dark,
/area/bigredv3/inside/science/xenolab)
"kv" = (
/obj/machinery/computer/security,
/turf/open/floor/tile/dark/red2/corner{
	dir = 4
	},
/area/bigredv3/inside/science/xenolab)
"lH" = (
/obj/effect/ai_node,
/turf/open/ground/jungle/clear,
/area/bigredv3/inside/science/xenolab)
"lQ" = (
/obj/effect/decal/cleanable/dirt,
/turf/open/floor/tile/dark/red2/corner,
/area/bigredv3/inside/science/xenolab)
"nN" = (
/obj/effect/ai_node,
/turf/open/floor/plating/ground/mars/random/sand,
/area/bigredv3/inside/science/xenolab)
"og" = (
/turf/closed/mineral/smooth/bigred/indestructible,
/area/bigredv3/inside/science/research_office)
"op" = (
/obj/effect/landmark/lv624/fog_blocker,
/turf/open/floor/plating/ground/mars/random/cave,
/area/bigredv3/caves/rock)
"ow" = (
/turf/open/floor/tile/dark/red2/corner{
	dir = 4
	},
/area/bigredv3/inside/science/xenolab)
"oG" = (
/turf/open/floor/tile/dark,
/area/bigredv3/inside/science/xenolab)
"pk" = (
/obj/structure/cable,
/obj/effect/ai_node,
/turf/open/floor/plating,
/area/bigredv3/inside/science/research_office)
"py" = (
/obj/structure/window/framed/colony/reinforced/unbreakable,
/turf/open/floor/plating,
/area/bigredv3/inside/wall)
"qE" = (
/obj/machinery/light{
	dir = 1
	},
/turf/open/floor/tile/dark/red2{
	dir = 9
	},
/area/bigredv3/inside/science/xenolab)
"rV" = (
/turf/open/floor/tile/dark/red2{
	dir = 8
	},
/area/bigredv3/inside/science/xenolab)
"sd" = (
/obj/structure/window/framed/colony,
/turf/open/floor/plating,
/area/bigredv3/inside/wall)
"sx" = (
/turf/open/floor/tile/darkgreen/darkgreen2{
	dir = 10
	},
/area/bigredv3/inside/science/xenolab)
"sP" = (
/turf/open/floor/tile/dark/red2{
	dir = 1
	},
/area/bigredv3/inside/science/xenolab)
"th" = (
/turf/open/floor/tile/darkgreen/darkgreen2{
	dir = 6
	},
/area/bigredv3/inside/science/xenolab)
"tn" = (
/turf/open/ground/jungle/clear,
/area/bigredv3/inside/science/xenolab)
"tF" = (
/obj/effect/decal/cleanable/blood/gibs,
/turf/open/floor/plating/ground/mars/random/cave,
/area/bigredv3/caves/south)
"tW" = (
/obj/effect/decal/cleanable/dirt,
/turf/open/floor/tile/dark,
/area/bigredv3/inside/science/xenolab)
"uI" = (
/obj/machinery/light{
	dir = 8
	},
/turf/open/floor/plating/ground/mars/random/sand,
/area/bigredv3/inside/science/xenolab)
"uV" = (
/obj/structure/closet/toolcloset,
/turf/open/floor/plating,
/area/bigredv3/inside/science/research_office)
"ve" = (
/obj/structure/table,
/obj/item/tool/pen,
/turf/open/floor/tile/dark/red2/corner{
	dir = 4
	},
/area/bigredv3/inside/science/xenolab)
"vV" = (
/obj/machinery/light{
	dir = 4
	},
/obj/effect/decal/cleanable/dirt,
/obj/effect/ai_node,
/turf/open/floor/tile/dark/red2/corner,
/area/bigredv3/inside/science/xenolab)
"wj" = (
/obj/effect/landmark/lv624/fog_blocker/xeno_spawn,
/turf/open/floor/plating/ground/mars/random/cave/rock,
/area/bigredv3/caves/south)
"wO" = (
/obj/effect/landmark/xeno_silo_spawn,
/turf/open/floor/plating/ground/mars/random/cave,
/area/bigredv3/caves/south)
"xc" = (
/obj/structure/table,
/obj/effect/spawner/random/engineering/technology_scanner,
/turf/open/floor/tile/dark/red2/corner{
	dir = 4
	},
/area/bigredv3/inside/science/xenolab)
"xw" = (
/turf/open/floor/tile/dark/red2{
	dir = 10
	},
/area/bigredv3/inside/science/xenolab)
"xT" = (
/obj/machinery/light{
	dir = 8
	},
/turf/open/floor/tile/dark/red2/corner{
	dir = 8
	},
/area/bigredv3/inside/science/xenolab)
"zh" = (
/obj/machinery/light{
	dir = 1
	},
/turf/open/floor/tile/dark/red2{
	dir = 5
	},
/area/bigredv3/inside/science/xenolab)
"zy" = (
/obj/structure/table,
/obj/structure/xenoautopsy,
/turf/open/floor/tile/dark/red2/corner{
	dir = 4
	},
/area/bigredv3/inside/science/xenolab)
"zH" = (
/obj/machinery/atmospherics/components/unary/vent_pump{
	dir = 4;
	on = 1
	},
/turf/open/floor/tile/dark,
/area/bigredv3/inside/science/xenolab)
"AG" = (
/obj/effect/spawner/random/engineering/structure/tank/fuelweighted,
/obj/machinery/light/small{
	dir = 1
	},
/turf/open/floor/plating,
/area/bigredv3/inside/science/research_office)
"BJ" = (
/turf/open/floor/plating/ground/mars/random/sand,
/area/bigredv3/inside/science/xenolab)
"Ck" = (
/obj/structure/table,
/obj/item/alienjar,
/turf/open/floor/tile/dark/red2/corner{
	dir = 4
	},
/area/bigredv3/inside/science/xenolab)
"CR" = (
/turf/closed/mineral/smooth/bigred,
/area/bigredv3/caves/rock)
"Dm" = (
/turf/open/floor/tile/dark/red2/corner{
	dir = 8
	},
/area/bigredv3/inside/science/xenolab)
"DF" = (
/obj/machinery/atmospherics/pipe/simple/green/hidden{
	dir = 4
	},
/turf/open/floor/tile/dark,
/area/bigredv3/inside/science/xenolab)
"DS" = (
/obj/effect/decal/cleanable/dirt,
/obj/effect/ai_node,
/turf/open/floor/tile/dark,
/area/bigredv3/inside/science/xenolab)
"DY" = (
/turf/open/floor/tile/dark/red2,
/area/bigredv3/inside/science/xenolab)
"EK" = (
/turf/open/floor/plating,
/area/bigredv3/inside/science/research_office)
"Fp" = (
/obj/structure/xenoautopsy/tank,
/turf/open/floor/tile/dark/red2/corner{
	dir = 8
	},
/area/bigredv3/inside/science/xenolab)
"GM" = (
/obj/structure/table,
/obj/machinery/light,
/obj/effect/spawner/random/engineering/technology_scanner,
/obj/item/xenos_claw,
/turf/open/floor/tile/dark/red2/corner{
	dir = 8
	},
/area/bigredv3/inside/science/xenolab)
"HX" = (
/obj/machinery/light,
/turf/open/floor/tile/darkgreen/darkgreen2,
/area/bigredv3/inside/science/xenolab)
"Ii" = (
/turf/open/floor/plating/ground/mars/random/cave,
/area/bigredv3/caves/rock)
"JW" = (
/obj/effect/landmark/lv624/fog_blocker/xeno_spawn,
/turf/closed/mineral/smooth/bigred,
/area/bigredv3/caves/rock)
"Kh" = (
/turf/open/floor/tile/dark/red2/corner,
/area/bigredv3/inside/science/xenolab)
"Kp" = (
/turf/open/floor/plating/ground/mars/random/cave,
/area/bigredv3/caves/south)
"KJ" = (
/obj/effect/landmark/lv624/fog_blocker/xeno_spawn,
/turf/open/floor/plating/ground/mars/random/cave,
/area/bigredv3/caves/rock)
"KK" = (
/obj/structure/cable,
/obj/machinery/power/apc/weak/ntf{
	dir = 1
	},
/turf/open/floor/plating,
/area/bigredv3/inside/science/research_office)
"Ly" = (
/obj/effect/ai_node,
/turf/open/floor/tile/dark,
/area/bigredv3/inside/science/xenolab)
"LP" = (
/obj/effect/ai_node,
/turf/open/floor/plating/ground/mars/random/cave/rock,
/area/bigredv3/caves/south)
"LZ" = (
/obj/effect/decal/cleanable/dirt,
/turf/open/floor/tile/dark/red2/corner{
	dir = 8
	},
/area/bigredv3/inside/science/xenolab)
"NK" = (
/obj/structure/cable,
/turf/open/floor/plating,
/area/bigredv3/inside/science/research_office)
"NL" = (
/obj/structure/fence/standard/xenoproof,
/turf/open/floor/plating/ground/mars/random/cave/rock,
/area/bigredv3/caves/south)
"NO" = (
/obj/structure/table,
/obj/item/paper,
/turf/open/floor/tile/dark/red2/corner,
/area/bigredv3/inside/science/xenolab)
"Oh" = (
/obj/structure/fence/standard/xenoproof,
/turf/open/floor/plating/ground/mars/random/cave,
/area/bigredv3/caves/south)
"Oz" = (
/obj/structure/closet/l3closet/scientist,
/turf/open/floor/tile/darkgreen/darkgreen2{
	dir = 5
	},
/area/bigredv3/inside/science/xenolab)
"PE" = (
/turf/closed/mineral/smooth/bigred/indestructible,
/area/space)
"QU" = (
/obj/structure/closet/firecloset,
/turf/open/floor/plating,
/area/bigredv3/inside/science/research_office)
"Rw" = (
/obj/structure/closet/l3closet/scientist,
/turf/open/floor/tile/darkgreen/darkgreen2{
	dir = 1
	},
/area/bigredv3/inside/science/xenolab)
"RA" = (
/obj/item/target,
/turf/open/floor/tile/dark/red2{
	dir = 1
	},
/area/bigredv3/inside/science/xenolab)
"RE" = (
/obj/machinery/light{
	dir = 4
	},
/turf/open/ground/jungle/clear,
/area/bigredv3/inside/science/xenolab)
"Sc" = (
/obj/structure/window/framed/colony/reinforced,
/turf/open/floor/plating,
/area/bigredv3/inside/wall)
"Sm" = (
/obj/machinery/atmospherics/components/unary/vent_pump{
	dir = 1;
	on = 1
	},
/turf/open/floor/tile/dark,
/area/bigredv3/inside/science/xenolab)
"TA" = (
/turf/open/floor/tile/dark/red2{
	dir = 4
	},
/area/bigredv3/inside/science/xenolab)
"TN" = (
/turf/closed/wall,
/area/bigredv3/inside/wall)
"TT" = (
/obj/effect/ai_node,
/turf/open/floor/plating/ground/mars/random/cave,
/area/bigredv3/caves/south)
"UT" = (
/obj/machinery/atmospherics/pipe/manifold/green/hidden{
	dir = 1
	},
/obj/effect/ai_node,
/turf/open/floor/tile/dark,
/area/bigredv3/inside/science/xenolab)
"Vq" = (
/obj/effect/landmark/lv624/fog_blocker,
/turf/closed/mineral/smooth/bigred,
/area/bigredv3/caves/rock)
"VI" = (
/obj/structure/bed/chair{
	dir = 4
	},
/turf/open/floor/tile/dark/red2{
	dir = 4
	},
/area/bigredv3/inside/science/xenolab)
"Wa" = (
/obj/effect/landmark/lv624/fog_blocker,
/turf/closed/wall/r_wall,
/area/bigredv3/inside/wall)
"Yn" = (
/obj/machinery/atmospherics/pipe/simple/green/hidden{
	dir = 4
	},
/obj/effect/ai_node,
/turf/open/floor/tile/dark,
/area/bigredv3/inside/science/xenolab)
"Yp" = (
/obj/structure/closet/l3closet/scientist,
/turf/open/floor/tile/darkgreen/darkgreen2{
	dir = 9
	},
/area/bigredv3/inside/science/xenolab)
"YI" = (
/turf/open/floor/tile/dark/red2{
	dir = 6
	},
/area/bigredv3/inside/science/xenolab)
"YK" = (
/turf/closed/wall)
"YO" = (
/turf/open/floor/plating/ground/mars/random/cave/rock,
/area/bigredv3/caves/south)
"ZR" = (
/obj/machinery/door/airlock/mainship/research/glass/free_access{
	dir = 1;
	name = "\improper Eta Lab Cell"
	},
/turf/open/floor/tile/dark,
/area/bigredv3/inside/science/xenolab)

(1,1,1) = {"
PE
PE
PE
PE
PE
PE
PE
PE
PE
PE
PE
PE
PE
PE
PE
PE
PE
PE
PE
PE
PE
PE
PE
PE
PE
PE
PE
PE
PE
PE
PE
PE
PE
PE
PE
PE
PE
PE
"}
(2,1,1) = {"
PE
PE
PE
PE
PE
PE
PE
PE
PE
PE
PE
PE
PE
PE
PE
PE
PE
PE
PE
PE
PE
PE
PE
PE
PE
PE
PE
PE
PE
PE
PE
PE
PE
PE
PE
PE
PE
PE
"}
(3,1,1) = {"
PE
PE
PE
PE
PE
PE
PE
PE
PE
PE
PE
PE
PE
PE
PE
PE
PE
PE
PE
PE
PE
PE
PE
PE
PE
PE
PE
PE
PE
PE
PE
PE
PE
PE
PE
PE
PE
PE
"}
(4,1,1) = {"
PE
PE
PE
PE
PE
PE
PE
PE
PE
PE
PE
PE
PE
PE
PE
PE
PE
PE
PE
PE
PE
PE
PE
PE
PE
PE
PE
PE
PE
PE
PE
PE
PE
PE
PE
PE
PE
PE
"}
(5,1,1) = {"
PE
PE
PE
PE
PE
PE
PE
PE
PE
PE
PE
PE
PE
PE
PE
PE
PE
PE
PE
PE
PE
PE
PE
PE
PE
PE
PE
PE
PE
PE
PE
PE
PE
PE
PE
PE
PE
PE
"}
(6,1,1) = {"
PE
PE
PE
PE
PE
PE
PE
PE
PE
PE
PE
PE
PE
PE
PE
PE
PE
PE
PE
PE
PE
PE
PE
PE
PE
PE
PE
PE
PE
PE
PE
PE
PE
PE
PE
PE
PE
PE
"}
(7,1,1) = {"
PE
PE
PE
PE
PE
PE
PE
PE
PE
PE
PE
PE
PE
PE
PE
PE
PE
PE
PE
PE
PE
PE
PE
PE
PE
PE
PE
PE
PE
PE
PE
PE
PE
PE
PE
PE
PE
PE
"}
(8,1,1) = {"
PE
PE
PE
PE
PE
PE
PE
og
PE
PE
PE
PE
PE
PE
PE
PE
PE
PE
PE
PE
PE
PE
PE
PE
PE
PE
PE
PE
PE
PE
PE
PE
PE
PE
PE
PE
PE
PE
"}
(9,1,1) = {"
PE
PE
PE
PE
PE
PE
PE
PE
PE
PE
PE
PE
PE
PE
PE
PE
PE
PE
PE
PE
PE
PE
PE
PE
PE
PE
PE
PE
PE
PE
PE
PE
PE
PE
PE
PE
PE
PE
"}
(10,1,1) = {"
PE
PE
PE
PE
PE
PE
PE
eB
PE
PE
PE
PE
PE
PE
PE
PE
PE
PE
PE
PE
PE
PE
PE
PE
PE
PE
PE
PE
PE
PE
PE
PE
PE
PE
PE
PE
PE
PE
"}
(11,1,1) = {"
PE
PE
PE
PE
PE
PE
PE
PE
PE
PE
PE
PE
PE
PE
PE
PE
PE
PE
PE
PE
PE
PE
PE
PE
PE
PE
PE
PE
PE
PE
PE
PE
PE
PE
PE
PE
PE
PE
"}
(12,1,1) = {"
PE
PE
PE
PE
PE
PE
PE
PE
PE
PE
PE
PE
PE
PE
PE
PE
PE
PE
PE
PE
PE
PE
PE
PE
PE
PE
PE
PE
PE
PE
PE
PE
PE
PE
PE
PE
PE
PE
"}
(13,1,1) = {"
PE
PE
PE
PE
PE
PE
PE
PE
PE
PE
PE
PE
PE
PE
PE
PE
PE
PE
PE
PE
PE
PE
PE
PE
PE
PE
PE
PE
PE
PE
PE
PE
PE
PE
PE
PE
PE
PE
"}
(14,1,1) = {"
PE
PE
PE
PE
PE
PE
PE
PE
PE
PE
PE
PE
PE
PE
PE
PE
PE
PE
PE
PE
PE
PE
PE
PE
PE
PE
PE
PE
PE
PE
PE
PE
PE
PE
PE
PE
PE
PE
"}
(15,1,1) = {"
PE
PE
PE
PE
PE
PE
PE
PE
PE
PE
PE
PE
PE
PE
PE
PE
PE
PE
PE
PE
PE
PE
PE
PE
PE
PE
PE
PE
PE
PE
PE
PE
PE
PE
PE
PE
PE
PE
"}
(16,1,1) = {"
PE
PE
PE
PE
PE
PE
PE
PE
PE
PE
PE
PE
PE
PE
PE
PE
PE
PE
PE
PE
PE
PE
PE
PE
PE
PE
PE
PE
PE
PE
PE
PE
PE
PE
PE
PE
PE
PE
"}
(17,1,1) = {"
PE
PE
PE
PE
PE
PE
PE
PE
PE
PE
PE
PE
PE
PE
PE
PE
PE
PE
PE
PE
PE
PE
PE
PE
PE
PE
PE
PE
PE
PE
PE
PE
PE
PE
PE
PE
PE
PE
"}
(18,1,1) = {"
PE
PE
PE
PE
PE
PE
PE
PE
PE
PE
PE
PE
PE
PE
PE
PE
PE
PE
PE
PE
PE
PE
PE
PE
PE
PE
PE
PE
PE
PE
PE
PE
PE
PE
PE
PE
PE
PE
"}
(19,1,1) = {"
PE
PE
PE
PE
PE
PE
PE
PE
PE
PE
PE
PE
PE
PE
PE
PE
PE
PE
PE
PE
PE
PE
PE
PE
PE
PE
PE
PE
PE
PE
PE
PE
PE
PE
PE
PE
PE
PE
"}
(20,1,1) = {"
PE
PE
PE
PE
PE
PE
PE
PE
PE
PE
PE
PE
PE
PE
PE
PE
PE
PE
PE
PE
PE
PE
PE
PE
PE
PE
PE
PE
PE
PE
PE
PE
PE
PE
PE
PE
PE
PE
"}
(21,1,1) = {"
PE
PE
PE
PE
PE
PE
PE
PE
PE
PE
PE
PE
PE
PE
PE
PE
PE
PE
PE
PE
PE
PE
PE
PE
PE
PE
PE
PE
PE
PE
PE
PE
PE
PE
PE
PE
PE
PE
"}
(22,1,1) = {"
PE
PE
PE
PE
PE
PE
PE
PE
PE
PE
PE
PE
PE
PE
PE
PE
PE
PE
PE
PE
PE
PE
PE
PE
PE
PE
PE
PE
PE
PE
PE
PE
PE
PE
PE
PE
PE
PE
"}
(23,1,1) = {"
PE
PE
PE
PE
PE
PE
PE
PE
PE
PE
PE
PE
PE
PE
PE
PE
PE
PE
PE
PE
PE
PE
PE
PE
PE
PE
PE
PE
PE
PE
PE
PE
PE
PE
PE
PE
PE
PE
"}
(24,1,1) = {"
PE
PE
PE
PE
PE
PE
PE
PE
PE
PE
PE
PE
PE
PE
PE
PE
PE
PE
PE
PE
PE
PE
PE
PE
PE
PE
PE
PE
PE
PE
PE
PE
PE
PE
PE
PE
PE
PE
"}
(25,1,1) = {"
PE
PE
PE
PE
PE
PE
PE
PE
PE
PE
PE
PE
PE
PE
PE
PE
PE
PE
PE
PE
PE
PE
PE
PE
PE
PE
PE
PE
PE
PE
PE
PE
PE
PE
PE
PE
PE
PE
"}
(26,1,1) = {"
PE
PE
PE
PE
PE
PE
PE
PE
PE
PE
PE
PE
PE
PE
PE
PE
PE
PE
PE
PE
PE
PE
PE
PE
PE
PE
PE
PE
PE
PE
PE
PE
PE
PE
PE
PE
PE
PE
"}
(27,1,1) = {"
PE
PE
PE
PE
PE
PE
PE
PE
PE
PE
PE
PE
PE
PE
PE
PE
PE
PE
PE
PE
PE
PE
PE
PE
PE
PE
PE
PE
PE
PE
PE
PE
PE
PE
PE
PE
PE
PE
"}
(28,1,1) = {"
PE
PE
PE
PE
PE
PE
PE
PE
PE
PE
PE
PE
PE
PE
PE
PE
PE
PE
PE
PE
PE
PE
PE
PE
PE
PE
PE
PE
PE
PE
PE
PE
PE
PE
PE
PE
PE
PE
"}
(29,1,1) = {"
PE
PE
PE
PE
PE
PE
PE
PE
PE
PE
PE
PE
PE
PE
PE
PE
PE
PE
PE
PE
PE
PE
PE
PE
PE
PE
PE
PE
PE
PE
PE
PE
PE
PE
PE
PE
PE
PE
"}
(30,1,1) = {"
CR
CR
CR
CR
CR
CR
CR
CR
CR
CR
CR
CR
CR
CR
CR
CR
CR
CR
CR
CR
CR
CR
CR
CR
CR
CR
CR
CR
CR
CR
CR
CR
CR
CR
CR
CR
CR
PE
"}
(31,1,1) = {"
CR
CR
JW
JW
JW
JW
JW
JW
JW
JW
JW
JW
JW
JW
JW
CR
CR
CR
CR
CR
CR
CR
CR
CR
CR
CR
CR
CR
CR
CR
CR
CR
CR
CR
CR
CR
CR
PE
"}
(32,1,1) = {"
CR
CR
JW
CR
CR
CR
CR
CR
CR
YO
YO
CR
CR
CR
JW
CR
CR
CR
CR
CR
CR
CR
CR
CR
CR
CR
CR
CR
CR
CR
CR
CR
CR
CR
CR
CR
CR
PE
"}
(33,1,1) = {"
CR
CR
JW
CR
CR
CR
CR
CR
YO
Kp
Kp
YO
CR
CR
JW
CR
CR
CR
CR
CR
CR
CR
CR
CR
CR
CR
CR
CR
CR
CR
CR
CR
CR
CR
CR
CR
CR
PE
"}
(34,1,1) = {"
CR
CR
JW
CR
CR
CR
CR
YO
Kp
Kp
wO
Kp
YO
YO
JW
CR
CR
CR
CR
CR
CR
CR
CR
CR
CR
CR
CR
CR
CR
CR
CR
CR
CR
CR
CR
CR
CR
PE
"}
(35,1,1) = {"
CR
CR
JW
CR
CR
CR
YO
Kp
Kp
Kp
Kp
Kp
Kp
YO
JW
CR
CR
CR
CR
CR
CR
CR
CR
CR
CR
CR
CR
CR
CR
CR
CR
CR
CR
CR
CR
CR
CR
PE
"}
(36,1,1) = {"
CR
CR
JW
CR
CR
CR
Kp
Kp
Kp
Kp
Kp
Kp
Kp
Kp
JW
CR
CR
CR
CR
CR
CR
CR
CR
CR
CR
CR
CR
CR
CR
CR
CR
CR
CR
CR
CR
CR
CR
PE
"}
(37,1,1) = {"
CR
CR
JW
CR
Kp
Kp
Kp
Kp
Kp
Kp
Kp
Kp
Kp
Kp
JW
CR
CR
CR
CR
CR
CR
CR
CR
CR
CR
CR
CR
CR
CR
CR
CR
CR
CR
CR
CR
CR
CR
PE
"}
(38,1,1) = {"
CR
CR
JW
Kp
Kp
Kp
Kp
Kp
Kp
Kp
Kp
Kp
Kp
Kp
aW
Kp
CR
CR
CR
CR
CR
CR
CR
CR
CR
CR
CR
CR
CR
CR
CR
CR
CR
CR
CR
CR
CR
PE
"}
(39,1,1) = {"
Kp
Kp
aW
Kp
Kp
Kp
Kp
Kp
Kp
Kp
Kp
Kp
Kp
Kp
aW
Kp
Kp
Kp
Kp
Kp
Kp
Kp
CR
CR
CR
CR
CR
CR
CR
CR
CR
CR
CR
CR
CR
CR
CR
PE
"}
(40,1,1) = {"
Kp
YO
aW
Kp
YO
YO
Kp
Kp
Kp
Kp
Kp
YO
Kp
Kp
aW
Kp
Kp
Kp
Kp
Kp
Kp
Kp
Kp
CR
CR
CR
CR
CR
CR
CR
CR
CR
CR
CR
CR
CR
CR
PE
"}
(41,1,1) = {"
Kp
Kp
aW
Kp
Kp
Kp
Kp
Kp
Kp
TT
Kp
Kp
YO
YO
wj
YO
YO
YO
Kp
YO
LP
YO
Kp
Kp
Kp
TT
CR
CR
CR
CR
CR
CR
CR
CR
CR
CR
CR
PE
"}
(42,1,1) = {"
Kp
Kp
aW
Kp
Kp
Kp
Kp
Kp
Kp
Kp
Kp
Kp
Kp
Kp
aW
Kp
Kp
Kp
Kp
Kp
Kp
Kp
YO
Kp
Kp
Kp
Kp
CR
CR
CR
CR
CR
CR
CR
CR
CR
CR
PE
"}
(43,1,1) = {"
Kp
CR
JW
CR
CR
CR
CR
YO
Kp
Kp
Kp
Kp
Kp
Kp
aW
Kp
Kp
Kp
Kp
Kp
Kp
Kp
Kp
Kp
Kp
Kp
Kp
Kp
CR
CR
CR
CR
CR
CR
CR
CR
CR
PE
"}
(44,1,1) = {"
CR
CR
JW
JW
JW
JW
JW
JW
JW
JW
KJ
KJ
KJ
KJ
JW
CR
CR
Kp
CR
CR
YO
YO
CR
YO
Kp
Kp
Kp
Kp
CR
CR
CR
CR
CR
CR
CR
CR
CR
PE
"}
(45,1,1) = {"
CR
CR
CR
CR
CR
CR
CR
CR
CR
CR
Ii
Ii
Ii
Ii
CR
CR
CR
CR
CR
CR
CR
CR
CR
CR
Kp
Kp
Kp
Kp
Kp
CR
CR
CR
CR
CR
CR
CR
CR
PE
"}
(46,1,1) = {"
Vq
Vq
Vq
Vq
Vq
Vq
Vq
Vq
Vq
Vq
Vq
op
op
op
Vq
Vq
Vq
Vq
Vq
Vq
Vq
Vq
CR
CR
YO
Kp
Kp
Kp
Kp
Kp
CR
CR
CR
CR
CR
CR
CR
PE
"}
(47,1,1) = {"
iN
iN
iN
iN
iN
iN
iN
iN
iN
iN
iN
iN
iN
iN
iN
iN
iN
iN
iN
iN
iN
iN
Wa
CR
Kp
Kp
Kp
Kp
Kp
Kp
Kp
CR
CR
CR
CR
CR
CR
PE
"}
(48,1,1) = {"
qE
rV
rV
xw
iN
Fp
dB
dB
Fp
Fp
iN
BJ
uI
BJ
iN
BJ
uI
BJ
iN
BJ
uI
BJ
Wa
CR
Oh
TT
Kp
Kp
Kp
Kp
Kp
CR
CR
CR
CR
CR
CR
PE
"}
(49,1,1) = {"
sP
Ly
oG
oG
ZR
oG
oG
Ly
oG
LZ
iN
BJ
nN
BJ
iN
BJ
nN
BJ
iN
BJ
nN
BJ
Wa
YO
NL
Kp
Kp
Kp
Kp
Kp
Kp
CR
CR
CR
CR
CR
CR
PE
"}
(50,1,1) = {"
sP
oG
oG
DY
iN
ow
tW
tW
tW
cQ
iN
BJ
BJ
BJ
iN
BJ
BJ
BJ
iN
BJ
BJ
BJ
Wa
Kp
Oh
Kp
Kp
Kp
Kp
Kp
Kp
CR
CR
CR
CR
CR
CR
PE
"}
(51,1,1) = {"
RA
oG
oG
DY
Sc
kv
tW
tW
oG
GM
iN
py
hY
py
iN
py
hY
py
iN
py
hY
py
Wa
Kp
Oh
Kp
Kp
YO
Kp
Kp
Kp
Kp
CR
CR
CR
CR
CR
PE
"}
(52,1,1) = {"
sP
oG
oG
DY
Sc
xc
tW
tW
oG
Dm
YK
eY
tW
eY
TN
eY
oG
eY
TN
eY
oG
eY
Wa
Kp
Oh
Kp
Kp
YO
Kp
Kp
Kp
Kp
Kp
CR
CR
CR
CR
PE
"}
(53,1,1) = {"
RA
oG
oG
DY
Sc
Ck
oG
tW
tW
oG
Dm
LZ
oG
Dm
xT
Dm
oG
Dm
Dm
Dm
tW
Dm
Wa
Kp
Oh
Kp
Kp
YO
Kp
Kp
Kp
Kp
Kp
CR
CR
CR
CR
PE
"}
(54,1,1) = {"
sP
Ly
oG
DY
Sc
zy
oG
zH
tW
tW
oG
tW
tW
tW
oG
tW
tW
tW
oG
tW
oG
tW
Wa
Kp
Oh
Kp
Kp
YO
Kp
Kp
Kp
Kp
Kp
CR
CR
CR
CR
PE
"}
(55,1,1) = {"
sP
oG
oG
DY
Sc
ve
oG
Yn
tW
tW
vV
lQ
DS
lQ
lQ
lQ
DS
lQ
vV
Kh
Ly
Kh
Wa
Kp
Oh
TT
Kp
Kp
Kp
Kp
Kp
Kp
TT
CR
CR
CR
CR
PE
"}
(56,1,1) = {"
zh
TA
TA
YI
Sc
NO
Kh
DF
Kh
ak
TN
VI
oG
VI
TN
VI
oG
VI
TN
VI
tW
VI
Wa
CR
NL
Kp
Kp
Kp
Kp
Kp
Kp
Kp
Kp
Kp
CR
CR
CR
PE
"}
(57,1,1) = {"
iN
iN
iN
iN
iN
TN
sd
kg
sd
TN
iN
py
hY
py
iN
py
hY
py
iN
py
hY
py
Wa
CR
CR
CR
CR
Kp
Kp
Kp
Kp
Kp
Kp
Kp
CR
CR
CR
PE
"}
(58,1,1) = {"
dM
NK
NK
KK
TN
Yp
hf
DF
hf
sx
iN
tn
tn
tn
iN
tn
tn
tn
iN
tn
tn
tn
Wa
CR
CR
CR
CR
Kp
CR
CR
Kp
Kp
Kp
Kp
Kp
CR
CR
PE
"}
(59,1,1) = {"
AG
pk
EK
QU
TN
Rw
oG
UT
Sm
HX
iN
tn
lH
tn
iN
tn
lH
tn
iN
tn
lH
tn
Wa
CR
CR
CR
CR
CR
CR
CR
CR
Kp
Kp
Kp
Kp
CR
CR
PE
"}
(60,1,1) = {"
dM
NK
EK
uV
TN
Oz
gD
DF
gD
th
iN
tn
RE
tn
iN
tn
RE
tn
iN
tn
RE
tn
Wa
Vq
Vq
Vq
Vq
Vq
Vq
Vq
CR
Kp
TT
tF
Kp
CR
CR
PE
"}
(61,1,1) = {"
TN
jy
TN
TN
TN
TN
sd
kg
sd
TN
iN
iN
iN
iN
iN
iN
iN
iN
iN
iN
iN
iN
iN
iN
iN
iN
iN
iN
iN
Vq
CR
Kp
Kp
Kp
Kp
CR
CR
PE
"}
