//MAP CONVERTED BY dmm2tgm.py THIS HEADER COMMENT PREVENTS RECONVERSION, DO NOT REMOVE
"a" = (
/turf/closed/mineral/smooth/bigred,
/area/bigredv3/caves/rock)
"b" = (
/obj/structure/cable,
/turf/closed/wall/r_wall,
/area/bigredv3/inside/wall)
"c" = (
/obj/machinery/light{
	dir = 8
	},
/obj/effect/decal/cleanable/dirt,
/turf/open/floor/tile/dark,
/area/bigredv3/inside/security/checkpoint_entrypoint)
"d" = (
/obj/structure/table/mainship,
/obj/effect/spawner/random/engineering/tool,
/obj/machinery/light{
	dir = 8
	},
/turf/open/floor/tile/dark,
/area/bigredv3/inside/security/checkpoint_entrypoint)
"e" = (
/obj/machinery/door/airlock/mainship/security/glass{
	dir = 4;
	name = "\improper Checkpoint Office"
	},
/turf/open/floor/tile/dark,
/area/bigredv3/inside/security/checkpoint_entrypoint)
"f" = (
/obj/item/radio,
/obj/structure/table/mainship,
/turf/open/floor/tile/dark,
/area/bigredv3/inside/security/checkpoint_entrypoint)
"h" = (
/obj/effect/decal/cleanable/blood,
/obj/effect/spawner/gibspawner/human,
/turf/open/floor/tile/dark,
/area/bigredv3/inside/security/checkpoint_entrypoint)
"i" = (
/obj/effect/spawner/random/misc/structure/supplycrate/normalweighted,
/obj/machinery/light{
	dir = 8
	},
/turf/open/floor/tile/dark,
/area/bigredv3/inside/security/checkpoint_entrypoint)
"j" = (
/obj/effect/decal/cleanable/dirt,
/turf/open/floor/tile/dark,
/area/bigredv3/inside/security/checkpoint_entrypoint)
"k" = (
/obj/structure/filingcabinet,
/turf/open/floor/podhatch/floor,
/area/bigredv3/inside/security/checkpoint_entrypoint)
"l" = (
/obj/item/trash/sosjerky,
/obj/effect/decal/cleanable/dirt,
/turf/open/floor/tile/dark,
/area/bigredv3/inside/security/checkpoint_entrypoint)
"m" = (
/obj/structure/table/mainship,
/turf/open/floor/podhatch/floor,
/area/bigredv3/inside/security/checkpoint_entrypoint)
"n" = (
/obj/machinery/door/airlock/mainship/security/glass{
	dir = 1;
	name = "\improper Checkpoint Office"
	},
/obj/structure/cable,
/turf/open/floor/tile/dark,
/area/bigredv3/inside/security/checkpoint_entrypoint)
"o" = (
/obj/structure/table/mainship,
/obj/machinery/computer/secure_data{
	dir = 8
	},
/obj/machinery/light{
	dir = 4
	},
/turf/open/floor/tile/dark,
/area/bigredv3/inside/security/checkpoint_entrypoint)
"q" = (
/obj/structure/rack,
/obj/effect/spawner/random/engineering/toolbox,
/turf/open/floor/tile/dark,
/area/bigredv3/inside/security/checkpoint_entrypoint)
"s" = (
/obj/structure/rack,
/obj/item/stack/sheet/metal/small_stack,
/turf/open/floor/tile/dark,
/area/bigredv3/inside/security/checkpoint_entrypoint)
"t" = (
/obj/effect/decal/cleanable/blood,
/turf/open/floor/tile/dark,
/area/bigredv3/inside/security/checkpoint_entrypoint)
"u" = (
/obj/structure/inflatable/wall,
/turf/open/floor/podhatch/floor,
/area/bigredv3/inside/security/checkpoint_entrypoint)
"v" = (
/obj/structure/rack,
/obj/item/storage/firstaid,
/turf/open/floor/tile/dark,
/area/bigredv3/inside/security/checkpoint_entrypoint)
"w" = (
/obj/structure/table/mainship,
/obj/effect/spawner/random/engineering/technology_scanner,
/turf/open/floor/podhatch/floor,
/area/bigredv3/inside/security/checkpoint_entrypoint)
"z" = (
/obj/machinery/power/apc/weak/ntf{
	start_charge = 0
	},
/obj/structure/cable,
/turf/open/floor/tile/dark,
/area/bigredv3/inside/security/checkpoint_entrypoint)
"A" = (
/obj/structure/table/mainship,
/obj/machinery/computer/security/wooden_tv{
	dir = 8
	},
/turf/open/floor/podhatch/floor,
/area/bigredv3/inside/security/checkpoint_entrypoint)
"B" = (
/obj/structure/table/mainship,
/obj/effect/spawner/random/misc/handcuffs,
/turf/open/floor/tile/dark,
/area/bigredv3/inside/security/checkpoint_entrypoint)
"C" = (
/turf/closed/wall/r_wall/unmeltable,
/area/bigredv3/inside/wall)
"E" = (
/obj/structure/bed/chair/office/light{
	dir = 4
	},
/turf/open/floor/tile/dark,
/area/bigredv3/inside/security/checkpoint_entrypoint)
"F" = (
/obj/effect/spawner/random/misc/structure/supplycrate/normalweighted,
/turf/open/floor/tile/dark,
/area/bigredv3/inside/security/checkpoint_entrypoint)
"G" = (
/turf/closed/wall/r_wall,
/area/bigredv3/inside/wall)
"H" = (
/turf/open/floor/podhatch/floor,
/area/bigredv3/inside/security/checkpoint_entrypoint)
"I" = (
/obj/structure/window/framed/colony/reinforced,
/turf/open/floor/plating,
/area/bigredv3/inside/wall)
"L" = (
/obj/machinery/light{
	dir = 4
	},
/turf/open/floor/tile/dark,
/area/bigredv3/inside/security/checkpoint_entrypoint)
"O" = (
/obj/effect/decal/cleanable/dirt,
/obj/structure/cable,
/turf/open/floor/tile/dark,
/area/bigredv3/inside/security/checkpoint_entrypoint)
"P" = (
/obj/structure/rack,
/obj/item/clothing/mask/gas,
/obj/item/flashlight,
/obj/machinery/light{
	dir = 4
	},
/turf/open/floor/tile/dark,
/area/bigredv3/inside/security/checkpoint_entrypoint)
"Q" = (
/obj/effect/spawner/random/misc/structure/supplycrate/normalweighted,
/turf/open/floor/podhatch/floor,
/area/bigredv3/inside/security/checkpoint_entrypoint)
"R" = (
/obj/structure/table/mainship,
/obj/item/ashtray/bronze,
/obj/item/trash/cigbutt/cigarbutt,
/obj/machinery/door_control{
	id = "securitycheckpointgate1";
	name = "Security Checkpoint Gate 1";
	pixel_y = 28;
	pixel_x = -8
	},
/obj/machinery/door_control{
	id = "securitycheckpointgate2";
	name = "Security Checkpoint Gate 2";
	pixel_y = 28;
	pixel_x = 8
	},
/obj/machinery/door_control{
	id = "securitycheckpointgate3";
	name = "Security Checkpoint Gate 3";
	pixel_y = 36
	},
/turf/open/floor/podhatch/floor,
/area/bigredv3/inside/security/checkpoint_entrypoint)
"S" = (
/obj/structure/table/mainship,
/obj/item/attachable/motiondetector,
/turf/open/floor/tile/dark,
/area/bigredv3/inside/security/checkpoint_entrypoint)
"U" = (
/turf/open/floor/tile/dark,
/area/bigredv3/inside/security/checkpoint_entrypoint)
"W" = (
/obj/structure/window/framed/colony/reinforced,
/turf/open/floor/tile/dark,
/area/bigredv3/inside/wall)
"X" = (
/obj/machinery/light{
	dir = 8
	},
/obj/machinery/vending/security,
/turf/open/floor/tile/dark,
/area/bigredv3/inside/security/checkpoint_entrypoint)
"Y" = (
/obj/structure/closet/secure_closet/marshal,
/turf/open/floor/podhatch/floor,
/area/bigredv3/inside/security/checkpoint_entrypoint)

(1,1,1) = {"
C
b
G
G
G
G
G
G
G
a
"}
(2,1,1) = {"
W
k
c
f
S
B
X
u
G
a
"}
(3,1,1) = {"
I
m
U
l
j
j
U
u
G
a
"}
(4,1,1) = {"
C
R
E
j
U
j
j
H
G
a
"}
(5,1,1) = {"
C
A
o
U
U
j
L
Y
G
a
"}
(6,1,1) = {"
C
G
G
G
e
G
G
G
G
a
"}
(7,1,1) = {"
C
F
i
U
j
U
d
m
G
a
"}
(8,1,1) = {"
C
z
U
j
j
U
U
w
G
a
"}
(9,1,1) = {"
n
O
j
U
U
j
U
H
G
a
"}
(10,1,1) = {"
C
U
h
t
U
j
j
H
G
a
"}
(11,1,1) = {"
C
t
L
q
v
s
P
Q
G
a
"}
(12,1,1) = {"
C
G
G
G
G
G
G
G
G
a
"}
