//MAP CONVERTED BY dmm2tgm.py THIS HEADER COMMENT PREVENTS RECONVERSION, DO NOT REMOVE
"aj" = (
/obj/machinery/light{
	dir = 1
	},
/turf/open/floor/tile/dark/red2{
	dir = 9
	},
/area/bigredv2/outside/nanotrasen_lab/inside)
"br" = (
/obj/structure/window/framed/colony/reinforced,
/turf/open/floor/plating,
/area/bigredv2/outside/nanotrasen_lab/inside)
"bt" = (
/obj/effect/landmark/lv624/fog_blocker,
/turf/closed/mineral/smooth/bigred,
/area/bigredv2/caves/rock)
"cB" = (
/obj/structure/table,
/obj/item/tool/pen,
/turf/open/floor/tile/dark/red2/corner{
	dir = 4
	},
/area/bigredv2/outside/nanotrasen_lab/inside)
"dk" = (
/obj/machinery/computer/security,
/turf/open/floor/tile/dark/red2/corner{
	dir = 4
	},
/area/bigredv2/outside/nanotrasen_lab/inside)
"eC" = (
/turf/open/floor/plating/ground/mars/random/cave,
/area/bigredv2/caves/south)
"eH" = (
/obj/effect/decal/cleanable/dirt,
/turf/open/floor/tile/dark/red2/corner,
/area/bigredv2/outside/nanotrasen_lab/inside)
"fU" = (
/obj/structure/table,
/obj/structure/xenoautopsy,
/turf/open/floor/tile/dark/red2/corner{
	dir = 4
	},
/area/bigredv2/outside/nanotrasen_lab/inside)
"gh" = (
/obj/machinery/light{
	dir = 8
	},
/turf/open/floor/tile/dark/red2/corner{
	dir = 8
	},
/area/bigredv2/outside/nanotrasen_lab/inside)
"gA" = (
/obj/structure/bed/chair{
	dir = 8
	},
/turf/open/floor/tile/dark/red2{
	dir = 8
	},
/area/bigredv2/outside/nanotrasen_lab/inside)
"gG" = (
/obj/structure/cable,
/obj/machinery/power/apc/high/ntf{
	dir = 1
	},
/turf/open/floor/plating,
/area/bigredv2/outside/nanotrasen_lab/inside)
"hJ" = (
/obj/effect/landmark/lv624/fog_blocker/xeno_spawn,
/turf/open/floor/plating/ground/mars/random/cave,
/area/bigredv2/caves/south)
"iu" = (
/obj/effect/landmark/lv624/fog_blocker/xeno_spawn,
/turf/closed/mineral/smooth/bigred,
/area/bigredv2/caves/rock)
"iZ" = (
/obj/effect/landmark/excavation_site_spawner,
/turf/open/floor/plating/ground/mars/random/cave,
/area/bigredv2/caves/south)
"ju" = (
/obj/effect/ai_node,
/turf/open/floor/tile/dark,
/area/bigredv2/outside/nanotrasen_lab/inside)
"kj" = (
/obj/machinery/atmospherics/components/unary/vent_pump{
	dir = 4;
	on = 1
	},
/turf/open/floor/tile/dark,
/area/bigredv2/outside/nanotrasen_lab/inside)
"lQ" = (
/turf/open/floor/plating/ground/mars/random/cave/rock,
/area/bigredv2/caves/south)
"mS" = (
/turf/open/floor/tile/darkgreen/darkgreen2{
	dir = 6
	},
/area/bigredv2/outside/nanotrasen_lab/inside)
"oH" = (
/turf/open/floor/plating,
/area/bigredv2/outside/nanotrasen_lab/inside)
"oL" = (
/obj/structure/xenoautopsy/tank/hugger,
/turf/open/floor/tile/dark/red2/corner{
	dir = 8
	},
/area/bigredv2/outside/nanotrasen_lab/inside)
"pz" = (
/turf/open/floor/plating/ground/mars/random/sand,
/area/bigredv2/outside/nanotrasen_lab/inside)
"pW" = (
/obj/effect/landmark/xeno_silo_spawn,
/turf/open/floor/plating/ground/mars/random/cave,
/area/bigredv2/caves/south)
"qt" = (
/obj/effect/landmark/lv624/fog_blocker,
/turf/closed/wall/r_wall,
/area/bigredv2/outside/nanotrasen_lab/inside)
"qR" = (
/obj/effect/decal/cleanable/dirt,
/obj/effect/ai_node,
/turf/open/floor/tile/dark,
/area/bigredv2/outside/nanotrasen_lab/inside)
"qZ" = (
/turf/open/floor/tile/dark/red2{
	dir = 8
	},
/area/bigredv2/outside/nanotrasen_lab/inside)
"rh" = (
/obj/machinery/atmospherics/pipe/simple/green/hidden{
	dir = 4
	},
/turf/open/floor/tile/dark,
/area/bigredv2/outside/nanotrasen_lab/inside)
"rx" = (
/obj/structure/closet/toolcloset,
/turf/open/floor/plating,
/area/bigredv2/outside/nanotrasen_lab/inside)
"rW" = (
/obj/effect/ai_node,
/turf/open/floor/plating/ground/mars/random/sand,
/area/bigredv2/outside/nanotrasen_lab/inside)
"tI" = (
/turf/open/floor/tile/darkgreen/darkgreen2{
	dir = 8
	},
/area/bigredv2/outside/nanotrasen_lab/inside)
"tQ" = (
/obj/structure/fence/standard/xenoproof,
/turf/open/floor/plating/ground/mars/random/cave/rock,
/area/bigredv2/caves/south)
"uH" = (
/obj/structure/fence/standard/xenoproof,
/turf/open/floor/plating/ground/mars/random/cave,
/area/bigredv2/caves/south)
"uL" = (
/turf/open/floor/tile/dark/red2/corner,
/area/bigredv2/outside/nanotrasen_lab/inside)
"uM" = (
/turf/open/ground/jungle/clear,
/area/bigredv2/outside/nanotrasen_lab/inside)
"vm" = (
/obj/structure/table,
/obj/item/alienjar,
/turf/open/floor/tile/dark/red2/corner{
	dir = 4
	},
/area/bigredv2/outside/nanotrasen_lab/inside)
"xk" = (
/obj/structure/bed/chair{
	dir = 4
	},
/turf/open/floor/tile/dark/red2{
	dir = 4
	},
/area/bigredv2/outside/nanotrasen_lab/inside)
"ym" = (
/obj/effect/ai_node,
/turf/open/floor/plating/ground/mars/random/cave,
/area/bigredv2/caves/south)
"yU" = (
/obj/machinery/miner/damaged/platinum,
/turf/open/floor/plating/ground/mars/random/cave/rock,
/area/bigredv2/caves/south)
"zf" = (
/turf/open/floor/tile/darkgreen/darkgreen2{
	dir = 4
	},
/area/bigredv2/outside/nanotrasen_lab/inside)
"zr" = (
/obj/structure/closet/l3closet/scientist,
/turf/open/floor/tile/darkgreen/darkgreen2{
	dir = 1
	},
/area/bigredv2/outside/nanotrasen_lab/inside)
"zV" = (
/turf/open/floor/tile/dark/red2,
/area/bigredv2/outside/nanotrasen_lab/inside)
"Aq" = (
/turf/open/floor/tile/dark/red2{
	dir = 1
	},
/area/bigredv2/outside/nanotrasen_lab/inside)
"AF" = (
/obj/machinery/light{
	dir = 1
	},
/turf/open/floor/tile/dark/red2{
	dir = 5
	},
/area/bigredv2/outside/nanotrasen_lab/inside)
"AQ" = (
/obj/structure/table,
/obj/item/paper,
/turf/open/floor/tile/dark/red2/corner,
/area/bigredv2/outside/nanotrasen_lab/inside)
"Bp" = (
/obj/machinery/atmospherics/pipe/simple/green/hidden{
	dir = 4
	},
/obj/machinery/door/airlock/mainship/research/glass/free_access{
	name = "\improper Eta Lab Xenobiology Lab"
	},
/turf/open/floor/tile/dark,
/area/bigredv2/outside/nanotrasen_lab/inside)
"DB" = (
/obj/machinery/door/airlock/mainship/research/glass/free_access{
	dir = 1;
	name = "\improper Eta Lab Cell"
	},
/turf/open/floor/tile/dark,
/area/bigredv2/outside/nanotrasen_lab/inside)
"En" = (
/obj/structure/xenoautopsy/tank/broken,
/turf/open/floor/tile/dark/red2/corner{
	dir = 8
	},
/area/bigredv2/outside/nanotrasen_lab/inside)
"Eq" = (
/obj/effect/decal/cleanable/dirt,
/turf/open/floor/tile/dark,
/area/bigredv2/outside/nanotrasen_lab/inside)
"EC" = (
/turf/open/floor/tile/dark/red2{
	dir = 4
	},
/area/bigredv2/outside/nanotrasen_lab/inside)
"EF" = (
/turf/closed/mineral/smooth/bigred,
/area/bigredv2/caves/rock)
"EK" = (
/obj/machinery/atmospherics/pipe/manifold/green/hidden{
	dir = 1
	},
/obj/effect/ai_node,
/turf/open/floor/tile/dark,
/area/bigredv2/outside/nanotrasen_lab/inside)
"EW" = (
/turf/closed/wall/r_wall,
/area/bigredv2/outside/nanotrasen_lab/inside)
"Gm" = (
/obj/effect/decal/cleanable/dirt,
/turf/open/floor/tile/dark/red2/corner{
	dir = 8
	},
/area/bigredv2/outside/nanotrasen_lab/inside)
"Hc" = (
/turf/open/floor/tile/dark/red2/corner{
	dir = 4
	},
/area/bigredv2/outside/nanotrasen_lab/inside)
"HO" = (
/obj/machinery/atmospherics/pipe/simple/green/hidden{
	dir = 4
	},
/obj/effect/ai_node,
/turf/open/floor/tile/dark,
/area/bigredv2/outside/nanotrasen_lab/inside)
"IA" = (
/obj/machinery/light{
	dir = 4
	},
/obj/effect/decal/cleanable/dirt,
/obj/effect/ai_node,
/turf/open/floor/tile/dark/red2/corner,
/area/bigredv2/outside/nanotrasen_lab/inside)
"Jq" = (
/obj/structure/bed/chair{
	dir = 4
	},
/obj/effect/landmark/excavation_site_spawner,
/turf/open/floor/tile/dark/red2{
	dir = 4
	},
/area/bigredv2/outside/nanotrasen_lab/inside)
"JI" = (
/obj/item/target,
/turf/open/floor/tile/dark/red2{
	dir = 1
	},
/area/bigredv2/outside/nanotrasen_lab/inside)
"KI" = (
/turf/open/floor/tile/dark/red2{
	dir = 6
	},
/area/bigredv2/outside/nanotrasen_lab/inside)
"KO" = (
/obj/machinery/light,
/turf/open/floor/tile/darkgreen/darkgreen2,
/area/bigredv2/outside/nanotrasen_lab/inside)
"Lv" = (
/obj/machinery/light{
	dir = 4
	},
/turf/open/ground/jungle/clear,
/area/bigredv2/outside/nanotrasen_lab/inside)
"LO" = (
/obj/structure/table,
/obj/effect/spawner/random/engineering/technology_scanner,
/turf/open/floor/tile/dark/red2/corner{
	dir = 4
	},
/area/bigredv2/outside/nanotrasen_lab/inside)
"LR" = (
/obj/structure/closet/l3closet/scientist,
/turf/open/floor/tile/darkgreen/darkgreen2{
	dir = 9
	},
/area/bigredv2/outside/nanotrasen_lab/inside)
"MK" = (
/obj/structure/cable,
/turf/open/floor/plating,
/area/bigredv2/outside/nanotrasen_lab/inside)
"NJ" = (
/turf/closed/mineral/smooth/bigred/indestructible,
/area/space)
"NW" = (
/turf/closed/wall,
/area/bigredv2/outside/nanotrasen_lab/inside)
"Og" = (
/obj/machinery/atmospherics/components/unary/vent_pump{
	dir = 1;
	on = 1
	},
/turf/open/floor/tile/dark,
/area/bigredv2/outside/nanotrasen_lab/inside)
"OF" = (
/obj/machinery/door/airlock/mainship/research/glass/free_access{
	name = "\improper Eta Lab Cell"
	},
/turf/open/floor/tile/dark,
/area/bigredv2/outside/nanotrasen_lab/inside)
"OP" = (
/turf/open/floor/tile/darkgreen/darkgreen2{
	dir = 10
	},
/area/bigredv2/outside/nanotrasen_lab/inside)
"PJ" = (
/obj/structure/window/framed/colony,
/turf/open/floor/plating,
/area/bigredv2/outside/nanotrasen_lab/inside)
"Sf" = (
/obj/structure/cable,
/obj/effect/ai_node,
/turf/open/floor/plating,
/area/bigredv2/outside/nanotrasen_lab/inside)
"Sq" = (
/obj/structure/closet/l3closet/scientist,
/turf/open/floor/tile/darkgreen/darkgreen2{
	dir = 5
	},
/area/bigredv2/outside/nanotrasen_lab/inside)
"TQ" = (
/obj/effect/decal/cleanable/blood/gibs,
/turf/open/floor/plating/ground/mars/random/cave,
/area/bigredv2/caves/south)
"TS" = (
/obj/structure/table,
/obj/machinery/light,
/obj/effect/spawner/random/engineering/technology_scanner,
/obj/item/xenos_claw,
/turf/open/floor/tile/dark/red2/corner{
	dir = 8
	},
/area/bigredv2/outside/nanotrasen_lab/inside)
"Un" = (
/turf/open/floor/tile/dark/red2/corner{
	dir = 8
	},
/area/bigredv2/outside/nanotrasen_lab/inside)
"Uo" = (
/obj/structure/closet/crate/secure,
/turf/open/floor/tile/dark/red2/corner,
/area/bigredv2/outside/nanotrasen_lab/inside)
"UB" = (
/turf/open/floor/tile/dark,
/area/bigredv2/outside/nanotrasen_lab/inside)
"UG" = (
/obj/effect/landmark/lv624/fog_blocker/xeno_spawn,
/turf/open/floor/plating/ground/mars/random/cave/rock,
/area/bigredv2/caves/south)
"VX" = (
/obj/effect/spawner/random/engineering/structure/tank/fuelweighted,
/turf/open/floor/plating,
/area/bigredv2/outside/nanotrasen_lab/inside)
"Wn" = (
/obj/structure/closet/firecloset,
/turf/open/floor/plating,
/area/bigredv2/outside/nanotrasen_lab/inside)
"WX" = (
/obj/structure/table,
/obj/effect/spawner/random/engineering/technology_scanner,
/turf/open/floor/tile/dark/red2/corner{
	dir = 8
	},
/area/bigredv2/outside/nanotrasen_lab/inside)
"XD" = (
/turf/open/floor/tile/dark/red2{
	dir = 10
	},
/area/bigredv2/outside/nanotrasen_lab/inside)
"Yz" = (
/obj/structure/cable,
/obj/machinery/door/airlock/mainship/maint/free_access{
	name = "\improper Eta Lab Maintenance Storage"
	},
/turf/open/floor/tile/dark,
/area/bigredv2/outside/nanotrasen_lab/inside)
"YO" = (
/obj/machinery/light{
	dir = 8
	},
/turf/open/floor/plating/ground/mars/random/sand,
/area/bigredv2/outside/nanotrasen_lab/inside)
"YU" = (
/obj/structure/xenoautopsy/tank,
/turf/open/floor/tile/dark/red2/corner{
	dir = 8
	},
/area/bigredv2/outside/nanotrasen_lab/inside)
"Zi" = (
/obj/effect/ai_node,
/turf/open/floor/plating/ground/mars/random/cave/rock,
/area/bigredv2/caves/south)
"Zl" = (
/obj/effect/ai_node,
/turf/open/ground/jungle/clear,
/area/bigredv2/outside/nanotrasen_lab/inside)

(1,1,1) = {"
NJ
NJ
NJ
NJ
NJ
NJ
NJ
NJ
NJ
NJ
NJ
NJ
NJ
NJ
NJ
NJ
NJ
NJ
NJ
NJ
NJ
NJ
NJ
NJ
NJ
NJ
NJ
NJ
NJ
NJ
NJ
NJ
NJ
NJ
NJ
NJ
NJ
NJ
"}
(2,1,1) = {"
NJ
NJ
NJ
NJ
NJ
NJ
NJ
NJ
NJ
NJ
NJ
NJ
NJ
NJ
NJ
NJ
NJ
NJ
NJ
NJ
NJ
NJ
NJ
NJ
NJ
NJ
NJ
NJ
NJ
NJ
NJ
NJ
NJ
NJ
NJ
NJ
NJ
NJ
"}
(3,1,1) = {"
NJ
NJ
NJ
NJ
NJ
NJ
NJ
NJ
NJ
NJ
NJ
NJ
NJ
NJ
NJ
NJ
NJ
NJ
NJ
NJ
NJ
NJ
NJ
NJ
NJ
NJ
NJ
NJ
NJ
NJ
NJ
NJ
NJ
NJ
NJ
NJ
NJ
NJ
"}
(4,1,1) = {"
NJ
NJ
NJ
NJ
NJ
NJ
NJ
NJ
NJ
NJ
NJ
NJ
NJ
NJ
NJ
NJ
NJ
NJ
NJ
NJ
NJ
NJ
NJ
NJ
NJ
NJ
NJ
NJ
NJ
NJ
NJ
NJ
NJ
NJ
NJ
NJ
NJ
NJ
"}
(5,1,1) = {"
NJ
NJ
NJ
NJ
NJ
NJ
NJ
NJ
NJ
NJ
NJ
NJ
NJ
NJ
NJ
NJ
NJ
NJ
NJ
NJ
NJ
NJ
NJ
NJ
NJ
NJ
NJ
NJ
NJ
NJ
NJ
NJ
NJ
NJ
NJ
NJ
NJ
NJ
"}
(6,1,1) = {"
NJ
NJ
NJ
NJ
NJ
NJ
NJ
NJ
NJ
NJ
NJ
NJ
NJ
NJ
NJ
NJ
NJ
NJ
NJ
NJ
NJ
NJ
NJ
NJ
NJ
NJ
NJ
NJ
NJ
NJ
NJ
NJ
NJ
NJ
NJ
NJ
NJ
NJ
"}
(7,1,1) = {"
NJ
NJ
NJ
NJ
NJ
NJ
NJ
NJ
NJ
NJ
NJ
NJ
NJ
NJ
NJ
NJ
NJ
NJ
NJ
NJ
NJ
NJ
NJ
NJ
NJ
NJ
NJ
NJ
NJ
NJ
NJ
NJ
NJ
NJ
NJ
NJ
NJ
NJ
"}
(8,1,1) = {"
NJ
NJ
NJ
NJ
NJ
NJ
NJ
NJ
NJ
NJ
NJ
NJ
NJ
NJ
NJ
NJ
NJ
NJ
NJ
NJ
NJ
NJ
NJ
NJ
NJ
NJ
NJ
NJ
NJ
NJ
NJ
NJ
NJ
NJ
NJ
NJ
NJ
NJ
"}
(9,1,1) = {"
NJ
NJ
NJ
NJ
NJ
NJ
NJ
NJ
NJ
NJ
NJ
NJ
NJ
NJ
NJ
NJ
NJ
NJ
NJ
NJ
NJ
NJ
NJ
NJ
NJ
NJ
NJ
NJ
NJ
NJ
NJ
NJ
NJ
NJ
NJ
NJ
NJ
NJ
"}
(10,1,1) = {"
NJ
NJ
NJ
NJ
NJ
NJ
NJ
NJ
NJ
NJ
NJ
NJ
NJ
NJ
NJ
NJ
NJ
NJ
NJ
NJ
NJ
NJ
NJ
NJ
NJ
NJ
NJ
NJ
NJ
NJ
NJ
NJ
NJ
NJ
NJ
NJ
NJ
NJ
"}
(11,1,1) = {"
NJ
NJ
NJ
NJ
NJ
NJ
NJ
NJ
NJ
NJ
NJ
NJ
NJ
NJ
NJ
NJ
NJ
NJ
NJ
NJ
NJ
NJ
NJ
NJ
NJ
NJ
NJ
NJ
NJ
NJ
NJ
NJ
NJ
NJ
NJ
NJ
NJ
NJ
"}
(12,1,1) = {"
NJ
NJ
NJ
NJ
NJ
NJ
NJ
NJ
NJ
NJ
NJ
NJ
NJ
NJ
NJ
NJ
NJ
NJ
NJ
NJ
NJ
NJ
NJ
NJ
NJ
NJ
NJ
NJ
NJ
NJ
NJ
NJ
NJ
NJ
NJ
NJ
NJ
NJ
"}
(13,1,1) = {"
NJ
NJ
NJ
NJ
NJ
NJ
NJ
NJ
NJ
NJ
NJ
NJ
NJ
NJ
NJ
NJ
NJ
NJ
NJ
NJ
NJ
NJ
NJ
NJ
NJ
NJ
NJ
NJ
NJ
NJ
NJ
NJ
NJ
NJ
NJ
NJ
NJ
NJ
"}
(14,1,1) = {"
NJ
NJ
NJ
NJ
NJ
NJ
NJ
NJ
NJ
NJ
NJ
NJ
NJ
NJ
NJ
NJ
NJ
NJ
NJ
NJ
NJ
NJ
NJ
NJ
NJ
NJ
NJ
NJ
NJ
NJ
NJ
NJ
NJ
NJ
NJ
NJ
NJ
NJ
"}
(15,1,1) = {"
NJ
NJ
NJ
NJ
NJ
NJ
NJ
NJ
NJ
NJ
NJ
NJ
NJ
NJ
NJ
NJ
NJ
NJ
NJ
NJ
NJ
NJ
NJ
NJ
NJ
NJ
NJ
NJ
NJ
NJ
NJ
NJ
NJ
NJ
NJ
NJ
NJ
NJ
"}
(16,1,1) = {"
NJ
NJ
NJ
NJ
NJ
NJ
NJ
NJ
NJ
NJ
NJ
NJ
NJ
NJ
NJ
NJ
NJ
NJ
NJ
NJ
NJ
NJ
NJ
NJ
NJ
NJ
NJ
NJ
NJ
NJ
NJ
NJ
NJ
NJ
NJ
NJ
NJ
NJ
"}
(17,1,1) = {"
NJ
NJ
NJ
NJ
NJ
NJ
NJ
NJ
NJ
NJ
NJ
NJ
NJ
NJ
NJ
NJ
NJ
NJ
NJ
NJ
NJ
NJ
NJ
NJ
NJ
NJ
NJ
NJ
NJ
NJ
NJ
NJ
NJ
NJ
NJ
NJ
NJ
NJ
"}
(18,1,1) = {"
NJ
NJ
NJ
NJ
NJ
NJ
NJ
NJ
NJ
NJ
NJ
NJ
NJ
NJ
NJ
NJ
NJ
NJ
NJ
NJ
NJ
NJ
NJ
NJ
NJ
NJ
NJ
NJ
NJ
NJ
NJ
NJ
NJ
NJ
NJ
NJ
NJ
NJ
"}
(19,1,1) = {"
NJ
NJ
NJ
NJ
NJ
NJ
NJ
NJ
NJ
NJ
NJ
NJ
NJ
NJ
NJ
NJ
NJ
NJ
NJ
NJ
NJ
NJ
NJ
NJ
NJ
NJ
NJ
NJ
NJ
NJ
NJ
NJ
NJ
NJ
NJ
NJ
NJ
NJ
"}
(20,1,1) = {"
NJ
NJ
NJ
NJ
NJ
NJ
NJ
NJ
NJ
NJ
NJ
NJ
NJ
NJ
NJ
NJ
NJ
NJ
NJ
NJ
NJ
NJ
NJ
NJ
NJ
NJ
NJ
NJ
NJ
NJ
NJ
NJ
NJ
NJ
NJ
NJ
NJ
NJ
"}
(21,1,1) = {"
NJ
NJ
NJ
NJ
NJ
NJ
NJ
NJ
NJ
NJ
NJ
NJ
NJ
NJ
NJ
NJ
NJ
NJ
NJ
NJ
NJ
NJ
NJ
NJ
NJ
NJ
NJ
NJ
NJ
NJ
NJ
NJ
NJ
NJ
NJ
NJ
NJ
NJ
"}
(22,1,1) = {"
NJ
NJ
NJ
NJ
NJ
NJ
NJ
NJ
NJ
NJ
NJ
NJ
NJ
NJ
NJ
NJ
NJ
NJ
NJ
NJ
NJ
NJ
NJ
NJ
NJ
NJ
NJ
NJ
NJ
NJ
NJ
NJ
NJ
NJ
NJ
NJ
NJ
NJ
"}
(23,1,1) = {"
NJ
NJ
NJ
NJ
NJ
NJ
NJ
NJ
NJ
NJ
NJ
NJ
NJ
NJ
NJ
NJ
NJ
NJ
NJ
NJ
NJ
NJ
NJ
NJ
NJ
NJ
NJ
NJ
NJ
NJ
NJ
NJ
NJ
NJ
NJ
NJ
NJ
NJ
"}
(24,1,1) = {"
NJ
NJ
NJ
NJ
NJ
NJ
NJ
NJ
NJ
NJ
NJ
NJ
NJ
NJ
NJ
NJ
NJ
NJ
NJ
NJ
NJ
NJ
NJ
NJ
NJ
NJ
NJ
NJ
NJ
NJ
NJ
NJ
NJ
NJ
NJ
NJ
NJ
NJ
"}
(25,1,1) = {"
NJ
NJ
NJ
NJ
NJ
NJ
NJ
NJ
NJ
NJ
NJ
NJ
NJ
NJ
NJ
NJ
NJ
NJ
NJ
NJ
NJ
NJ
NJ
NJ
NJ
NJ
NJ
NJ
NJ
NJ
NJ
NJ
NJ
NJ
NJ
NJ
NJ
NJ
"}
(26,1,1) = {"
NJ
NJ
NJ
NJ
NJ
NJ
NJ
NJ
NJ
NJ
NJ
NJ
NJ
NJ
NJ
NJ
NJ
NJ
NJ
NJ
NJ
NJ
NJ
NJ
NJ
NJ
NJ
NJ
NJ
NJ
NJ
NJ
NJ
NJ
NJ
NJ
NJ
NJ
"}
(27,1,1) = {"
NJ
NJ
NJ
NJ
NJ
NJ
NJ
NJ
NJ
NJ
NJ
NJ
NJ
NJ
NJ
NJ
NJ
NJ
NJ
NJ
NJ
NJ
NJ
NJ
NJ
NJ
NJ
NJ
NJ
NJ
NJ
NJ
NJ
NJ
NJ
NJ
NJ
NJ
"}
(28,1,1) = {"
NJ
NJ
NJ
NJ
NJ
NJ
NJ
NJ
NJ
NJ
NJ
NJ
NJ
NJ
NJ
NJ
NJ
NJ
NJ
NJ
NJ
NJ
NJ
NJ
NJ
NJ
NJ
NJ
NJ
NJ
NJ
NJ
NJ
NJ
NJ
NJ
NJ
NJ
"}
(29,1,1) = {"
NJ
NJ
NJ
NJ
NJ
NJ
NJ
NJ
NJ
NJ
NJ
NJ
NJ
NJ
NJ
NJ
NJ
NJ
NJ
NJ
NJ
NJ
NJ
NJ
NJ
NJ
NJ
NJ
NJ
NJ
NJ
NJ
NJ
NJ
NJ
NJ
NJ
NJ
"}
(30,1,1) = {"
EF
EF
EF
EF
EF
EF
EF
EF
EF
EF
EF
EF
EF
EF
EF
EF
EF
EF
EF
EF
EF
EF
EF
EF
EF
EF
EF
EF
EF
EF
EF
EF
EF
EF
EF
EF
EF
NJ
"}
(31,1,1) = {"
EF
EF
iu
iu
iu
iu
iu
iu
iu
iu
iu
iu
iu
iu
iu
EF
EF
EF
EF
EF
EF
EF
EF
EF
EF
EF
EF
EF
EF
EF
EF
EF
EF
EF
EF
EF
EF
NJ
"}
(32,1,1) = {"
EF
EF
iu
EF
EF
EF
EF
EF
EF
lQ
lQ
EF
EF
EF
iu
EF
EF
EF
EF
EF
EF
EF
EF
EF
EF
EF
EF
EF
EF
EF
EF
EF
EF
EF
EF
EF
EF
NJ
"}
(33,1,1) = {"
EF
EF
iu
EF
EF
EF
EF
EF
lQ
eC
eC
lQ
EF
EF
iu
EF
EF
EF
EF
EF
EF
EF
EF
EF
EF
EF
EF
EF
EF
EF
EF
EF
EF
EF
EF
EF
EF
NJ
"}
(34,1,1) = {"
EF
EF
iu
EF
EF
EF
EF
lQ
eC
eC
pW
eC
lQ
lQ
iu
EF
EF
EF
EF
EF
EF
EF
EF
EF
EF
EF
EF
EF
EF
EF
EF
EF
EF
EF
EF
EF
EF
NJ
"}
(35,1,1) = {"
EF
EF
iu
EF
EF
EF
lQ
eC
eC
ym
eC
eC
eC
lQ
iu
EF
EF
EF
EF
EF
EF
EF
EF
EF
EF
EF
EF
EF
EF
EF
EF
EF
EF
EF
EF
EF
EF
NJ
"}
(36,1,1) = {"
EF
EF
iu
EF
EF
EF
eC
eC
eC
eC
eC
eC
eC
eC
iu
EF
EF
EF
EF
EF
EF
EF
EF
EF
EF
EF
EF
EF
EF
EF
EF
EF
EF
EF
EF
EF
EF
NJ
"}
(37,1,1) = {"
EF
EF
iu
EF
eC
eC
eC
iZ
eC
eC
eC
eC
eC
eC
iu
EF
EF
EF
EF
EF
EF
EF
EF
EF
EF
EF
EF
EF
EF
EF
EF
EF
EF
EF
EF
EF
EF
NJ
"}
(38,1,1) = {"
EF
EF
iu
eC
eC
eC
eC
eC
eC
eC
eC
eC
eC
eC
hJ
eC
EF
EF
EF
EF
EF
EF
EF
EF
EF
EF
EF
EF
EF
EF
EF
EF
EF
EF
EF
EF
EF
NJ
"}
(39,1,1) = {"
eC
eC
hJ
eC
eC
eC
eC
eC
eC
eC
eC
eC
eC
eC
hJ
eC
eC
eC
eC
eC
eC
eC
EF
EF
EF
EF
EF
EF
EF
EF
EF
EF
EF
EF
EF
EF
EF
NJ
"}
(40,1,1) = {"
eC
lQ
hJ
eC
lQ
lQ
eC
eC
eC
eC
eC
lQ
eC
eC
hJ
eC
eC
eC
eC
eC
eC
eC
eC
EF
EF
EF
EF
EF
EF
EF
EF
EF
EF
EF
EF
EF
EF
NJ
"}
(41,1,1) = {"
eC
eC
hJ
eC
eC
eC
eC
eC
eC
ym
eC
eC
lQ
lQ
UG
lQ
lQ
lQ
eC
lQ
Zi
lQ
eC
eC
eC
ym
EF
EF
EF
EF
EF
EF
EF
EF
EF
EF
EF
NJ
"}
(42,1,1) = {"
eC
eC
hJ
eC
eC
eC
eC
eC
eC
eC
eC
eC
eC
eC
hJ
eC
eC
eC
eC
eC
eC
eC
lQ
eC
eC
eC
eC
EF
EF
EF
EF
EF
EF
EF
EF
EF
EF
NJ
"}
(43,1,1) = {"
eC
EF
iu
EF
EF
EF
EF
lQ
eC
eC
eC
eC
eC
eC
hJ
eC
eC
eC
eC
eC
eC
eC
eC
eC
eC
eC
eC
eC
EF
EF
EF
EF
EF
EF
EF
EF
EF
NJ
"}
(44,1,1) = {"
EF
EF
iu
iu
iu
iu
iu
iu
iu
iu
iu
iu
iu
iu
iu
EF
EF
eC
EF
EF
lQ
lQ
EF
lQ
eC
eC
eC
eC
EF
EF
EF
EF
EF
EF
EF
EF
EF
NJ
"}
(45,1,1) = {"
EF
EF
EF
EF
EF
EF
EF
EF
EF
EF
EF
EF
EF
EF
EF
EF
EF
EF
EF
EF
EF
EF
EF
EF
eC
eC
eC
eC
eC
EF
EF
EF
EF
EF
EF
EF
EF
NJ
"}
(46,1,1) = {"
bt
bt
bt
bt
bt
bt
bt
bt
bt
bt
bt
bt
bt
bt
bt
bt
bt
bt
bt
bt
bt
bt
EF
EF
EF
eC
eC
eC
eC
eC
EF
EF
EF
EF
EF
EF
EF
NJ
"}
(47,1,1) = {"
EW
EW
EW
EW
EW
EW
EW
EW
EW
EW
EW
EW
EW
EW
EW
EW
EW
EW
EW
EW
EW
EW
qt
EF
EF
eC
eC
eC
eC
eC
eC
EF
EF
EF
EF
EF
EF
NJ
"}
(48,1,1) = {"
aj
qZ
qZ
XD
EW
YU
En
oL
oL
oL
EW
pz
YO
pz
EW
pz
YO
pz
EW
pz
YO
pz
qt
EF
EF
ym
eC
iZ
eC
eC
eC
EF
EF
EF
EF
EF
EF
NJ
"}
(49,1,1) = {"
Aq
ju
UB
UB
DB
UB
UB
ju
UB
Gm
EW
pz
rW
pz
EW
pz
rW
pz
EW
pz
rW
pz
qt
EF
EF
eC
eC
eC
eC
eC
eC
EF
EF
EF
EF
EF
EF
NJ
"}
(50,1,1) = {"
Aq
UB
UB
zV
EW
Hc
Eq
Eq
Eq
WX
EW
pz
pz
pz
EW
pz
pz
pz
EW
pz
pz
pz
qt
EF
EF
eC
eC
eC
eC
eC
eC
EF
EF
EF
EF
EF
EF
NJ
"}
(51,1,1) = {"
JI
UB
UB
zV
br
dk
Eq
Eq
UB
TS
EW
br
OF
br
EW
br
OF
br
EW
br
OF
br
qt
EF
EF
eC
eC
lQ
eC
eC
eC
eC
EF
EF
EF
EF
EF
NJ
"}
(52,1,1) = {"
Aq
UB
UB
zV
br
LO
Eq
Eq
UB
Un
NW
gA
Eq
gA
NW
gA
UB
gA
NW
gA
UB
gA
qt
EF
EF
eC
eC
yU
eC
eC
eC
eC
eC
EF
EF
EF
EF
NJ
"}
(53,1,1) = {"
JI
UB
UB
zV
br
vm
UB
Eq
Eq
UB
Un
Gm
UB
Un
gh
Un
UB
Un
Un
Un
Eq
Un
qt
EF
uH
eC
eC
lQ
eC
eC
eC
eC
eC
EF
EF
EF
EF
NJ
"}
(54,1,1) = {"
Aq
ju
UB
zV
br
fU
UB
kj
Eq
Eq
UB
Eq
Eq
Eq
UB
Eq
Eq
Eq
UB
Eq
UB
Eq
qt
eC
uH
eC
eC
lQ
eC
eC
eC
eC
eC
EF
EF
EF
EF
NJ
"}
(55,1,1) = {"
Aq
UB
UB
zV
br
cB
UB
HO
Eq
Eq
IA
eH
qR
eH
eH
eH
qR
eH
IA
uL
ju
uL
qt
eC
uH
ym
eC
eC
eC
eC
eC
eC
ym
EF
EF
EF
EF
NJ
"}
(56,1,1) = {"
AF
EC
EC
KI
br
AQ
uL
rh
uL
Uo
NW
xk
UB
Jq
NW
xk
UB
xk
NW
xk
Eq
xk
qt
EF
tQ
eC
eC
eC
eC
eC
eC
eC
eC
eC
EF
EF
EF
NJ
"}
(57,1,1) = {"
EW
EW
EW
EW
EW
NW
PJ
Bp
PJ
NW
EW
br
OF
br
EW
br
OF
br
EW
br
OF
br
qt
EF
EF
EF
EF
eC
eC
eC
eC
eC
eC
eC
EF
EF
EF
NJ
"}
(58,1,1) = {"
VX
MK
MK
gG
NW
LR
tI
rh
tI
OP
EW
uM
uM
uM
EW
uM
uM
uM
EW
uM
uM
uM
qt
EF
EF
EF
EF
eC
EF
EF
eC
eC
eC
eC
eC
EF
EF
NJ
"}
(59,1,1) = {"
VX
Sf
oH
Wn
NW
zr
UB
EK
Og
KO
EW
uM
Zl
uM
EW
uM
Zl
uM
EW
uM
Zl
uM
qt
EF
EF
EF
EF
EF
EF
EF
EF
eC
eC
eC
eC
EF
EF
NJ
"}
(60,1,1) = {"
VX
MK
oH
rx
NW
Sq
zf
rh
zf
mS
EW
uM
Lv
uM
EW
uM
Lv
uM
EW
uM
Lv
uM
qt
bt
bt
bt
bt
bt
bt
bt
EF
eC
ym
TQ
eC
EF
EF
NJ
"}
(61,1,1) = {"
NW
Yz
NW
NW
NW
NW
PJ
Bp
PJ
NW
EW
EW
EW
EW
EW
EW
EW
EW
EW
EW
EW
EW
EW
EW
EW
EW
EW
EW
EW
bt
EF
eC
eC
eC
eC
EF
EF
NJ
"}
