//MAP CONVERTED BY dmm2tgm.py THIS HEADER COMMENT PREVENTS RECONVERSION, DO NOT REMOVE
"b" = (
/obj/machinery/chem_dispenser,
/turf/open/floor/tile/whiteyellow{
	dir = 1
	},
/area/bigredv2/caves/lambda_lab)
"c" = (
/obj/effect/ai_node,
/obj/effect/landmark/excavation_site_spawner,
/turf/open/floor/plating/ground/mars/random/cave,
/area/bigredv2/caves/northeast)
"g" = (
/turf/closed/wall/r_wall,
/area/bigredv2/caves/rock)
"h" = (
/obj/effect/landmark/excavation_site_spawner,
/turf/open/floor/plating/ground/mars/random/cave,
/area/bigredv2/caves/northeast)
"j" = (
/obj/machinery/chem_dispenser,
/turf/open/floor/tile/whiteyellow{
	dir = 9
	},
/area/bigredv2/caves/lambda_lab)
"n" = (
/obj/structure/closet/crate/freezer/rations,
/turf/open/floor/plating,
/area/bigredv2/caves/lambda_lab)
"o" = (
/turf/closed/wall/r_wall,
/area/bigredv2/caves/lambda_lab)
"p" = (
/obj/effect/ai_node,
/turf/open/floor/plating/ground/mars/random/cave,
/area/bigredv2/caves/northeast)
"q" = (
/turf/open/floor/plating,
/area/bigredv2/caves/lambda_lab)
"v" = (
/turf/open/floor/plating/ground/mars/random/cave,
/area/bigredv2/caves/northeast)
"A" = (
/turf/closed/mineral/smooth/bigred/indestructible,
/area/space)
"B" = (
/obj/machinery/chem_master,
/turf/open/floor/tile/whiteyellow{
	dir = 5
	},
/area/bigredv2/caves/lambda_lab)
"D" = (
/obj/structure/closet/crate/internals,
/turf/open/floor/plating,
/area/bigredv2/caves/lambda_lab)
"E" = (
/turf/open/floor/plating/ground/mars/random/cave,
/area/bigredv2/caves/northeast/garbledradio)
"G" = (
/turf/closed/mineral/smooth/bigred,
/area/bigredv2/caves/rock)
"H" = (
/obj/structure/fence/standard,
/turf/open/floor/plating/ground/mars/random/cave,
/area/bigredv2/caves/northeast)
"K" = (
/turf/open/floor/plating/ground/mars/random/cave/rock,
/area/bigredv2/caves/northeast/garbledradio)
"L" = (
/obj/effect/ai_node,
/turf/open/floor/plating/ground/mars/random/cave,
/area/bigredv2/caves/northeast/garbledradio)
"U" = (
/obj/effect/landmark/lv624/fog_blocker,
/turf/open/floor/plating/ground/mars/random/cave,
/area/bigredv2/caves/northeast)
"V" = (
/obj/effect/landmark/lv624/fog_blocker,
/turf/closed/mineral/smooth/bigred,
/area/bigredv2/caves/rock)
"W" = (
/obj/machinery/miner/damaged/platinum,
/turf/open/floor/plating/ground/mars/random/cave,
/area/bigredv2/caves/northeast)
"X" = (
/turf/open/floor/plating/ground/mars/random/cave/rock,
/area/bigredv2/caves/northeast)

(1,1,1) = {"
A
A
A
A
A
A
A
A
A
A
A
A
A
A
A
A
A
A
A
A
G
G
G
G
G
E
E
E
E
K
G
G
"}
(2,1,1) = {"
A
A
A
A
A
A
A
A
A
A
A
A
A
A
A
A
A
A
A
A
G
G
G
K
K
E
E
E
E
K
G
G
"}
(3,1,1) = {"
A
A
A
A
A
A
A
A
A
A
A
A
A
A
A
A
A
A
A
A
G
G
G
E
E
E
E
E
E
K
G
G
"}
(4,1,1) = {"
A
A
A
A
A
A
A
A
A
A
A
A
A
A
A
A
A
A
A
A
G
G
G
E
E
E
E
E
E
E
K
G
"}
(5,1,1) = {"
A
A
A
A
A
A
A
A
A
A
A
A
A
A
A
A
A
A
A
A
G
G
G
E
L
E
E
E
E
L
K
G
"}
(6,1,1) = {"
A
A
A
A
A
A
A
A
A
A
A
A
A
A
A
A
A
A
A
A
G
G
G
K
E
E
E
E
E
E
K
G
"}
(7,1,1) = {"
A
A
A
A
A
A
A
A
A
A
A
A
A
A
A
A
A
A
A
A
G
G
G
G
G
K
E
E
E
E
K
G
"}
(8,1,1) = {"
A
A
A
A
A
A
A
A
A
A
A
A
A
A
A
A
A
A
A
A
G
G
G
G
G
G
E
E
E
E
E
K
"}
(9,1,1) = {"
A
A
A
A
A
A
A
A
A
A
A
A
A
A
A
A
A
A
A
A
G
G
G
G
G
G
K
E
E
E
E
E
"}
(10,1,1) = {"
A
A
A
A
A
A
A
A
A
A
A
A
A
A
A
A
A
A
A
A
G
G
G
G
G
G
G
K
E
L
E
E
"}
(11,1,1) = {"
A
A
A
A
A
A
A
A
A
A
A
A
A
A
A
A
A
A
A
A
G
G
G
G
G
G
G
G
G
E
L
E
"}
(12,1,1) = {"
A
A
A
A
A
A
A
A
A
A
A
A
A
A
A
A
A
A
A
A
G
G
G
G
G
G
G
G
G
K
E
L
"}
(13,1,1) = {"
A
A
A
A
A
A
A
A
A
A
A
A
A
A
A
A
A
A
A
A
G
G
G
G
G
G
G
G
G
G
G
G
"}
(14,1,1) = {"
A
A
A
A
A
A
A
A
A
A
A
A
A
A
A
A
A
A
A
A
G
G
G
G
G
G
G
G
G
G
G
G
"}
(15,1,1) = {"
A
A
A
A
A
A
A
A
A
A
A
A
A
A
A
A
A
A
A
A
G
G
G
G
G
G
G
g
g
g
g
g
"}
(16,1,1) = {"
A
A
A
A
A
A
A
A
A
A
A
A
A
A
A
A
A
A
A
A
G
G
G
G
G
G
G
g
E
E
E
E
"}
(17,1,1) = {"
A
A
A
A
A
A
A
A
A
A
A
A
A
A
A
A
A
A
A
A
G
G
G
G
G
G
G
g
E
E
E
E
"}
(18,1,1) = {"
A
A
A
A
A
A
A
A
A
A
A
A
A
A
A
A
A
A
A
A
G
G
G
G
G
G
G
g
E
E
E
L
"}
(19,1,1) = {"
A
A
A
A
A
A
A
A
A
A
A
A
A
A
A
A
A
A
A
A
G
G
G
G
G
G
G
E
E
E
E
E
"}
(20,1,1) = {"
A
A
A
A
A
A
A
A
A
A
A
A
A
A
A
A
A
A
A
A
G
G
G
G
G
G
h
v
v
E
E
E
"}
(21,1,1) = {"
A
A
A
A
A
A
A
A
A
A
A
A
A
A
A
A
A
A
A
A
G
G
G
G
G
G
v
v
v
v
E
E
"}
(22,1,1) = {"
A
A
A
A
A
A
A
A
A
A
A
A
A
A
A
A
A
A
A
A
G
G
G
G
G
v
v
v
v
v
E
E
"}
(23,1,1) = {"
A
A
A
A
A
A
A
A
A
A
A
A
A
A
A
A
A
A
A
A
G
G
G
G
G
v
p
v
v
v
E
L
"}
(24,1,1) = {"
A
A
A
A
A
A
A
A
A
A
A
A
A
A
A
A
A
A
A
A
G
G
G
G
v
v
v
v
v
v
E
E
"}
(25,1,1) = {"
A
A
A
A
A
A
A
A
A
A
A
A
A
A
A
A
A
A
A
A
G
G
G
v
v
v
v
v
v
E
E
E
"}
(26,1,1) = {"
A
A
A
A
A
A
A
A
A
A
A
A
A
A
A
A
A
A
A
A
G
G
G
v
v
v
v
v
v
v
E
G
"}
(27,1,1) = {"
A
A
A
A
A
A
A
A
A
A
A
A
A
A
A
A
A
A
A
A
G
G
v
v
v
v
v
v
v
v
G
G
"}
(28,1,1) = {"
A
A
A
A
A
A
A
A
A
A
A
A
A
A
A
A
A
A
A
A
G
G
p
v
v
v
p
v
v
v
G
V
"}
(29,1,1) = {"
A
A
A
A
A
A
A
A
A
A
A
A
A
A
A
A
A
A
A
A
G
G
v
v
v
v
v
v
v
G
V
G
"}
(30,1,1) = {"
A
A
A
A
A
A
A
A
A
A
A
A
A
A
A
A
A
A
A
A
G
G
G
v
v
v
v
v
G
V
G
G
"}
(31,1,1) = {"
A
A
A
A
A
A
A
A
A
A
A
A
A
A
A
A
A
A
A
A
G
G
G
v
v
v
v
v
G
V
G
o
"}
(32,1,1) = {"
A
A
A
A
A
A
A
A
A
A
A
A
A
A
A
A
A
A
A
A
G
G
G
v
v
v
v
v
G
V
G
o
"}
(33,1,1) = {"
A
A
A
A
A
A
A
A
A
A
A
A
A
A
A
A
A
A
A
A
G
G
G
v
v
v
p
v
G
V
G
o
"}
(34,1,1) = {"
A
A
A
A
A
A
A
A
A
A
A
A
A
A
A
A
A
A
A
A
G
G
G
v
v
v
v
v
G
V
G
o
"}
(35,1,1) = {"
A
A
A
A
A
A
A
A
A
A
A
A
A
A
A
A
A
A
A
A
G
G
G
v
v
v
v
v
G
V
G
o
"}
(36,1,1) = {"
A
A
A
A
A
A
A
A
A
A
A
A
A
A
A
A
A
A
A
A
G
G
G
v
v
v
v
v
G
V
G
G
"}
(37,1,1) = {"
A
A
A
A
A
A
A
A
A
A
A
A
A
A
A
A
A
A
A
A
G
G
G
v
v
v
v
v
G
V
G
G
"}
(38,1,1) = {"
A
A
A
A
A
A
A
A
A
A
A
A
A
A
A
A
A
A
A
A
G
G
G
v
v
v
v
v
G
V
G
G
"}
(39,1,1) = {"
A
A
A
A
A
A
A
A
A
A
A
A
A
A
A
A
A
A
A
A
G
G
G
v
v
v
v
v
G
V
o
o
"}
(40,1,1) = {"
A
A
A
A
A
A
A
A
A
A
A
A
A
A
A
A
A
A
A
A
G
G
G
v
v
v
v
v
G
V
o
q
"}
(41,1,1) = {"
A
A
A
A
A
A
A
A
A
A
A
A
A
A
A
A
A
A
A
A
G
G
G
v
v
v
v
v
G
V
o
D
"}
(42,1,1) = {"
A
A
A
A
A
A
A
A
A
A
A
A
A
A
A
A
A
A
A
A
G
G
G
v
v
v
v
v
G
V
o
n
"}
(43,1,1) = {"
A
A
A
A
A
A
A
A
A
A
A
A
A
A
A
A
A
A
A
A
G
G
G
v
v
v
p
v
G
V
o
o
"}
(44,1,1) = {"
A
A
A
A
A
A
A
A
A
A
A
A
A
A
A
A
A
A
A
A
G
G
G
v
v
v
v
v
H
V
o
j
"}
(45,1,1) = {"
A
A
A
A
A
A
A
A
A
A
A
A
A
A
A
A
A
A
A
A
G
G
G
v
v
v
v
v
H
U
o
b
"}
(46,1,1) = {"
A
A
A
A
A
A
A
A
A
A
A
A
A
A
A
A
A
A
A
A
G
G
G
v
v
v
v
v
H
U
o
b
"}
(47,1,1) = {"
A
A
A
A
A
A
A
A
A
A
A
A
A
A
A
A
A
A
A
A
G
G
G
v
v
v
v
v
G
V
o
B
"}
(48,1,1) = {"
A
A
A
A
A
A
A
A
A
A
A
A
A
A
A
A
A
A
A
A
G
G
G
G
v
v
v
v
G
V
o
o
"}
(49,1,1) = {"
A
A
A
A
A
A
A
A
A
A
A
A
A
A
A
A
A
A
A
A
G
G
G
G
v
v
v
v
G
G
V
o
"}
(50,1,1) = {"
A
A
A
A
A
A
A
A
A
A
A
A
A
A
A
A
A
A
A
A
G
G
G
G
v
v
v
v
v
v
G
V
"}
(51,1,1) = {"
A
A
A
A
A
A
A
A
A
A
A
A
A
A
A
A
A
A
A
A
G
G
G
G
G
v
v
c
v
v
v
X
"}
(52,1,1) = {"
A
A
A
A
A
A
A
A
A
A
A
A
A
A
A
A
A
A
A
A
G
G
G
G
G
v
p
v
v
v
p
v
"}
(53,1,1) = {"
A
A
A
A
A
A
A
A
A
A
A
A
A
A
A
A
A
A
A
A
G
G
G
G
G
G
v
v
v
v
v
v
"}
(54,1,1) = {"
A
A
A
A
A
A
A
A
A
A
A
A
A
A
A
A
A
A
A
A
G
G
G
G
G
G
v
v
v
v
v
v
"}
(55,1,1) = {"
A
A
A
A
A
A
A
A
A
A
A
A
A
A
A
A
A
A
A
A
G
G
G
G
G
G
G
v
W
v
v
v
"}
(56,1,1) = {"
A
A
A
A
A
A
A
A
A
A
A
A
A
A
A
A
A
A
A
A
G
G
G
G
G
G
G
v
v
v
v
v
"}
(57,1,1) = {"
A
A
A
A
A
A
A
A
A
A
A
A
A
A
A
A
A
A
A
A
G
G
G
G
G
G
G
v
v
v
v
v
"}
(58,1,1) = {"
A
A
A
A
A
A
A
A
A
A
A
A
A
A
A
A
A
A
A
A
G
G
G
G
G
G
G
v
v
v
p
v
"}
(59,1,1) = {"
A
A
A
A
A
A
A
A
A
A
A
A
A
A
A
A
A
A
A
A
G
G
G
G
G
G
G
v
v
v
v
v
"}
(60,1,1) = {"
A
A
A
A
A
A
A
A
A
A
A
A
A
A
A
A
A
A
A
A
G
G
G
G
G
G
G
G
v
v
p
v
"}
(61,1,1) = {"
A
A
A
A
A
A
A
A
A
A
A
A
A
A
A
A
A
A
A
A
G
G
G
G
G
G
G
G
G
v
v
v
"}
(62,1,1) = {"
A
A
A
A
A
A
A
A
A
A
A
A
A
A
A
A
A
A
A
A
G
G
G
G
G
G
G
G
G
v
v
v
"}
(63,1,1) = {"
A
A
A
A
A
A
A
A
A
A
A
A
A
A
A
A
A
A
A
A
G
G
G
G
G
G
G
G
G
v
v
v
"}
(64,1,1) = {"
A
A
A
A
A
A
A
A
A
A
A
A
A
A
A
A
A
A
A
A
G
G
G
G
G
G
G
G
G
v
v
v
"}
(65,1,1) = {"
A
A
A
A
A
A
A
A
A
A
A
A
A
A
A
A
A
A
A
A
G
G
G
G
G
G
G
G
G
v
v
v
"}
