//MAP CONVERTED BY dmm2tgm.py THIS HEADER COMMENT PREVENTS RECONVERSION, DO NOT REMOVE
"a" = (
/turf/closed/wall,
/area/bigredv3/inside/wall)
"b" = (
/obj/machinery/light{
	dir = 1
	},
/obj/effect/ai_node,
/turf/open/floor/wood,
/area/bigredv3/inside/colony/library)
"c" = (
/obj/structure/window/framed/colony,
/obj/machinery/door/poddoor/shutters/mainship{
	dir = 2;
	id = "Library";
	name = "\improper Library Shutters"
	},
/turf/open/floor/plating,
/area/bigredv3/inside/wall)
"d" = (
/obj/structure/cable,
/obj/machinery/atmospherics/pipe/simple/green/hidden{
	dir = 4
	},
/turf/open/floor/wood,
/area/bigredv3/inside/colony/library)
"e" = (
/turf/open/floor/carpet/side{
	dir = 1
	},
/area/bigredv3/inside/colony/library)
"f" = (
/turf/open/floor/carpet/side{
	dir = 9
	},
/area/bigredv3/inside/colony/library)
"h" = (
/obj/structure/cable,
/obj/machinery/atmospherics/pipe/simple/green/hidden{
	dir = 6
	},
/turf/open/floor/wood,
/area/bigredv3/inside/colony/library)
"i" = (
/obj/structure/cable,
/obj/machinery/atmospherics/pipe/simple/green/hidden{
	dir = 4
	},
/obj/machinery/door/airlock/mainship/generic{
	name = "\improper Library Backroom"
	},
/turf/open/floor/wood,
/area/bigredv3/inside/colony/library)
"j" = (
/obj/machinery/atmospherics/pipe/simple/green/hidden,
/obj/structure/cable,
/turf/open/floor/marking/asteroidwarning{
	dir = 8
	},
/area/bigredv3/outside/directions/e)
"k" = (
/obj/structure/bookcase,
/obj/machinery/light{
	dir = 1
	},
/turf/open/floor/wood,
/area/bigredv3/inside/colony/library)
"l" = (
/obj/machinery/power/apc/weak/ntf,
/obj/structure/cable,
/obj/effect/ai_node,
/turf/open/floor/wood,
/area/bigredv3/inside/colony/library)
"m" = (
/obj/machinery/atmospherics/pipe/manifold/green/hidden{
	dir = 4
	},
/obj/effect/ai_node,
/obj/structure/cable,
/turf/open/floor/wood,
/area/bigredv3/inside/colony/library)
"n" = (
/turf/open/floor/carpet/side{
	dir = 6
	},
/area/bigredv3/inside/colony/library)
"o" = (
/obj/structure/window/framed/colony,
/obj/machinery/door/poddoor/shutters/mainship{
	id = "Library";
	name = "\improper Library Shutters"
	},
/turf/open/floor/plating,
/area/bigredv3/inside/wall)
"p" = (
/turf/open/floor/carpet/side{
	dir = 5
	},
/area/bigredv3/inside/colony/library)
"q" = (
/obj/machinery/atmospherics/pipe/simple/green/hidden,
/obj/structure/cable,
/turf/open/floor/carpet,
/area/bigredv3/inside/colony/library)
"r" = (
/obj/machinery/atmospherics/pipe/simple/green/hidden,
/obj/machinery/door/airlock/multi_tile/mainship/generic{
	name = "\improper Library"
	},
/obj/structure/cable,
/turf/open/floor/wood,
/area/bigredv3/inside/colony/library)
"s" = (
/obj/structure/cable,
/obj/machinery/atmospherics/pipe/simple/green/hidden{
	dir = 9
	},
/turf/open/floor/wood,
/area/bigredv3/inside/colony/library)
"t" = (
/obj/machinery/atmospherics/pipe/simple/green/hidden{
	dir = 4
	},
/obj/structure/cable,
/turf/open/floor/wood,
/area/bigredv3/inside/colony/library)
"u" = (
/obj/structure/table/wood,
/obj/item/paper,
/turf/open/floor/wood,
/area/bigredv3/inside/colony/library)
"v" = (
/obj/machinery/atmospherics/pipe/simple/green/hidden{
	dir = 5
	},
/obj/structure/cable,
/turf/open/floor/carpet/side,
/area/bigredv3/inside/colony/library)
"w" = (
/turf/open/floor/wood,
/area/bigredv3/inside/colony/library)
"x" = (
/obj/machinery/door_control{
	dir = 8;
	id = "Library";
	name = "Storm Shutters"
	},
/turf/open/floor/wood,
/area/bigredv3/inside/colony/library)
"y" = (
/obj/structure/table/wood,
/turf/open/floor/wood,
/area/bigredv3/inside/colony/library)
"z" = (
/obj/machinery/atmospherics/pipe/simple/green/hidden,
/obj/structure/cable,
/turf/open/floor/wood,
/area/bigredv3/inside/colony/library)
"B" = (
/obj/machinery/atmospherics/pipe/simple/green/hidden,
/obj/effect/ai_node,
/obj/structure/cable,
/turf/open/floor/carpet/side{
	dir = 4
	},
/area/bigredv3/inside/colony/library)
"C" = (
/obj/structure/cable,
/obj/machinery/atmospherics/pipe/simple/green/hidden,
/turf/open/floor/wood,
/area/bigredv3/inside/colony/library)
"D" = (
/obj/structure/bed/chair/wood/normal,
/turf/open/floor/wood,
/area/bigredv3/inside/colony/library)
"E" = (
/turf/open/floor/carpet/side,
/area/bigredv3/inside/colony/library)
"F" = (
/obj/structure/bookcase,
/turf/open/floor/wood,
/area/bigredv3/inside/colony/library)
"H" = (
/obj/machinery/atmospherics/pipe/simple/green/hidden,
/obj/structure/cable,
/turf/open/floor/carpet/side{
	dir = 4
	},
/area/bigredv3/inside/colony/library)
"I" = (
/obj/machinery/atmospherics/pipe/simple/green/hidden,
/obj/structure/cable,
/turf/open/floor/carpet/side{
	dir = 5
	},
/area/bigredv3/inside/colony/library)
"K" = (
/obj/structure/table/wood,
/obj/item/toy/dice/d20,
/turf/open/floor/wood,
/area/bigredv3/inside/colony/library)
"L" = (
/obj/machinery/light{
	dir = 8
	},
/turf/open/floor/wood,
/area/bigredv3/inside/colony/library)
"M" = (
/obj/structure/bed/chair/wood/normal{
	dir = 1
	},
/turf/open/floor/wood,
/area/bigredv3/inside/colony/library)
"N" = (
/obj/effect/ai_node,
/turf/open/floor/wood,
/area/bigredv3/inside/colony/library)
"O" = (
/turf/open/floor/carpet/side{
	dir = 8
	},
/area/bigredv3/inside/colony/library)
"Q" = (
/obj/machinery/atmospherics/pipe/simple/green/hidden{
	dir = 10
	},
/obj/structure/cable,
/turf/open/floor/carpet/side,
/area/bigredv3/inside/colony/library)
"R" = (
/obj/machinery/light,
/turf/open/floor/wood,
/area/bigredv3/inside/colony/library)
"S" = (
/obj/machinery/light{
	dir = 4
	},
/turf/open/floor/wood,
/area/bigredv3/inside/colony/library)
"T" = (
/obj/machinery/atmospherics/pipe/simple/green/hidden{
	dir = 4
	},
/obj/structure/cable,
/obj/machinery/door/airlock/mainship/medical/glass/free_access{
	name = "\improper Greenhouse Storage"
	},
/turf/open/floor/wood,
/area/bigredv3/inside/colony/library)
"U" = (
/turf/open/floor/marking/asteroidwarning{
	dir = 4
	},
/area/bigredv3/outside/directions/e)
"V" = (
/obj/machinery/air_alarm{
	dir = 4
	},
/turf/open/floor/wood,
/area/bigredv3/inside/colony/library)
"W" = (
/obj/structure/cable,
/obj/machinery/atmospherics/components/unary/vent_pump{
	dir = 8;
	on = 1
	},
/turf/open/floor/wood,
/area/bigredv3/inside/colony/library)
"Y" = (
/turf/open/floor/carpet/side{
	dir = 10
	},
/area/bigredv3/inside/colony/library)
"Z" = (
/turf/open/floor/plating/ground/mars/random/dirt,
/area/bigredv3/outside/directions/e)

(1,1,1) = {"
a
a
a
a
T
a
a
a
a
a
a
a
a
a
a
a
a
a
"}
(2,1,1) = {"
a
F
w
w
t
F
L
F
V
F
L
F
w
F
L
w
a
Z
"}
(3,1,1) = {"
a
F
w
w
t
F
w
F
w
F
w
F
w
F
w
w
c
Z
"}
(4,1,1) = {"
a
w
w
w
d
f
O
O
O
O
O
O
O
O
Y
w
c
Z
"}
(5,1,1) = {"
a
k
N
h
m
I
H
H
H
H
H
B
H
q
v
R
a
Z
"}
(6,1,1) = {"
a
b
w
d
w
w
w
w
w
w
w
F
N
e
Q
z
r
j
"}
(7,1,1) = {"
a
h
C
s
x
w
D
u
K
M
w
w
w
e
E
w
w
U
"}
(8,1,1) = {"
a
i
a
a
a
w
D
y
y
M
w
F
w
e
E
R
a
Z
"}
(9,1,1) = {"
a
W
y
y
a
w
w
w
w
w
w
F
w
p
n
w
c
Z
"}
(10,1,1) = {"
a
l
S
w
a
S
w
w
w
S
w
w
S
w
w
w
c
Z
"}
(11,1,1) = {"
a
a
a
a
a
a
a
o
o
a
o
o
a
o
o
a
a
Z
"}
