//MAP CONVERTED BY dmm2tgm.py THIS HEADER COMMENT PREVENTS RECONVERSION, DO NOT REMOVE
"b" = (
/turf/open/floor/plating/ground/mars/random/cave,
/area/bigredv2/caves/east)
"i" = (
/obj/effect/landmark/xeno_silo_spawn,
/turf/open/floor/plating/ground/mars/random/cave,
/area/bigredv2/caves/southeast)
"k" = (
/turf/closed/mineral/smooth/bigred/indestructible,
/area/space)
"l" = (
/turf/open/floor/plating/ground/mars/random/cave,
/area/bigredv2/caves/southeast)
"o" = (
/turf/open/floor/plating/ground/mars/random/cave,
/area/bigredv2/caves/southeast/garbledradio)
"p" = (
/turf/closed/mineral/smooth/bigred,
/area/bigredv2/caves/rock)
"s" = (
/turf/open/space/basic,
/area/space)
"t" = (
/turf/open/floor/plating/ground/mars/random/cave/rock,
/area/bigredv2/caves/southeast/garbledradio)
"w" = (
/obj/effect/ai_node,
/turf/open/floor/plating/ground/mars/random/cave/rock,
/area/bigredv2/caves/southeast/garbledradio)
"A" = (
/obj/effect/ai_node,
/turf/open/floor/plating/ground/mars/random/cave,
/area/bigredv2/caves/southeast)
"D" = (
/turf/open/floor/plating/ground/mars/random/cave/rock,
/area/bigredv2/caves/southeast)
"R" = (
/obj/effect/landmark/lv624/fog_blocker/xeno_spawn,
/turf/open/floor/plating/ground/mars/random/cave,
/area/bigredv2/caves/southeast)
"S" = (
/obj/effect/ai_node,
/turf/open/floor/plating/ground/mars/random/cave,
/area/bigredv2/caves/southeast/garbledradio)
"U" = (
/obj/effect/landmark/lv624/fog_blocker/xeno_spawn,
/turf/closed/mineral/smooth/bigred,
/area/bigredv2/caves/rock)
"X" = (
/turf/closed/mineral/smooth/bigred/indestructible,
/area/bigredv2/caves/rock)

(1,1,1) = {"
p
p
p
p
p
p
p
p
p
p
p
p
p
p
p
p
o
o
o
o
o
o
t
p
p
p
p
p
p
p
p
l
l
l
l
l
l
p
p
p
p
p
p
p
p
p
p
p
p
p
l
l
l
l
p
p
p
p
p
p
p
p
p
p
k
k
s
"}
(2,1,1) = {"
b
p
p
p
p
p
p
p
p
p
p
p
p
p
t
t
o
o
o
p
o
o
t
p
p
p
p
p
p
p
p
l
l
l
l
l
p
p
p
p
p
p
p
p
p
p
p
p
p
p
l
l
l
l
p
p
p
p
p
p
p
p
p
p
p
k
s
"}
(3,1,1) = {"
p
p
p
p
p
p
p
p
p
p
p
p
p
p
o
o
o
o
o
p
t
o
t
p
p
p
p
p
p
p
p
l
l
l
l
l
p
p
p
p
p
p
p
p
p
p
p
p
p
p
l
l
l
l
p
p
p
p
p
p
p
p
p
p
p
k
s
"}
(4,1,1) = {"
p
p
p
p
p
p
p
p
p
p
p
p
p
w
o
o
S
o
p
p
p
o
t
p
p
p
p
p
p
p
p
l
l
l
l
l
p
p
p
p
p
p
p
p
p
p
p
p
p
p
l
l
l
l
p
p
p
p
p
p
p
p
p
p
p
k
s
"}
(5,1,1) = {"
p
p
p
p
p
p
p
p
p
p
p
p
p
o
o
t
o
o
p
p
p
o
t
p
p
p
p
p
p
p
p
l
l
l
l
l
p
p
p
p
p
p
p
p
p
p
p
p
p
p
l
l
A
l
p
p
p
p
p
p
p
p
p
p
p
k
s
"}
(6,1,1) = {"
p
p
p
p
p
p
p
p
p
p
p
t
t
o
o
t
o
o
p
p
p
o
t
p
p
p
p
p
p
p
p
l
l
l
l
l
p
p
p
p
p
p
p
p
p
p
p
p
p
p
l
l
l
l
p
p
p
p
p
p
p
p
p
p
p
k
s
"}
(7,1,1) = {"
p
p
p
p
p
p
p
p
p
p
p
o
o
o
t
o
o
p
p
p
p
o
t
p
p
p
p
p
p
p
p
l
l
l
l
l
p
p
p
p
p
p
p
p
p
p
p
p
p
p
l
l
l
l
p
p
p
p
p
p
p
p
p
p
p
k
s
"}
(8,1,1) = {"
p
p
p
p
p
p
p
p
p
p
p
o
o
S
o
p
p
p
p
p
p
o
t
p
p
p
p
p
p
p
p
l
l
l
l
l
p
p
p
p
p
p
p
p
p
p
p
p
p
p
l
l
l
l
p
p
p
p
p
p
p
p
p
p
p
k
s
"}
(9,1,1) = {"
p
p
p
p
p
p
p
p
p
p
p
o
w
o
o
p
p
p
p
p
p
o
t
p
p
p
p
p
p
p
p
l
l
l
l
l
p
p
p
p
p
p
p
p
p
p
p
p
p
p
l
l
l
l
p
p
p
p
p
p
p
p
p
p
p
k
s
"}
(10,1,1) = {"
p
p
p
p
p
p
p
p
p
p
t
o
t
o
o
p
p
p
p
o
o
S
t
p
p
p
p
p
p
p
l
l
l
l
l
l
p
p
p
p
p
p
p
p
p
p
p
p
p
p
l
l
l
l
p
p
p
p
p
p
p
p
p
p
p
k
s
"}
(11,1,1) = {"
p
p
p
p
p
p
p
p
p
p
o
o
t
o
t
t
t
t
t
o
o
o
t
p
p
p
p
p
p
l
l
l
l
A
l
l
l
p
p
p
p
p
p
p
p
p
p
p
p
p
l
l
l
l
p
p
p
p
p
p
p
p
p
p
p
k
s
"}
(12,1,1) = {"
p
p
p
p
p
p
p
p
p
p
o
o
o
t
o
o
o
o
t
o
o
o
p
p
p
p
p
l
A
l
l
l
A
l
l
l
l
p
p
p
p
p
p
p
p
p
p
p
p
p
l
l
l
p
p
p
p
p
p
p
p
p
p
p
p
k
s
"}
(13,1,1) = {"
p
p
p
p
p
p
p
p
p
p
o
o
o
o
o
o
S
o
o
o
o
o
p
p
p
p
p
l
l
l
l
l
l
l
l
l
l
p
p
p
p
p
p
p
p
p
p
p
p
l
l
l
l
p
p
p
p
p
p
p
p
p
p
p
p
k
s
"}
(14,1,1) = {"
t
o
p
p
p
p
p
p
p
t
o
o
o
o
o
o
o
o
o
o
o
t
p
p
p
p
p
l
l
l
l
l
l
l
l
l
l
l
l
p
p
p
p
p
p
p
p
p
p
l
l
l
A
p
p
p
p
p
p
p
p
p
p
p
p
k
s
"}
(15,1,1) = {"
t
p
p
p
p
p
p
p
p
o
S
o
S
o
o
o
S
o
o
t
p
p
p
p
p
l
l
l
l
l
l
l
l
l
l
l
l
l
l
l
l
p
p
p
p
p
p
p
l
l
l
A
l
p
p
p
p
p
p
p
p
p
p
p
p
k
s
"}
(16,1,1) = {"
t
p
p
p
p
p
p
t
t
o
t
o
o
o
o
o
o
o
o
o
o
p
p
p
p
l
l
l
l
l
l
l
l
l
l
l
l
l
l
l
l
l
l
l
l
p
p
p
l
l
l
l
l
p
p
p
p
p
p
p
p
p
p
p
p
k
s
"}
(17,1,1) = {"
o
p
p
p
p
p
p
o
o
o
t
o
o
o
p
p
p
D
o
o
o
p
p
p
p
l
l
l
l
l
l
l
l
l
l
l
l
l
l
l
l
l
l
l
l
l
l
l
l
l
l
l
p
p
p
p
p
p
p
p
p
p
p
p
p
k
s
"}
(18,1,1) = {"
o
p
p
p
p
p
p
t
o
t
o
o
o
p
p
p
p
p
o
o
A
l
l
l
l
l
l
l
l
l
l
l
l
l
l
l
l
l
l
l
l
l
l
l
l
l
l
l
l
l
l
l
p
p
p
p
p
p
p
p
p
p
p
p
p
k
s
"}
(19,1,1) = {"
o
p
p
p
p
p
o
o
o
t
o
p
p
p
p
p
p
p
p
p
l
l
l
l
l
l
l
l
A
l
l
l
l
A
l
l
l
l
l
l
l
l
A
l
l
l
l
l
l
A
l
A
p
p
p
p
p
p
p
p
p
p
p
p
p
X
s
"}
(20,1,1) = {"
o
p
p
o
o
o
S
o
o
o
S
p
p
p
p
p
p
p
p
p
l
l
l
l
l
l
l
l
l
l
l
l
l
l
l
l
l
l
l
l
l
l
l
l
l
l
l
l
l
l
l
l
p
p
p
p
p
p
p
p
p
p
p
p
p
X
s
"}
(21,1,1) = {"
o
o
o
o
o
o
o
o
t
o
p
p
p
p
p
p
p
p
p
p
A
l
l
l
A
l
l
l
A
l
l
l
l
l
l
l
l
l
l
l
l
l
l
l
l
l
l
l
l
l
l
p
p
p
p
p
p
p
p
p
p
p
p
p
p
X
s
"}
(22,1,1) = {"
o
o
o
o
t
t
o
o
o
o
p
p
p
p
p
p
p
p
p
p
p
l
l
l
l
l
l
l
l
l
l
l
l
l
l
l
l
p
p
p
p
l
l
l
l
l
l
l
l
l
p
p
p
p
p
p
p
p
p
p
p
p
p
p
p
X
s
"}
(23,1,1) = {"
o
S
o
t
o
o
S
o
o
p
p
p
p
p
p
p
p
p
p
p
p
p
l
l
l
l
l
l
l
l
l
l
l
l
l
l
p
p
p
p
p
p
p
p
p
p
p
p
p
p
p
p
p
p
p
p
p
p
p
p
p
p
p
p
p
X
s
"}
(24,1,1) = {"
o
t
t
o
o
o
o
t
p
p
p
p
p
p
p
p
p
p
p
p
p
p
p
l
l
l
l
l
l
l
l
l
l
l
l
l
p
p
p
p
p
p
p
p
p
p
p
p
p
p
p
p
p
p
p
p
p
p
p
p
p
p
p
p
p
X
s
"}
(25,1,1) = {"
t
o
o
t
p
p
p
p
p
p
p
p
p
p
p
p
p
p
p
p
p
p
p
p
A
l
l
l
l
A
l
l
l
l
l
l
p
p
p
p
p
p
p
p
p
p
p
p
p
p
p
p
p
p
p
p
p
p
p
p
p
p
p
p
p
X
s
"}
(26,1,1) = {"
o
o
o
t
p
p
p
p
p
p
p
p
p
p
p
p
p
p
p
p
p
p
p
p
p
l
l
l
A
l
l
l
l
A
l
p
p
p
p
p
p
p
p
p
p
p
p
p
p
p
p
p
p
p
p
p
p
p
p
p
p
p
p
p
p
X
s
"}
(27,1,1) = {"
p
p
p
p
p
p
p
p
p
p
p
p
p
p
p
p
p
p
p
p
p
p
p
p
p
l
l
l
l
l
l
l
l
l
l
p
p
p
p
p
p
p
p
p
p
p
p
p
p
p
p
p
p
p
p
p
p
p
p
p
p
p
p
p
p
X
s
"}
(28,1,1) = {"
p
p
p
p
p
p
p
p
p
p
p
p
p
p
p
p
p
p
p
p
p
p
p
p
p
l
l
l
l
l
l
l
l
l
p
p
p
p
p
p
p
p
p
p
p
p
p
p
p
p
p
p
p
p
p
p
p
p
p
p
p
p
p
p
p
X
s
"}
(29,1,1) = {"
p
p
p
p
p
p
p
p
p
p
p
p
p
p
p
p
p
p
p
p
p
p
p
p
p
l
l
l
l
l
l
l
l
p
p
p
p
p
p
p
p
p
p
p
p
p
p
p
p
p
p
p
p
p
p
p
p
p
p
p
p
p
p
p
p
X
s
"}
(30,1,1) = {"
p
p
p
p
p
p
p
p
p
p
p
p
p
p
p
p
p
p
p
p
p
p
p
p
p
l
l
l
A
l
l
l
p
p
p
p
p
p
p
p
p
p
p
p
p
p
p
p
p
p
p
p
p
p
p
p
p
p
p
p
p
p
p
p
p
X
s
"}
(31,1,1) = {"
p
p
p
p
p
p
p
p
p
p
p
p
p
p
p
p
p
p
p
p
p
p
p
p
p
l
l
A
l
l
l
p
p
p
p
p
p
p
p
p
p
p
p
p
p
p
p
p
p
p
p
p
p
p
p
p
p
p
p
p
p
p
p
p
p
X
s
"}
(32,1,1) = {"
l
l
p
p
p
p
p
p
p
p
p
p
p
p
p
p
p
p
p
p
p
p
p
p
p
l
l
l
l
l
p
p
p
p
p
p
p
p
p
p
p
p
p
p
p
p
p
p
p
p
p
p
p
p
p
p
p
p
p
p
p
p
p
p
p
X
s
"}
(33,1,1) = {"
l
l
l
l
A
p
p
p
p
p
p
p
p
p
p
p
p
p
p
p
p
p
p
p
p
l
l
l
l
l
p
p
p
p
p
p
p
p
p
p
p
p
p
p
p
p
p
p
p
p
p
p
p
p
p
p
p
p
p
p
p
p
p
p
p
X
s
"}
(34,1,1) = {"
l
l
l
l
l
l
l
p
p
p
p
p
p
p
p
p
p
p
p
p
p
p
p
p
p
l
l
l
l
l
p
p
p
p
p
p
p
p
p
p
p
p
p
p
p
p
p
p
p
p
p
p
p
p
p
p
p
p
p
p
p
p
p
p
p
X
s
"}
(35,1,1) = {"
l
l
l
l
l
l
l
p
p
p
p
p
p
p
p
p
p
p
p
p
p
p
p
p
p
l
l
l
l
l
p
p
p
p
p
p
p
p
p
p
p
p
p
p
p
p
p
p
p
p
p
p
p
p
p
p
p
p
p
p
p
p
p
p
p
X
s
"}
(36,1,1) = {"
l
l
l
l
l
l
l
l
p
l
p
p
p
p
p
p
p
p
p
p
p
p
p
p
l
l
l
l
l
l
p
p
p
p
p
p
p
p
p
p
p
p
p
p
p
p
p
p
p
p
p
p
p
p
p
p
p
p
p
p
p
p
p
p
p
X
s
"}
(37,1,1) = {"
l
l
l
l
A
l
l
A
l
l
l
l
p
p
p
p
p
p
p
p
p
p
U
U
R
R
R
R
R
R
p
p
p
p
p
p
p
p
p
p
p
p
p
p
p
p
p
p
p
p
p
p
p
p
p
p
p
p
p
p
p
p
p
p
p
X
s
"}
(38,1,1) = {"
p
p
l
l
l
l
l
l
l
l
l
l
l
l
p
p
p
p
p
p
p
p
U
p
l
l
l
l
l
U
p
p
p
p
p
p
p
p
p
p
p
p
p
p
p
p
p
p
p
p
p
p
p
p
p
p
p
p
p
p
p
p
p
k
k
k
s
"}
(39,1,1) = {"
p
p
l
l
l
l
l
A
l
l
l
l
l
l
A
l
l
l
p
p
p
p
U
p
l
l
l
l
l
U
p
p
p
p
p
p
p
p
p
p
p
p
p
p
p
p
p
p
p
p
p
p
p
p
p
p
p
p
p
p
p
p
p
k
k
k
s
"}
(40,1,1) = {"
p
p
l
l
l
l
l
l
l
l
l
l
l
l
l
l
l
l
l
p
p
p
U
l
l
l
l
l
l
U
p
p
p
p
p
p
p
p
p
p
p
p
p
p
p
p
p
p
p
p
p
p
p
p
p
p
p
p
p
p
p
p
p
k
k
k
s
"}
(41,1,1) = {"
l
l
l
l
l
l
l
l
l
l
l
l
l
l
l
l
l
l
l
l
p
p
U
l
l
l
l
l
l
U
p
p
p
p
p
p
p
p
p
p
p
p
p
p
p
p
p
p
p
p
p
p
p
p
p
p
p
p
p
p
p
p
p
k
k
k
s
"}
(42,1,1) = {"
l
l
l
l
l
l
l
l
l
l
l
l
l
l
l
l
l
l
l
l
l
l
U
l
l
l
l
l
l
U
p
p
p
p
p
p
p
p
p
p
p
p
p
p
p
p
p
p
p
p
p
p
p
p
p
p
p
p
p
p
p
p
p
k
k
k
s
"}
(43,1,1) = {"
l
l
l
l
l
l
l
l
l
l
l
l
l
l
l
l
l
l
l
l
l
l
R
l
l
l
l
l
l
U
p
p
p
p
p
p
p
p
p
p
p
p
p
p
p
p
p
p
p
p
p
p
p
p
p
p
p
p
p
p
p
p
p
k
k
k
s
"}
(44,1,1) = {"
l
l
l
l
l
l
l
l
l
l
l
l
l
l
l
l
l
l
l
l
l
l
R
l
l
l
l
l
l
U
p
p
p
p
p
p
p
p
p
p
p
p
p
p
p
p
p
p
p
p
p
p
p
p
p
p
p
p
p
p
p
p
p
k
k
k
s
"}
(45,1,1) = {"
l
A
l
l
l
l
l
A
l
l
l
l
l
l
A
l
l
l
l
l
l
l
R
l
l
A
l
A
l
U
p
p
p
p
p
p
p
p
p
p
p
p
p
p
p
p
p
p
p
p
p
p
p
p
p
p
p
p
p
p
p
p
p
k
k
k
s
"}
(46,1,1) = {"
l
l
l
l
l
l
l
l
l
p
l
l
l
l
l
l
l
l
l
l
l
l
R
l
l
i
l
l
l
U
p
p
p
p
p
p
p
p
p
p
p
p
p
p
p
p
p
p
p
p
p
p
p
p
p
p
p
p
p
p
p
p
p
k
k
k
s
"}
(47,1,1) = {"
l
l
l
l
l
l
l
l
l
p
p
p
l
l
l
l
l
l
l
l
l
l
R
l
l
l
l
l
p
U
p
p
p
p
p
p
p
p
p
p
p
p
p
p
p
p
p
p
p
p
p
p
p
p
p
p
p
p
p
p
p
p
p
k
k
k
s
"}
(48,1,1) = {"
l
l
l
l
l
l
l
p
p
p
p
p
p
p
p
l
l
l
l
l
l
l
R
l
l
l
l
p
p
U
p
p
p
p
p
p
p
p
p
p
p
p
p
p
p
p
p
p
p
p
p
p
p
p
p
p
p
p
p
p
p
p
p
k
k
k
s
"}
(49,1,1) = {"
l
A
l
l
l
l
p
p
p
p
p
p
p
p
p
p
p
l
l
l
l
l
R
l
l
p
p
p
p
U
p
p
p
p
p
p
p
p
p
p
p
p
p
p
p
p
p
p
p
p
p
p
p
p
p
p
p
p
p
p
p
p
p
k
k
k
s
"}
(50,1,1) = {"
l
l
l
p
p
p
p
p
p
p
p
p
p
p
p
p
p
p
p
l
l
l
R
p
p
p
p
p
p
U
p
p
p
p
p
p
p
p
p
p
p
p
p
p
p
p
p
p
p
p
p
p
p
p
p
p
p
p
p
p
p
p
p
k
k
k
s
"}
(51,1,1) = {"
l
l
l
p
p
p
p
p
p
p
p
p
p
p
p
p
p
p
p
p
p
p
U
U
U
U
U
U
U
U
p
p
p
p
p
p
p
p
p
p
p
p
p
p
p
p
p
p
p
p
p
p
p
p
p
p
p
p
p
p
p
p
p
k
k
k
s
"}
(52,1,1) = {"
p
p
p
p
p
p
p
p
p
p
p
p
p
p
p
p
p
p
p
p
p
p
p
p
p
p
p
p
p
p
p
p
p
p
p
p
p
p
p
p
p
p
p
p
p
p
p
p
p
p
p
p
p
p
p
p
p
p
p
p
p
p
p
k
k
k
s
"}
(53,1,1) = {"
p
p
p
p
p
p
p
p
p
p
p
p
p
p
p
p
p
p
p
p
p
p
p
p
p
p
p
p
p
p
p
p
p
p
p
p
p
p
p
p
p
p
p
p
p
p
p
p
p
p
p
p
p
p
p
p
p
p
p
p
p
p
p
k
k
k
s
"}
(54,1,1) = {"
p
p
p
p
p
p
p
p
p
p
p
p
p
p
p
p
p
p
p
p
p
p
p
p
p
p
p
p
p
p
p
p
p
p
p
p
p
p
p
p
p
p
p
p
p
p
p
p
p
p
p
p
p
p
p
p
p
p
p
p
p
p
p
k
k
k
s
"}
(55,1,1) = {"
p
p
p
p
p
p
p
p
p
p
p
p
p
p
p
p
p
p
p
p
p
p
p
p
p
p
p
p
p
p
p
p
p
p
p
p
p
p
p
p
p
p
p
p
p
p
p
p
p
p
p
p
p
p
p
p
p
p
p
p
p
p
p
k
k
k
s
"}
(56,1,1) = {"
p
p
p
p
p
p
p
p
p
p
p
p
p
p
p
p
p
p
p
p
p
p
p
p
p
p
p
p
p
p
p
p
p
p
p
p
p
p
p
p
p
p
p
p
p
p
p
p
p
p
p
p
p
p
p
p
p
p
p
p
p
p
p
k
k
k
s
"}
(57,1,1) = {"
p
p
p
p
p
p
p
p
p
p
p
p
p
p
p
p
p
p
p
p
p
p
p
p
p
p
p
p
p
p
p
p
p
p
p
p
p
p
p
p
p
p
p
p
p
p
p
p
p
p
p
p
p
p
p
p
p
p
p
p
p
p
p
k
k
k
s
"}
(58,1,1) = {"
p
p
p
p
p
p
p
p
p
p
p
p
p
p
p
p
p
p
p
p
p
p
p
p
p
p
p
p
p
p
p
p
p
p
p
p
p
p
p
p
p
p
p
p
p
p
p
p
p
p
p
p
p
p
p
p
p
p
p
p
p
p
p
k
k
k
s
"}
(59,1,1) = {"
p
p
p
p
p
p
p
p
p
p
p
p
p
p
p
p
p
p
p
p
p
p
p
p
p
p
p
p
p
p
p
p
p
p
p
p
p
p
p
p
p
p
p
p
p
p
p
p
p
p
p
p
p
p
p
p
p
p
p
p
p
p
p
k
k
k
s
"}
(60,1,1) = {"
p
p
p
p
p
p
p
p
p
p
p
p
p
p
p
p
p
p
p
p
p
p
p
p
p
p
p
p
p
p
p
p
p
p
p
p
p
p
p
p
p
p
p
p
p
p
p
p
p
p
p
p
p
p
p
p
p
p
p
p
p
p
p
k
k
k
s
"}
(61,1,1) = {"
p
p
p
p
p
p
p
p
p
p
p
p
p
p
p
p
p
p
p
p
p
p
p
p
p
p
p
p
p
p
p
p
p
p
p
p
p
p
p
p
p
p
p
p
p
p
p
p
p
p
p
p
p
p
p
p
p
p
p
p
p
p
p
k
k
k
s
"}
(62,1,1) = {"
p
p
p
p
p
p
p
p
p
p
p
p
p
p
p
p
p
p
p
p
p
p
p
p
p
p
p
p
p
p
p
p
p
p
p
p
p
p
p
p
p
p
p
p
p
p
p
p
p
p
p
p
p
p
p
p
p
p
p
p
p
p
p
k
k
k
s
"}
(63,1,1) = {"
k
k
k
k
k
k
k
k
k
k
k
k
k
k
k
k
k
k
k
k
k
k
k
k
k
k
k
k
k
k
k
k
k
k
k
k
k
k
k
k
k
k
k
k
p
p
p
p
p
p
p
p
p
p
p
p
p
p
p
p
p
p
p
k
k
k
s
"}
(64,1,1) = {"
k
k
k
k
k
k
k
k
k
k
k
k
k
k
k
k
k
k
k
k
k
k
k
k
k
k
k
k
k
k
k
k
k
k
k
k
k
k
k
k
k
k
k
k
p
p
p
p
p
p
p
p
p
p
p
p
p
p
p
p
p
p
p
k
k
k
s
"}
(65,1,1) = {"
k
k
k
k
k
k
k
k
k
k
k
k
k
k
k
k
k
k
k
k
k
k
k
k
k
k
k
k
k
k
k
k
k
k
k
k
k
k
k
k
k
k
k
k
p
p
p
p
p
p
p
p
p
p
p
p
p
p
p
p
p
p
p
k
k
k
s
"}
(66,1,1) = {"
k
k
k
k
k
k
k
k
k
k
k
k
k
k
k
k
k
k
k
k
k
k
k
k
k
k
k
k
k
k
k
k
k
k
k
k
k
k
k
k
k
k
k
k
p
p
p
p
p
p
p
p
p
p
p
p
p
p
p
p
p
p
p
k
k
k
s
"}
(67,1,1) = {"
k
k
k
k
k
k
k
k
k
k
k
k
k
k
k
k
k
k
k
k
k
k
k
k
k
k
k
k
k
k
k
k
k
k
k
k
k
k
k
k
k
k
k
k
p
p
p
p
p
p
p
p
p
p
p
p
p
p
p
p
p
p
p
k
k
k
s
"}
(68,1,1) = {"
k
k
k
k
k
k
k
k
k
k
k
k
k
k
k
k
k
k
k
k
k
k
k
k
k
k
k
k
k
k
k
k
k
k
k
k
k
k
k
k
k
k
k
k
p
p
p
p
p
p
p
p
p
p
p
p
p
p
p
p
p
p
p
k
k
k
s
"}
(69,1,1) = {"
k
k
k
k
k
k
k
k
k
k
k
k
k
k
k
k
k
k
k
k
k
k
k
k
k
k
k
k
k
k
k
k
k
k
k
k
k
k
k
k
k
k
k
k
p
p
p
p
p
p
p
p
p
p
p
p
p
p
p
p
p
p
p
k
k
k
s
"}
(70,1,1) = {"
k
k
k
k
k
k
k
k
k
k
k
k
k
k
k
k
k
k
k
k
k
k
k
k
k
k
k
k
k
k
k
k
k
k
k
k
k
k
k
k
k
k
k
k
k
k
k
k
k
p
p
p
p
p
p
p
p
p
p
p
p
p
p
k
k
k
s
"}
(71,1,1) = {"
k
k
k
k
k
k
k
k
k
k
k
k
k
k
k
k
k
k
k
k
k
k
k
k
k
k
k
k
k
k
k
k
k
k
k
k
k
k
k
k
k
k
k
k
k
k
k
k
k
k
k
k
k
k
k
k
k
k
k
k
k
k
k
k
k
k
s
"}
