//MAP CONVERTED BY dmm2tgm.py THIS HEADER COMMENT PREVENTS RECONVERSION, DO NOT REMOVE
"f" = (
/obj/machinery/chem_dispenser,
/turf/open/floor/tile/whiteyellow{
	dir = 1
	},
/area/bigredv2/caves/lambda_lab)
"g" = (
/turf/open/floor/plating/ground/mars/random/cave/rock,
/area/bigredv3/caves/northeast)
"i" = (
/obj/structure/fence/standard/xenoproof,
/turf/open/floor/plating/ground/mars/random/cave,
/area/bigredv3/caves/northeast)
"j" = (
/obj/machinery/chem_dispenser,
/turf/open/floor/tile/whiteyellow{
	dir = 9
	},
/area/bigredv2/caves/lambda_lab)
"k" = (
/obj/effect/landmark/lv624/fog_blocker,
/turf/closed/mineral/smooth/bigred,
/area/bigredv3/caves/rock)
"m" = (
/turf/open/floor/plating,
/area/bigredv2/caves/lambda_lab)
"n" = (
/obj/effect/ai_node,
/turf/open/floor/plating/ground/mars/random/cave,
/area/bigredv3/caves/northeast/garbledradio)
"q" = (
/obj/structure/closet/crate/freezer/rations,
/turf/open/floor/plating,
/area/bigredv2/caves/lambda_lab)
"s" = (
/turf/closed/mineral/smooth/bigred,
/area/bigredv3/caves/rock)
"t" = (
/turf/closed/mineral/smooth/bigred/indestructible,
/area/bigredv3/inside/lambda/virology)
"x" = (
/turf/closed/mineral/smooth/bigred/indestructible,
/area/bigredv3/inside/wall)
"F" = (
/turf/closed/mineral/smooth/bigred/indestructible,
/area/space)
"I" = (
/obj/machinery/chem_master,
/turf/open/floor/tile/whiteyellow{
	dir = 5
	},
/area/bigredv2/caves/lambda_lab)
"J" = (
/obj/effect/ai_node,
/turf/open/floor/plating/ground/mars/random/cave,
/area/bigredv3/caves/northeast)
"M" = (
/turf/open/floor/plating/ground/mars/random/cave,
/area/bigredv3/caves/northeast)
"N" = (
/turf/open/floor/plating/ground/mars/random/cave,
/area/bigredv3/caves/northeast/garbledradio)
"S" = (
/turf/closed/wall/r_wall,
/area/bigredv3/inside/wall)
"V" = (
/obj/structure/closet/crate/internals,
/turf/open/floor/plating,
/area/bigredv2/caves/lambda_lab)
"W" = (
/turf/open/floor/plating/ground/mars/random/cave/rock,
/area/bigredv3/caves/northeast/garbledradio)
"X" = (
/obj/effect/landmark/lv624/fog_blocker,
/turf/open/floor/plating/ground/mars/random/cave,
/area/bigredv3/caves/northeast)

(1,1,1) = {"
F
F
F
F
F
F
F
F
F
F
F
F
F
F
F
F
F
F
F
F
s
s
s
s
s
N
N
N
N
W
s
s
"}
(2,1,1) = {"
F
F
F
F
F
F
F
F
F
F
F
F
F
F
F
F
F
F
F
F
s
s
s
W
W
N
N
N
N
W
s
s
"}
(3,1,1) = {"
F
F
F
F
F
F
F
F
F
F
F
F
F
F
F
F
F
F
F
F
s
s
s
N
N
N
N
N
N
W
s
s
"}
(4,1,1) = {"
F
t
F
F
F
F
F
F
F
F
F
F
F
F
F
F
F
F
F
F
s
s
s
N
N
N
N
N
N
N
W
s
"}
(5,1,1) = {"
F
F
F
F
F
F
F
F
F
F
F
F
F
F
F
F
F
F
F
F
s
s
s
N
n
N
N
N
N
n
W
s
"}
(6,1,1) = {"
F
F
F
F
F
F
F
F
F
F
F
F
F
F
F
F
F
F
F
F
s
s
s
W
N
N
N
N
N
N
W
s
"}
(7,1,1) = {"
F
F
F
F
F
F
F
F
F
F
F
F
F
F
F
F
F
F
F
F
s
s
s
s
s
W
N
N
N
N
W
s
"}
(8,1,1) = {"
F
F
F
F
F
F
F
F
F
F
F
F
F
F
F
F
F
F
F
F
s
s
s
s
s
s
N
N
N
N
N
W
"}
(9,1,1) = {"
F
F
F
F
F
F
F
F
F
F
F
F
F
F
F
F
F
F
F
F
s
s
s
s
s
s
W
N
N
N
N
N
"}
(10,1,1) = {"
F
F
F
F
F
F
F
F
F
F
F
F
F
F
F
F
F
F
F
F
s
s
s
s
s
s
s
W
N
n
N
N
"}
(11,1,1) = {"
F
F
F
F
F
F
F
F
F
F
F
F
F
F
F
F
F
F
F
F
s
s
s
s
s
s
s
s
N
N
n
N
"}
(12,1,1) = {"
F
F
F
F
F
F
F
F
F
F
F
F
F
F
F
F
F
F
F
F
s
s
s
s
s
s
s
s
N
W
N
n
"}
(13,1,1) = {"
F
F
F
F
F
F
F
F
F
F
F
F
F
F
F
F
F
F
F
F
s
s
s
s
s
s
s
s
N
N
N
s
"}
(14,1,1) = {"
F
F
F
F
F
F
F
F
F
F
F
F
F
F
F
F
F
F
F
F
s
s
s
s
s
s
s
s
N
N
N
s
"}
(15,1,1) = {"
F
F
F
F
F
F
F
F
F
F
F
F
F
F
F
F
F
F
F
F
s
s
s
s
s
s
s
s
N
N
N
s
"}
(16,1,1) = {"
F
x
F
F
F
F
F
F
F
F
F
F
F
F
F
F
F
F
F
F
s
s
s
s
s
s
s
s
N
N
N
N
"}
(17,1,1) = {"
F
F
F
F
F
F
F
F
F
F
F
F
F
F
F
F
F
F
F
F
s
s
s
s
s
s
s
s
N
N
N
N
"}
(18,1,1) = {"
F
F
F
F
F
F
F
F
F
F
F
F
F
F
F
F
F
F
F
F
s
s
s
s
s
s
s
s
N
N
N
n
"}
(19,1,1) = {"
F
F
F
F
F
F
F
F
F
F
F
F
F
F
F
F
F
F
F
F
s
s
s
s
s
s
s
N
N
N
N
N
"}
(20,1,1) = {"
F
F
F
F
F
F
F
F
F
F
F
F
F
F
F
F
F
F
F
F
s
s
s
s
s
s
s
N
N
N
N
N
"}
(21,1,1) = {"
F
F
F
F
F
F
F
F
F
F
F
F
F
F
F
F
F
F
F
F
s
s
s
s
s
s
s
N
N
N
N
N
"}
(22,1,1) = {"
F
F
F
F
F
F
F
F
F
F
F
F
F
F
F
F
F
F
F
F
s
s
s
s
s
s
N
N
N
N
N
N
"}
(23,1,1) = {"
F
F
F
F
F
F
F
F
F
F
F
F
F
F
F
F
F
F
F
F
s
s
s
s
s
N
n
N
N
N
N
n
"}
(24,1,1) = {"
F
F
F
F
F
F
F
F
F
F
F
F
F
F
F
F
F
F
F
F
s
s
s
s
s
N
N
N
N
N
N
N
"}
(25,1,1) = {"
F
F
F
F
F
F
F
F
F
F
F
F
F
F
F
F
F
F
F
F
s
s
s
s
N
N
N
N
N
N
N
N
"}
(26,1,1) = {"
F
F
F
F
F
F
F
F
F
F
F
F
F
F
F
F
F
F
F
F
s
s
s
s
N
N
N
N
N
N
N
s
"}
(27,1,1) = {"
F
F
F
F
F
F
F
F
F
F
F
F
F
F
F
F
F
F
F
F
s
s
s
N
N
N
N
N
N
s
s
s
"}
(28,1,1) = {"
F
F
F
F
F
F
F
F
F
F
F
F
F
F
F
F
F
F
F
F
s
s
n
N
N
N
n
N
s
s
s
k
"}
(29,1,1) = {"
F
F
F
F
F
F
F
F
F
F
F
F
F
F
F
F
F
F
F
F
s
s
s
N
N
N
N
s
s
s
k
s
"}
(30,1,1) = {"
F
F
F
F
F
F
F
F
F
F
F
F
F
F
F
F
F
F
F
F
s
s
s
N
N
N
N
s
s
k
s
s
"}
(31,1,1) = {"
F
F
F
F
F
F
F
F
F
F
F
F
F
F
F
F
F
F
F
F
s
s
s
N
N
N
N
s
s
k
s
S
"}
(32,1,1) = {"
F
F
F
F
F
F
F
F
F
F
F
F
F
F
F
F
F
F
F
F
s
s
N
N
N
N
N
s
s
k
s
S
"}
(33,1,1) = {"
F
F
F
F
F
F
F
F
F
F
F
F
F
F
F
F
F
F
F
F
s
s
N
N
n
N
n
s
s
k
s
S
"}
(34,1,1) = {"
F
F
F
F
F
F
F
F
F
F
F
F
F
F
F
F
F
F
F
F
s
s
s
N
N
N
N
s
s
k
s
S
"}
(35,1,1) = {"
F
F
F
F
F
F
F
F
F
F
F
F
F
F
F
F
F
F
F
F
s
s
N
N
N
M
s
s
s
k
s
S
"}
(36,1,1) = {"
F
F
F
F
F
F
F
F
F
F
F
F
F
F
F
F
F
F
F
F
s
s
N
N
M
M
s
s
s
k
s
s
"}
(37,1,1) = {"
F
F
F
F
F
F
F
F
F
F
F
F
F
F
F
F
F
F
F
F
s
s
M
M
M
M
s
s
s
k
s
s
"}
(38,1,1) = {"
F
F
F
F
F
F
F
F
F
F
F
F
F
F
F
F
F
F
F
F
s
s
M
M
M
M
s
s
s
k
s
s
"}
(39,1,1) = {"
F
F
F
F
F
F
F
F
F
F
F
F
F
F
F
F
F
F
F
F
s
s
s
M
M
M
M
s
s
k
S
S
"}
(40,1,1) = {"
F
F
F
F
F
F
F
F
F
F
F
F
F
F
F
F
F
F
F
F
s
s
s
M
M
M
M
M
s
k
S
m
"}
(41,1,1) = {"
F
F
F
F
F
F
F
F
F
F
F
F
F
F
F
F
F
F
F
F
s
s
s
M
M
M
M
M
s
k
S
V
"}
(42,1,1) = {"
F
F
F
F
F
F
F
F
F
F
F
F
F
F
F
F
F
F
F
F
s
s
s
M
M
M
M
M
s
k
S
q
"}
(43,1,1) = {"
F
F
F
F
F
F
F
F
F
F
F
F
F
F
F
F
F
F
F
F
s
s
M
M
J
M
J
M
s
k
S
S
"}
(44,1,1) = {"
F
F
F
F
F
F
F
F
F
F
F
F
F
F
F
F
F
F
F
F
s
s
M
M
M
M
M
M
i
k
S
j
"}
(45,1,1) = {"
F
F
F
F
F
F
F
F
F
F
F
F
F
F
F
F
F
F
F
F
s
s
M
M
M
M
M
M
i
X
S
f
"}
(46,1,1) = {"
F
F
F
F
F
F
F
F
F
F
F
F
F
F
F
F
F
F
F
F
s
s
M
M
M
M
M
M
i
X
S
f
"}
(47,1,1) = {"
F
F
F
F
F
F
F
F
F
F
F
F
F
F
F
F
F
F
F
F
s
s
s
M
M
M
M
M
s
k
S
I
"}
(48,1,1) = {"
F
F
F
F
F
F
F
F
F
F
F
F
F
F
F
F
F
F
F
F
s
s
s
s
M
M
M
s
s
k
S
S
"}
(49,1,1) = {"
F
F
F
F
F
F
F
F
F
F
F
F
F
F
F
F
F
F
F
F
s
s
s
s
M
M
M
s
s
s
k
S
"}
(50,1,1) = {"
F
F
F
F
F
F
F
F
F
F
F
F
F
F
F
F
F
F
F
F
s
s
s
s
M
M
M
M
s
s
s
k
"}
(51,1,1) = {"
F
F
F
F
F
F
F
F
F
F
F
F
F
F
F
F
F
F
F
F
s
s
s
s
s
M
M
J
M
M
M
g
"}
(52,1,1) = {"
F
F
F
F
F
F
F
F
F
F
F
F
F
F
F
F
F
F
F
F
s
s
s
s
s
M
J
M
M
M
J
M
"}
(53,1,1) = {"
F
F
F
F
F
F
F
F
F
F
F
F
F
F
F
F
F
F
F
F
s
s
s
s
s
s
M
M
M
M
M
M
"}
(54,1,1) = {"
F
F
F
F
F
F
F
F
F
F
F
F
F
F
F
F
F
F
F
F
s
s
s
s
s
s
M
M
M
M
M
M
"}
(55,1,1) = {"
F
F
F
F
F
F
F
F
F
F
F
F
F
F
F
F
F
F
F
F
s
s
s
s
s
s
s
M
M
M
M
M
"}
(56,1,1) = {"
F
F
F
F
F
F
F
F
F
F
F
F
F
F
F
F
F
F
F
F
s
s
s
s
s
s
s
M
M
M
M
M
"}
(57,1,1) = {"
F
F
F
F
F
F
F
F
F
F
F
F
F
F
F
F
F
F
F
F
s
s
s
s
s
s
s
M
M
M
M
M
"}
(58,1,1) = {"
F
F
F
F
F
F
F
F
F
F
F
F
F
F
F
F
F
F
F
F
s
s
s
s
s
s
s
M
M
M
J
M
"}
(59,1,1) = {"
F
F
F
F
F
F
F
F
F
F
F
F
F
F
F
F
F
F
F
F
s
s
s
s
s
s
s
M
M
M
M
M
"}
(60,1,1) = {"
F
F
F
F
F
F
F
F
F
F
F
F
F
F
F
F
F
F
F
F
s
s
s
s
s
s
s
s
M
M
J
M
"}
(61,1,1) = {"
F
F
F
F
F
F
F
F
F
F
F
F
F
F
F
F
F
F
F
F
s
s
s
s
s
s
s
s
s
M
M
M
"}
(62,1,1) = {"
F
F
F
F
F
F
F
F
F
F
F
F
F
F
F
F
F
F
F
F
s
s
s
s
s
s
s
s
s
M
M
M
"}
(63,1,1) = {"
F
F
F
F
F
F
F
F
F
F
F
F
F
F
F
F
F
F
F
F
s
s
s
s
s
s
s
s
s
M
M
M
"}
(64,1,1) = {"
F
F
F
F
F
F
F
F
F
F
F
F
F
F
F
F
F
F
F
F
s
s
s
s
s
s
s
s
s
M
M
M
"}
(65,1,1) = {"
F
F
F
F
F
F
F
F
F
F
F
F
F
F
F
F
F
F
F
F
s
s
s
s
s
s
s
s
s
M
M
M
"}
