//MAP CONVERTED BY dmm2tgm.py THIS HEADER COMMENT PREVENTS RECONVERSION, DO NOT REMOVE
"b" = (
/obj/machinery/chem_master,
/turf/open/floor/tile/whiteyellow{
	dir = 5
	},
/area/bigredv2/caves/lambda_lab)
"d" = (
/turf/open/floor/plating/ground/mars/random/cave,
/area/bigredv2/caves/northeast/garbledradio)
"h" = (
/turf/closed/wall/r_wall,
/area/bigredv2/caves/rock)
"j" = (
/obj/structure/fence/standard/xenoproof,
/turf/open/floor/plating/ground/mars/random/cave,
/area/bigredv2/caves/northeast)
"l" = (
/turf/open/floor/plating/ground/mars/random/cave/rock,
/area/bigredv2/caves/northeast/garbledradio)
"n" = (
/obj/structure/closet/crate/freezer/rations,
/turf/open/floor/plating,
/area/bigredv2/caves/lambda_lab)
"o" = (
/obj/effect/landmark/lv624/fog_blocker,
/turf/open/floor/plating/ground/mars/random/cave,
/area/bigredv2/caves/northeast)
"q" = (
/obj/effect/ai_node,
/obj/effect/landmark/excavation_site_spawner,
/turf/open/floor/plating/ground/mars/random/cave,
/area/bigredv2/caves/northeast)
"r" = (
/turf/open/floor/plating,
/area/bigredv2/caves/lambda_lab)
"u" = (
/obj/effect/ai_node,
/turf/open/floor/plating/ground/mars/random/cave,
/area/bigredv2/caves/northeast)
"v" = (
/obj/effect/ai_node,
/turf/open/floor/plating/ground/mars/random/cave,
/area/bigredv2/caves/northeast/garbledradio)
"z" = (
/obj/effect/landmark/lv624/fog_blocker,
/turf/closed/mineral/smooth/bigred,
/area/bigredv2/caves/rock)
"A" = (
/obj/machinery/chem_dispenser,
/turf/open/floor/tile/whiteyellow{
	dir = 1
	},
/area/bigredv2/caves/lambda_lab)
"B" = (
/turf/open/floor/plating/ground/mars/random/cave,
/area/bigredv2/caves/northeast)
"C" = (
/turf/closed/mineral/smooth/bigred/indestructible,
/area/space)
"H" = (
/obj/machinery/door/poddoor/two_tile_hor,
/turf/open/floor/plating/ground/mars/random/cave,
/area/bigredv2/caves/northeast/garbledradio)
"J" = (
/obj/structure/closet/crate/internals,
/turf/open/floor/plating,
/area/bigredv2/caves/lambda_lab)
"K" = (
/obj/machinery/chem_dispenser,
/turf/open/floor/tile/whiteyellow{
	dir = 9
	},
/area/bigredv2/caves/lambda_lab)
"N" = (
/turf/closed/mineral/smooth/bigred,
/area/bigredv2/caves/rock)
"O" = (
/obj/machinery/miner/damaged/platinum,
/turf/open/floor/plating/ground/mars/random/cave,
/area/bigredv2/caves/northeast)
"T" = (
/turf/open/floor/plating/ground/mars/random/cave/rock,
/area/bigredv2/caves/northeast)
"X" = (
/turf/closed/wall/r_wall,
/area/bigredv2/caves/lambda_lab)

(1,1,1) = {"
C
C
C
C
C
C
C
C
C
C
C
C
C
C
C
N
N
N
N
N
N
N
N
N
N
d
d
d
d
l
N
N
"}
(2,1,1) = {"
C
C
C
C
C
C
C
C
C
C
N
N
N
N
N
N
N
N
N
N
N
N
N
l
l
d
d
d
d
l
N
N
"}
(3,1,1) = {"
C
C
C
C
C
C
C
C
C
C
N
N
N
N
N
N
N
N
N
N
N
N
d
d
d
d
d
d
d
l
N
N
"}
(4,1,1) = {"
C
C
C
C
C
C
C
C
C
C
N
N
N
N
N
N
N
N
N
N
N
d
d
d
d
d
d
d
d
d
l
N
"}
(5,1,1) = {"
C
C
C
C
C
C
C
C
C
C
N
N
N
N
N
N
N
N
N
N
d
d
v
d
v
d
d
d
d
v
l
N
"}
(6,1,1) = {"
C
C
C
C
C
C
C
C
C
C
N
N
N
N
N
N
N
v
d
H
d
v
d
l
d
d
d
d
d
d
l
N
"}
(7,1,1) = {"
C
C
C
C
C
C
C
C
C
C
N
N
N
N
N
N
d
d
d
d
d
d
d
N
N
l
d
d
d
d
l
N
"}
(8,1,1) = {"
C
C
C
C
C
C
C
C
C
C
N
N
N
N
N
N
d
d
d
N
d
d
N
N
N
N
d
d
d
d
d
T
"}
(9,1,1) = {"
C
C
C
C
C
C
C
C
C
C
N
N
N
N
N
N
d
v
d
N
N
N
N
N
N
N
l
d
d
d
d
d
"}
(10,1,1) = {"
C
C
C
C
C
C
C
C
C
C
N
N
N
N
N
d
v
d
d
N
N
N
N
N
N
N
N
l
d
v
d
d
"}
(11,1,1) = {"
C
C
C
C
C
C
C
C
C
C
N
N
N
N
d
d
d
d
d
N
N
N
N
N
N
N
N
N
N
d
v
d
"}
(12,1,1) = {"
C
C
C
C
C
C
C
C
C
C
N
N
N
N
d
d
d
d
d
N
N
N
N
N
N
N
N
N
N
l
d
v
"}
(13,1,1) = {"
C
C
C
C
C
C
C
C
C
C
N
N
N
d
d
d
d
d
N
N
N
N
N
N
N
N
N
N
N
N
N
N
"}
(14,1,1) = {"
C
C
C
C
C
C
C
C
C
C
N
N
v
d
d
d
v
N
N
N
N
N
N
N
N
N
N
N
N
N
N
N
"}
(15,1,1) = {"
C
C
C
C
C
C
C
C
C
C
N
N
B
B
d
N
N
N
N
N
N
N
N
N
N
N
N
N
N
h
h
h
"}
(16,1,1) = {"
C
C
C
C
C
C
C
C
C
C
N
N
B
B
B
N
N
N
N
N
N
N
N
N
N
N
N
N
N
d
d
d
"}
(17,1,1) = {"
C
C
C
C
C
C
C
C
C
C
N
B
B
B
N
N
N
N
N
N
N
N
N
N
N
N
N
N
N
d
d
d
"}
(18,1,1) = {"
C
C
C
C
C
C
C
C
C
C
N
B
u
B
N
N
N
N
N
N
N
N
N
N
N
N
N
N
N
d
d
v
"}
(19,1,1) = {"
C
C
C
C
C
C
C
C
C
C
N
u
B
B
B
N
N
N
N
N
N
N
N
N
N
N
N
N
N
d
d
d
"}
(20,1,1) = {"
C
C
C
C
C
C
C
C
C
C
N
N
B
B
B
B
B
N
N
N
N
N
N
N
N
N
N
N
N
d
d
d
"}
(21,1,1) = {"
C
C
C
C
C
C
C
C
C
C
N
N
B
B
B
B
B
B
B
N
N
N
N
N
N
N
N
N
N
N
d
d
"}
(22,1,1) = {"
C
C
C
C
C
C
C
C
C
C
N
N
u
B
B
B
u
B
B
N
N
N
N
N
N
N
N
N
N
N
d
d
"}
(23,1,1) = {"
C
C
C
C
C
C
C
C
C
C
N
N
N
B
B
B
B
B
B
N
N
N
N
N
N
N
N
N
N
N
d
v
"}
(24,1,1) = {"
C
C
C
C
C
C
C
C
C
C
N
N
N
N
B
B
B
B
B
B
N
N
N
N
N
N
N
N
N
N
d
d
"}
(25,1,1) = {"
C
C
C
C
C
C
C
C
C
C
N
N
N
N
B
B
B
N
B
B
N
N
N
N
N
N
N
N
N
N
N
d
"}
(26,1,1) = {"
C
C
C
C
C
C
C
C
C
C
N
N
N
N
B
B
B
N
B
B
B
N
N
N
N
B
N
N
N
N
N
N
"}
(27,1,1) = {"
C
C
C
C
C
C
C
C
C
C
N
N
N
N
N
B
B
B
B
B
B
B
B
B
B
B
B
N
N
N
N
N
"}
(28,1,1) = {"
C
C
C
C
C
C
C
C
C
C
N
N
N
N
N
B
u
B
B
B
B
B
u
B
B
B
u
N
N
N
N
z
"}
(29,1,1) = {"
C
C
C
C
C
C
C
C
C
C
N
N
N
N
N
N
B
B
B
B
B
B
B
B
B
B
B
N
N
N
z
N
"}
(30,1,1) = {"
C
C
C
C
C
C
C
C
C
C
N
N
N
N
N
N
N
N
N
B
B
B
B
B
B
B
B
N
N
z
N
N
"}
(31,1,1) = {"
C
C
C
C
C
C
C
C
C
C
N
N
N
N
N
N
N
N
N
N
N
N
N
B
B
B
B
N
N
z
N
X
"}
(32,1,1) = {"
C
C
C
C
C
C
C
C
C
C
N
N
N
N
N
N
N
N
N
N
N
N
N
B
B
B
B
N
N
z
N
X
"}
(33,1,1) = {"
C
C
C
C
C
C
C
C
C
C
N
N
N
N
N
N
N
N
N
N
N
N
N
u
B
B
u
N
N
z
N
X
"}
(34,1,1) = {"
C
C
C
C
C
C
C
C
C
C
N
N
N
N
N
N
N
N
N
N
N
N
N
B
B
B
B
N
N
z
N
X
"}
(35,1,1) = {"
C
C
C
C
C
C
C
C
C
C
N
N
N
N
N
N
N
N
N
N
N
N
N
B
B
B
B
N
N
z
N
X
"}
(36,1,1) = {"
C
C
C
C
C
C
C
C
C
C
N
N
N
N
N
N
N
N
N
N
N
N
N
B
B
B
B
B
N
z
N
N
"}
(37,1,1) = {"
C
C
C
C
C
C
C
C
C
C
N
N
N
N
N
N
N
N
N
N
N
N
N
B
B
B
B
B
N
z
N
N
"}
(38,1,1) = {"
C
C
C
C
C
C
C
C
C
C
N
N
N
N
N
N
N
N
N
N
N
N
N
B
B
B
B
B
N
z
N
N
"}
(39,1,1) = {"
C
C
C
C
C
C
C
C
C
C
N
N
N
N
N
N
N
N
N
N
N
N
N
B
B
B
B
B
N
z
X
X
"}
(40,1,1) = {"
C
C
C
C
C
C
C
C
C
C
C
C
C
C
C
C
C
C
C
C
N
N
N
B
B
B
B
B
N
z
X
r
"}
(41,1,1) = {"
C
C
C
C
C
C
C
C
C
C
C
C
C
C
C
C
C
C
C
C
N
N
N
B
B
B
B
B
N
z
X
J
"}
(42,1,1) = {"
C
C
C
C
C
C
C
C
C
C
C
C
C
C
C
C
C
C
C
C
N
N
N
B
B
B
B
B
N
z
X
n
"}
(43,1,1) = {"
C
C
C
C
C
C
C
C
C
C
C
C
C
C
C
C
C
C
C
C
N
N
N
u
B
B
u
B
N
z
X
X
"}
(44,1,1) = {"
C
C
C
C
C
C
C
C
C
C
C
C
C
C
C
C
C
C
C
C
N
N
N
B
B
B
B
B
j
z
X
K
"}
(45,1,1) = {"
C
C
C
C
C
C
C
C
C
C
C
C
C
C
C
C
C
C
C
C
N
N
N
B
B
B
B
B
j
o
X
A
"}
(46,1,1) = {"
C
C
C
C
C
C
C
C
C
C
C
C
C
C
C
C
C
C
C
C
N
N
N
B
B
B
B
B
j
o
X
A
"}
(47,1,1) = {"
C
C
C
C
C
C
C
C
C
C
C
C
C
C
C
C
C
C
C
C
N
N
N
B
B
B
B
B
N
z
X
b
"}
(48,1,1) = {"
C
C
C
C
C
C
C
C
C
C
C
C
C
C
C
C
C
C
C
C
N
N
N
N
B
B
B
B
N
z
X
X
"}
(49,1,1) = {"
C
C
C
C
C
C
C
C
C
C
C
C
C
C
C
C
C
C
C
C
N
N
N
N
B
B
B
B
N
N
z
X
"}
(50,1,1) = {"
C
C
C
C
C
C
C
C
C
C
C
C
C
C
C
C
C
C
C
C
N
N
N
N
B
B
B
B
B
B
N
z
"}
(51,1,1) = {"
C
C
C
C
C
C
C
C
C
C
C
C
C
C
C
C
C
C
C
C
N
N
N
N
N
B
B
q
B
B
B
T
"}
(52,1,1) = {"
C
C
C
C
C
C
C
C
C
C
C
C
C
C
C
C
C
C
C
C
N
N
N
N
N
B
u
B
B
B
u
B
"}
(53,1,1) = {"
C
C
C
C
C
C
C
C
C
C
C
C
C
C
C
C
C
C
C
C
N
N
N
N
N
N
B
B
B
B
B
B
"}
(54,1,1) = {"
C
C
C
C
C
C
C
C
C
C
C
C
C
C
C
C
C
C
C
C
N
N
N
N
N
N
B
B
B
B
B
B
"}
(55,1,1) = {"
C
C
C
C
C
C
C
C
C
C
C
C
C
C
C
C
C
C
C
C
N
N
N
N
N
N
N
B
O
B
B
B
"}
(56,1,1) = {"
C
C
C
C
C
C
C
C
C
C
C
C
C
C
C
C
C
C
C
C
N
N
N
N
N
N
N
B
B
B
B
B
"}
(57,1,1) = {"
C
C
C
C
C
C
C
C
C
C
C
C
C
C
C
C
C
C
C
C
N
N
N
N
N
N
N
B
B
B
B
B
"}
(58,1,1) = {"
C
C
C
C
C
C
C
C
C
C
C
C
C
C
C
C
C
C
C
C
N
N
N
N
N
N
N
B
B
B
u
B
"}
(59,1,1) = {"
C
C
C
C
C
C
C
C
C
C
C
C
C
C
C
C
C
C
C
C
N
N
N
N
N
N
N
B
B
B
B
B
"}
(60,1,1) = {"
C
C
C
C
C
C
C
C
C
C
C
C
C
C
C
C
C
C
C
C
N
N
N
N
N
N
N
N
B
B
u
B
"}
(61,1,1) = {"
C
C
C
C
C
C
C
C
C
C
C
C
C
C
C
C
C
C
C
C
N
N
N
N
N
N
N
N
N
B
B
B
"}
(62,1,1) = {"
C
C
C
C
C
C
C
C
C
C
C
C
C
C
C
C
C
C
C
C
N
N
N
N
N
N
N
N
N
B
B
B
"}
(63,1,1) = {"
C
C
C
C
C
C
C
C
C
C
C
C
C
C
C
C
C
C
C
C
N
N
N
N
N
N
N
N
N
B
B
B
"}
(64,1,1) = {"
C
C
C
C
C
C
C
C
C
C
C
C
C
C
C
C
C
C
C
C
N
N
N
N
N
N
N
N
N
B
B
B
"}
(65,1,1) = {"
C
C
C
C
C
C
C
C
C
C
C
C
C
C
C
C
C
C
C
C
N
N
N
N
N
N
N
N
N
B
B
B
"}
