//MAP CONVERTED BY dmm2tgm.py THIS HEADER COMMENT PREVENTS RECONVERSION, DO NOT REMOVE
"ag" = (
/turf/open/floor/plating/ground/mars/random/cave,
/area/bigredv3/caves/east/garbledradio)
"am" = (
/obj/effect/ai_node,
/turf/open/floor/plating/ground/mars/random/cave,
/area/bigredv3/caves/east)
"ap" = (
/turf/open/floor/plating/ground/mars/random/cave/rock,
/area/bigredv3/caves/east)
"aq" = (
/turf/closed/mineral/smooth/bigred,
/area/bigredv3/caves/rock)
"ar" = (
/obj/effect/ai_node,
/turf/open/floor/plating/ground/mars/random/cave,
/area/bigredv3/caves/east/garbledradio)
"as" = (
/obj/effect/landmark/lv624/fog_blocker,
/turf/closed/mineral/smooth/bigred,
/area/bigredv3/caves/rock)
"au" = (
/obj/effect/landmark/lv624/fog_blocker/xeno_spawn,
/turf/closed/mineral/smooth/bigred,
/area/bigredv3/caves/rock)
"aB" = (
/turf/open/floor/plating/ground/mars/random/cave/rock,
/area/bigredv3/caves/east/garbledradio)
"aE" = (
/obj/effect/landmark/lv624/fog_blocker/xeno_spawn,
/turf/open/floor/plating/ground/mars/random/cave/rock,
/area/bigredv3/caves/east/garbledradio)
"aG" = (
/obj/effect/landmark/lv624/fog_blocker/xeno_spawn,
/obj/effect/landmark/lv624/fog_blocker/xeno_spawn,
/turf/closed/mineral/smooth/bigred,
/area/bigredv3/caves/rock)
"aH" = (
/obj/effect/landmark/lv624/fog_blocker/xeno_spawn,
/obj/effect/landmark/lv624/fog_blocker/xeno_spawn,
/turf/open/floor/plating/ground/mars/random/cave,
/area/bigredv3/caves/east/garbledradio)
"aK" = (
/obj/effect/landmark/xeno_silo_spawn,
/turf/open/floor/plating/ground/mars/random/cave,
/area/bigredv3/caves/east/garbledradio)
"aN" = (
/turf/open/floor/plating/ground/mars/random/cave,
/area/bigredv3/caves/east)
"aP" = (
/turf/open/floor/plating/ground/mars/random/sand,
/area/bigredv3/outside/directions/se)
"aQ" = (
/obj/effect/landmark/lv624/fog_blocker,
/turf/closed/wall/r_wall,
/area/bigredv3/caves/east/garbledradio)
"aR" = (
/obj/effect/landmark/lv624/fog_blocker/xeno_spawn,
/turf/open/floor/plating/ground/mars/random/cave,
/area/bigredv3/caves/east)
"aS" = (
/obj/effect/ai_node,
/turf/open/floor/plating/ground/mars/random/sand,
/area/bigredv3/outside/directions/se)
"aW" = (
/obj/effect/landmark/lv624/fog_blocker/xeno_spawn,
/turf/open/floor/plating/ground/mars/random/cave,
/area/bigredv3/caves/east/garbledradio)
"aZ" = (
/turf/closed/mineral/smooth/bigred/indestructible,
/area/space)
"bZ" = (
/obj/structure/fence/standard/xenoproof,
/turf/open/floor/plating/ground/mars/random/cave,
/area/bigredv3/caves/east/garbledradio)
"uH" = (
/obj/effect/landmark/xeno_tunnel_spawn,
/turf/open/floor/plating/ground/mars/random/cave,
/area/bigredv3/caves/east/garbledradio)
"wM" = (
/obj/effect/ai_node,
/turf/open/floor/plating/ground/mars/random/cave/rock,
/area/bigredv3/caves/east/garbledradio)

(1,1,1) = {"
aP
aP
aP
aP
aP
aP
aP
aP
aP
aP
aP
aq
aq
aq
aQ
bZ
bZ
ag
ag
ag
ag
ag
ag
ag
ag
ag
ag
ag
aq
aq
aq
aq
aq
aq
aq
aq
aq
ag
ag
ag
ag
ag
"}
(2,1,1) = {"
aP
aP
aP
aP
aP
aP
aP
aP
aP
aP
aP
aq
aq
aq
as
ag
ag
ag
ag
ag
ag
ag
ag
ag
ag
ag
ag
ag
aq
aq
aq
aq
aq
aq
aq
aq
aq
aq
ag
ag
ar
ag
"}
(3,1,1) = {"
aP
aP
aP
aP
aP
aP
aP
aP
aP
aP
aP
aq
aq
aq
as
ag
ag
ag
ag
ag
ag
aq
aq
aq
aq
aq
ag
ag
ag
aq
aq
aq
aq
aq
aq
aq
aq
aq
ag
ag
ag
ag
"}
(4,1,1) = {"
aP
aq
aq
aq
aq
aP
aP
aP
aP
aP
aP
aP
aq
aq
as
ag
ag
ag
ag
ag
ag
aq
aq
aq
aq
aq
aB
ag
ag
ag
ag
ag
ag
ag
ag
aq
aB
aB
ag
ag
ag
ag
"}
(5,1,1) = {"
aP
aq
aq
aq
aq
aq
aq
aP
aP
aP
aP
aP
aP
aq
as
aq
ag
aH
aW
aR
au
au
au
au
au
au
aW
aE
aH
ag
ag
ag
ag
ag
ag
aB
ag
ag
ag
ag
ag
ag
"}
(6,1,1) = {"
aP
aP
aq
aq
aq
aq
aq
aq
aP
aP
aP
aP
aP
aq
as
aq
aq
aW
ag
aq
aq
aq
aq
aq
aq
ag
ag
ag
aE
aB
ar
ag
ag
ag
ag
ag
ag
ag
ag
ag
ar
aB
"}
(7,1,1) = {"
aP
aP
aP
aP
aP
aP
aP
aP
aP
aP
aP
aP
aP
aq
as
aq
aq
aW
ag
ag
ag
aq
ag
aq
aq
ag
ar
ag
aW
ar
ag
ag
ag
ag
ag
ag
ag
ag
ag
ag
ag
aB
"}
(8,1,1) = {"
aP
aP
aP
aP
aP
aP
aP
aP
aP
aP
aP
aP
aP
aq
as
aq
aq
au
ag
ag
ag
ar
ag
ag
ar
ag
ag
ag
aW
ag
ag
ag
ag
ag
ag
ag
aB
ag
ag
ag
aB
aq
"}
(9,1,1) = {"
aP
aP
aP
aP
aP
aS
aP
aP
aP
aS
aP
aP
aP
aq
as
aq
aq
au
ag
ag
ag
ag
ag
ag
ag
ag
ag
aq
au
aq
aq
aq
ag
ag
ag
ag
ag
aB
ag
ag
ag
aB
"}
(10,1,1) = {"
aP
aP
aP
aP
aP
aP
aP
aP
aP
aP
aP
aP
aq
aq
as
aq
aq
au
aq
aq
ag
ag
ag
ag
ag
aq
aq
aq
au
aq
aq
aq
aq
aq
aq
aq
ag
ag
ag
ag
ag
aB
"}
(11,1,1) = {"
aP
aP
aq
aP
aP
aP
aP
aP
aP
aP
aP
aq
aq
aq
as
aq
aq
au
aq
ag
ag
ag
ag
ag
ag
ag
aq
aq
au
aq
aq
aq
aq
aq
aq
aq
ag
ag
ag
ag
ag
aB
"}
(12,1,1) = {"
aP
aq
aq
aP
aP
aP
aP
aP
aP
aq
aq
aq
aq
aq
as
aq
aq
au
ag
aB
ag
ag
aB
ag
ag
ag
aq
aq
au
aq
aq
aq
aq
aq
aq
aq
ag
ag
ag
ag
ag
aB
"}
(13,1,1) = {"
aq
aq
aq
aP
aP
aP
aP
aP
aP
aq
aq
aq
aq
aq
as
aq
aq
au
ag
ag
ag
ag
ag
ag
ag
ag
aq
aq
au
aq
aq
aq
aq
aq
aq
aq
aB
ag
ag
ag
aB
aq
"}
(14,1,1) = {"
aq
aq
aP
aP
aP
aP
aP
aP
aP
aq
aq
aq
aq
aq
as
aq
aq
au
ag
ag
ag
ar
aK
ag
ag
ag
ag
aq
au
aq
aq
aq
aq
aq
aq
aq
ag
ag
ag
ag
ar
aB
"}
(15,1,1) = {"
aq
aP
aP
aP
aP
aP
aq
aq
aq
aq
aq
aq
aq
aq
as
aq
aq
au
ag
ag
ag
ag
ag
ag
ag
ag
aq
aq
au
aq
aq
aq
aq
aq
aq
aq
aq
aB
ag
ag
ag
aB
"}
(16,1,1) = {"
aP
aP
aP
aP
aP
aS
aq
aq
aq
aq
aq
aq
aq
aq
as
aq
aq
au
aq
ag
ag
ag
ag
ag
ag
aq
aq
aq
au
aq
aq
aq
aq
aq
aq
aq
aq
aq
ag
ag
ag
ag
"}
(17,1,1) = {"
aP
aP
aP
aP
aP
aP
aq
aq
aq
aq
aq
aq
aq
aq
as
aq
aq
au
aq
ag
ag
uH
ag
ag
aq
aq
aq
aq
au
aq
aq
aq
aq
aq
aq
aq
aq
aq
ag
ag
ag
ag
"}
(18,1,1) = {"
aq
aq
aq
aq
aq
aq
aq
aq
aq
aq
aq
aq
aq
aq
as
aq
aq
aG
au
aW
aW
aW
aW
aW
au
au
au
au
aG
aq
aq
aq
aq
aq
aq
aq
ag
ag
ag
ag
ag
ag
"}
(19,1,1) = {"
as
as
as
as
as
as
as
as
as
as
as
as
as
as
as
aq
aq
aq
aq
aq
aq
ag
ag
ag
aq
aq
aq
aq
aq
aq
aq
aq
aq
aq
aq
ag
ag
ag
ag
ag
ag
ag
"}
(20,1,1) = {"
aq
aq
aq
aq
aq
aq
aq
aq
aq
aq
aq
aq
aq
aq
aq
aq
aq
aq
aq
aq
aq
aq
aq
aq
aq
aq
aq
aq
aq
aq
aq
aq
aq
aq
ag
ag
ag
ag
ag
ag
ag
ag
"}
(21,1,1) = {"
aq
aq
aq
aq
aq
aq
aq
aq
aq
aq
aq
aq
aq
aq
aq
aq
aq
aq
aq
aq
aq
aq
aq
aq
aq
aq
aq
aq
aq
aq
aq
aq
aq
aq
ag
ag
ag
ag
ag
aB
ag
ag
"}
(22,1,1) = {"
aq
aB
aB
wM
aB
aB
aq
aq
aq
aq
aq
aq
aq
aq
aq
aq
aq
aq
aq
aq
aq
aq
aq
aq
aq
aq
aq
aq
aq
aq
aq
aq
aq
aq
ag
ag
ag
ag
ag
ag
ag
ag
"}
(23,1,1) = {"
aq
ag
ag
ag
ag
ag
aB
aq
aq
aq
aq
aq
aq
aq
aq
aq
aq
aq
aq
aq
aq
aq
aq
aq
aq
aq
aq
aq
aq
aq
aq
aq
aq
aq
ag
ag
aB
aq
aq
ag
ag
ag
"}
(24,1,1) = {"
aq
aB
ag
ag
ag
ag
aB
aq
aq
aq
aq
aq
aq
aq
aq
aq
aq
aq
aq
aq
aq
aq
aq
aq
aq
aq
aq
aq
aq
aq
aq
aq
aq
aq
aq
ag
aB
aq
aq
ag
ag
ag
"}
(25,1,1) = {"
aq
aq
aq
wM
ag
ag
aB
ag
ar
ag
ag
aq
aq
aq
aq
aq
aq
aq
aq
aq
aq
aq
aq
aq
aq
aq
aq
aq
aq
aq
aq
aq
aq
aq
aq
aq
aq
aq
aq
ag
ag
ag
"}
(26,1,1) = {"
aq
aq
aq
aq
aq
ag
aB
ag
ag
ag
ag
aq
aq
aq
aq
aq
aq
aq
aq
aq
aq
aq
aq
aq
aq
au
au
au
au
au
au
au
au
au
au
au
aq
aq
aq
aq
ag
ag
"}
(27,1,1) = {"
aB
aB
aB
aB
aB
ag
aB
ag
ag
ag
ag
aB
aq
aq
aq
aq
aq
aq
aq
aq
aq
aq
aq
aq
aq
au
aq
aq
aq
aq
aq
aq
aq
aq
aq
au
aq
aq
aq
aq
ar
ag
"}
(28,1,1) = {"
ar
ag
ag
ag
ag
ar
ag
aB
wM
aB
aB
ag
aq
aq
aq
aq
aq
aq
aq
aq
aq
aq
aq
aq
aq
au
aq
aq
aq
ag
ag
aq
aq
aq
aq
au
aq
aq
aq
aq
ag
ag
"}
(29,1,1) = {"
ag
ag
ag
ag
ag
ag
ag
ag
ag
ag
ag
aq
aq
aq
aq
aq
aq
aq
aq
aq
aq
aq
aq
aq
aq
au
aq
aq
ag
ag
ag
ag
aq
aq
aq
au
aq
aq
aq
aq
aq
ag
"}
(30,1,1) = {"
ag
ag
ag
ag
ag
ag
ag
ag
ag
ag
ag
aq
aq
aq
aq
aq
aq
aq
aq
aq
aq
aq
aq
aq
aq
au
aq
aq
ag
ag
aK
ag
ag
aq
aq
au
aq
aq
aq
aq
aq
aq
"}
(31,1,1) = {"
ag
ag
ag
ag
ag
ag
ag
ag
ag
aq
aq
aq
aq
aq
aq
aq
aq
aq
aq
aq
aq
aq
aq
aq
aq
au
aq
aq
ag
ag
ag
ag
ag
aq
aq
au
aq
aq
aq
aq
aq
aq
"}
(32,1,1) = {"
aB
ag
ag
ag
ag
ag
ag
aq
aq
aq
aq
aq
aq
aq
aq
aq
aq
aq
aq
aq
aq
aq
aq
aq
aq
au
aq
ag
ag
ag
ag
ag
ag
uH
aq
au
aq
aq
aq
aq
aq
aq
"}
(33,1,1) = {"
ag
ag
ag
ag
ag
ag
ag
aq
aq
aq
aq
aq
aq
aq
aq
aq
aq
aq
aq
ag
aq
aq
aq
aq
aq
au
aq
ag
ag
ag
ag
ag
ag
ag
aq
au
aq
aq
aq
aq
aq
aq
"}
(34,1,1) = {"
aB
ag
ag
aB
ag
ag
ag
aq
aq
aq
aq
ag
aq
aq
aq
aq
aq
aq
ag
ag
ag
aq
aq
aq
ag
aW
ag
ag
ag
ag
ag
ag
ag
ag
aq
au
aq
aq
aq
aq
aq
aq
"}
(35,1,1) = {"
aq
aB
ag
ag
ag
ag
ag
ag
aq
aq
aq
ag
ag
ag
aq
aq
aq
ag
ag
ag
ag
ag
ag
ag
ag
aW
aW
aW
aW
aW
aW
aW
aW
aW
aW
au
aq
aq
aq
aq
aq
aq
"}
(36,1,1) = {"
aq
aq
aq
ag
ag
aB
ag
ag
ag
aq
aq
ag
ag
ag
ag
ag
ag
ag
ag
ag
ag
ag
ag
ag
ag
ag
ag
ag
ag
ag
ag
ag
ag
ag
ag
ag
aq
aq
aq
aq
aq
ag
"}
(37,1,1) = {"
aq
aq
aq
ag
ag
aB
ag
ag
ag
aB
ag
ag
ag
ag
ag
ag
ag
ag
ag
ag
ag
ag
ag
ag
ag
ag
ag
ag
ag
ag
ag
ag
ag
ag
ag
ag
ag
ag
ag
ag
ag
ag
"}
(38,1,1) = {"
aq
aq
aq
ag
ag
ar
ag
ag
ag
ag
ag
ag
ag
ag
ag
ag
ar
ag
ag
ag
ag
ag
ag
ar
ag
ag
ag
ag
ag
ag
ag
ar
ag
ag
ag
ag
ag
ag
ag
ar
ag
ag
"}
(39,1,1) = {"
aq
aq
aq
aq
ag
ag
ag
ag
ag
ag
ag
ag
ag
ag
ag
ag
ag
ag
ag
ag
ag
ag
ag
ag
ag
ag
ag
ag
ag
ag
ag
ag
ag
ag
ag
ag
ag
ag
ag
ag
ag
ag
"}
(40,1,1) = {"
aq
aq
aq
aq
ag
ag
ag
ag
ag
ag
ag
ag
ag
ag
ag
ag
ag
ag
ag
ag
ag
ag
ag
ag
ag
ag
ag
ag
ag
ag
ag
ag
ag
ag
ag
ag
ag
ag
ag
ag
ag
ag
"}
(41,1,1) = {"
aq
aq
aq
ag
ag
ag
ag
ag
ag
ag
ag
ag
ag
ag
ag
ag
ag
ag
ag
ag
ag
ag
ag
ag
ag
ag
ag
ag
ag
ag
ag
ag
ag
ag
ag
ag
ag
ag
ag
ag
ag
ag
"}
(42,1,1) = {"
aq
aq
aq
ag
ag
ag
ag
aN
aN
aN
ag
ag
aN
ag
ag
aN
ag
ag
ag
aN
aN
ag
ag
ag
aN
ag
ag
aN
ag
ag
ag
am
ag
ag
ag
ag
aN
ag
ag
ar
ag
aN
"}
(43,1,1) = {"
aq
aq
aN
aN
aN
am
aN
aN
aN
aN
aN
aN
aN
aN
aN
aN
am
aN
aN
aN
aN
aN
aN
am
aN
aN
aN
aN
aN
aN
aN
aN
aN
aN
aN
aN
aN
aN
aN
aN
aN
aN
"}
(44,1,1) = {"
aq
aq
aN
aN
aN
aN
aN
aN
aN
aN
aN
aN
aN
aN
aN
aN
aN
aN
aN
aN
aN
aN
aN
aN
aN
aN
aN
aN
aN
aN
aN
aN
aN
aN
aN
aN
aN
aN
aN
aN
aN
aN
"}
(45,1,1) = {"
aq
aq
aN
aN
aN
aN
aN
aN
aN
aN
aN
aN
aN
aN
aN
aN
aN
aN
aN
aN
aN
aN
aN
aN
aN
aN
aN
aN
aN
aN
aN
aN
aN
aN
aN
aN
aN
aN
aN
aN
aN
aN
"}
(46,1,1) = {"
aN
aN
aN
aN
aN
aN
aN
aN
aN
aN
aN
aN
aN
aN
aN
aN
aN
aN
aN
aN
aN
aN
aN
aN
aN
aN
aN
aN
aN
aN
aN
aN
aN
aN
aN
aN
aN
aN
aN
aN
aN
aN
"}
(47,1,1) = {"
aN
aN
aN
aN
aN
aN
am
aN
aN
aN
aN
aN
aN
aN
aN
aN
am
aN
aN
aN
aN
aN
am
aN
aN
aN
aN
aN
aN
aN
aN
aN
aN
aN
aN
aN
aN
aN
aN
aN
aN
aN
"}
(48,1,1) = {"
am
aN
aN
aN
aN
am
aN
aN
aN
aN
aN
aN
aN
aN
aN
aN
aN
aN
aN
aN
aN
aN
aN
am
aN
aN
aN
aN
aN
aN
aN
am
aN
aN
aN
aN
aN
aN
aN
am
aN
aN
"}
(49,1,1) = {"
aN
aN
aN
aN
aN
aN
aN
aN
aN
aN
aN
aN
aN
aN
aN
aN
aN
aN
aN
aN
aN
aN
aN
aN
aN
aN
aN
aN
aN
aN
aN
aN
aN
aN
aN
aN
aN
aN
aN
aN
aN
aN
"}
(50,1,1) = {"
aN
aN
aN
aN
aN
aN
aN
aN
aN
aq
aq
aq
aq
aN
aN
aN
aN
aN
aN
aN
aN
aN
aN
aN
aN
aN
aN
aN
aN
aN
aN
aN
aN
aN
aN
aN
aN
aN
aN
aN
aN
aN
"}
(51,1,1) = {"
aN
aN
aN
aN
aN
aN
aN
aN
aN
aq
aq
aq
aq
aq
aN
aN
aN
aN
aN
aN
aN
aN
aN
aN
aN
aN
aN
aN
aN
aN
aq
aq
aq
aN
aN
aN
aN
aN
aN
aN
aN
aN
"}
(52,1,1) = {"
aN
ap
aN
aN
aN
aN
aN
aq
aq
aq
aq
aq
aq
aq
aq
aq
aq
aq
aq
aq
aq
aq
aN
aN
aN
aN
aN
aN
aN
aq
aq
aq
aq
aq
aN
aN
aN
aN
aN
am
aN
aN
"}
(53,1,1) = {"
am
aN
aN
aN
aq
aq
aq
aq
aq
aq
aq
aq
aq
aq
aq
aq
aq
aq
aq
aq
aq
aq
aq
ap
aN
aN
aN
aN
aq
aq
aq
aq
aq
aq
ap
aN
aN
aN
aN
aN
aN
aN
"}
(54,1,1) = {"
aN
aN
aN
aN
aq
aq
aq
aq
aq
aq
aq
aq
aq
aq
aq
aq
aq
aq
aq
aq
aq
aq
aq
aq
aN
aN
aN
aN
aN
aq
aq
aq
aq
aq
aq
aq
aN
aN
aN
aN
aN
aN
"}
(55,1,1) = {"
aN
aN
aN
aq
aq
aq
aq
aq
aq
aq
aq
aq
aq
aq
aq
aq
aq
aq
aq
aq
aq
aq
aq
aq
aN
aN
aN
aN
aN
aN
aq
aq
aq
aq
aq
aq
aq
aq
aq
aN
aN
aN
"}
(56,1,1) = {"
aN
aN
aN
aq
aq
aq
aq
aq
aq
aq
aq
aq
aq
aq
aq
aq
aq
aq
aq
aq
aq
aq
aq
aq
aN
aN
aN
aN
aN
aN
aq
aq
aq
aq
aq
aq
aq
aq
aq
aq
aq
aq
"}
(57,1,1) = {"
aN
aN
aN
aq
aq
aq
aq
aq
aq
aq
aq
aq
aq
aq
aq
aq
aq
aq
aq
aq
aq
aq
aq
aq
aN
aN
aN
aN
aN
aN
aq
aq
aq
aq
aq
aq
aq
aq
aq
aq
aq
aq
"}
(58,1,1) = {"
aN
aN
aN
aq
aq
aq
aq
aq
aq
aq
aq
aq
aq
aq
aq
aq
aq
aq
aq
aq
aq
aq
aq
aq
aN
aN
aN
aN
aN
aq
aq
aq
aq
aq
aq
aq
aq
aq
aq
aq
aq
aq
"}
(59,1,1) = {"
am
aN
aq
aq
aq
aq
aq
aq
aq
aq
aq
aq
aq
aq
aq
aq
aq
aq
aq
aq
aq
aq
aq
aq
aq
aN
aN
aN
aq
aq
aq
aq
aq
aq
aq
aq
aq
aq
aq
aq
aq
aq
"}
(60,1,1) = {"
aq
aq
aq
aq
aq
aq
aq
aq
aq
aq
aq
aq
aq
aq
aq
aq
aq
aq
aq
aq
aq
aq
aq
aq
aq
aq
aq
aq
aq
aq
aq
aq
aq
aq
aq
aq
aq
aq
aq
aq
aq
aq
"}
(61,1,1) = {"
aq
aq
aq
aq
aq
aq
aq
aq
aq
aq
aq
aq
aq
aq
aq
aq
aq
aq
aq
aq
aq
aq
aq
aq
aq
aq
aq
aq
aq
aq
aq
aq
aq
aq
aq
aq
aq
aq
aq
aq
aq
aq
"}
(62,1,1) = {"
au
au
aq
aq
aq
aq
aq
aq
aq
aq
aq
aq
aq
aq
aq
aq
aq
aq
aq
aq
aq
aq
aq
aq
aq
aq
aq
aq
aq
aq
aq
aq
aq
aq
aq
aq
aq
aq
aq
aq
aq
aq
"}
(63,1,1) = {"
aq
au
au
aq
aq
aq
aq
aq
aq
aq
aq
aq
aq
aq
aq
aq
aq
aq
aq
aq
aq
aq
aq
aq
aq
aq
aq
aq
aq
aq
aq
aq
aq
aq
aq
aq
aq
aq
aq
aq
aq
aq
"}
(64,1,1) = {"
aq
aq
au
aq
aq
aq
aq
aq
aq
aq
aq
aq
aq
aq
aq
aq
aq
aq
aq
aq
aq
aq
aq
aq
aq
aq
aq
aq
aq
aq
aq
aq
aq
aq
aq
aq
aq
aq
aq
aq
aq
aq
"}
(65,1,1) = {"
aq
aq
au
aq
aq
aq
aq
aq
aq
aq
aq
aq
aq
aq
aq
aq
aq
aq
aq
aq
aq
aq
aq
aq
aq
aq
aq
aq
aq
aq
aq
aq
aq
aq
aq
aq
aq
aq
aq
aq
aq
aq
"}
(66,1,1) = {"
aN
aq
aZ
aZ
aZ
aZ
aZ
aZ
aZ
aZ
aZ
aZ
aZ
aZ
aZ
aZ
aZ
aZ
aZ
aZ
aZ
aZ
aZ
aZ
aZ
aZ
aZ
aZ
aZ
aZ
aZ
aZ
aZ
aZ
aZ
aZ
aZ
aZ
aZ
aZ
aZ
aZ
"}
