//MAP CONVERTED BY dmm2tgm.py THIS HEADER COMMENT PREVENTS RECONVERSION, DO NOT REMOVE
"am" = (
/obj/effect/decal/cleanable/dirt,
/obj/machinery/atmospherics/pipe/manifold/green/hidden,
/obj/structure/cable,
/turf/open/floor/tile/red/redtaupecorner,
/area/bigredv3/inside/secondary/office_complex)
"ao" = (
/obj/machinery/atmospherics/components/unary/vent_pump{
	dir = 1;
	on = 1
	},
/turf/open/floor/tile/red/redtaupecorner,
/area/bigredv3/inside/secondary/office_complex)
"aF" = (
/turf/open/floor/marking/asteroidwarning,
/area/bigredv3/outside/directions/central)
"aL" = (
/obj/structure/table,
/turf/open/floor/tile/dark,
/area/bigredv3/inside/secondary/office_complex)
"aO" = (
/obj/machinery/vending/snack,
/turf/open/floor,
/area/bigredv3/inside/secondary/office_complex)
"bF" = (
/turf/open/floor/marking/asteroidwarning{
	dir = 5
	},
/area/bigredv3/outside/directions/e)
"cg" = (
/obj/structure/bed/chair{
	dir = 1
	},
/turf/open/floor,
/area/bigredv3/inside/secondary/office_complex)
"cn" = (
/obj/machinery/atmospherics/pipe/simple/green/hidden,
/obj/machinery/door/airlock/multi_tile/mainship/generic{
	name = "\improper Office Complex Janitor Room"
	},
/turf/open/floor/tile/whiteyellow/full,
/area/bigredv3/inside/secondary/office_complex)
"cx" = (
/obj/structure/table,
/obj/item/paper,
/obj/machinery/light{
	dir = 8
	},
/turf/open/floor,
/area/bigredv3/inside/secondary/office_complex)
"cD" = (
/turf/open/floor/plating/ground/mars/dirttosand/autosmooth{
	dir = 1
	},
/area/bigredv3/outside/directions/e)
"dr" = (
/obj/machinery/light{
	dir = 8
	},
/turf/open/floor/wood,
/area/bigredv3/inside/secondary/office_complex)
"dS" = (
/obj/effect/decal/cleanable/dirt,
/turf/open/floor/tile/dark,
/area/bigredv3/inside/secondary/office_complex)
"ei" = (
/obj/machinery/atmospherics/pipe/simple/green/hidden{
	dir = 4
	},
/turf/open/floor/tile/red/redtaupecorner,
/area/bigredv3/inside/secondary/office_complex)
"en" = (
/obj/structure/flora/pottedplant/ten,
/turf/open/floor/wood,
/area/bigredv3/inside/secondary/office_complex)
"eU" = (
/obj/structure/table,
/obj/effect/spawner/random/misc/paperbin,
/turf/open/floor,
/area/bigredv3/inside/secondary/office_complex)
"fp" = (
/turf/open/floor/marking/asteroidwarning{
	dir = 6
	},
/area/bigredv3/outside/directions/se)
"fz" = (
/turf/open/floor/tile/white/warningstripe,
/area/bigredv3/inside/secondary/office_complex)
"fW" = (
/obj/structure/table,
/obj/machinery/computer3/laptop/secure_data,
/turf/open/floor/grimy,
/area/bigredv3/inside/secondary/office_complex)
"gf" = (
/turf/open/floor/marking/asteroidwarning{
	dir = 10
	},
/area/bigredv3/outside/directions/central)
"gh" = (
/obj/structure/table,
/obj/item/tool/pen/blue,
/turf/open/floor/grimy,
/area/bigredv3/inside/secondary/office_complex)
"hl" = (
/obj/structure/bed/chair/comfy/black{
	dir = 8
	},
/obj/effect/decal/cleanable/dirt,
/turf/open/floor,
/area/bigredv3/inside/secondary/office_complex)
"ho" = (
/obj/machinery/atmospherics/components/unary/vent_pump{
	dir = 4;
	on = 1
	},
/obj/effect/decal/cleanable/dirt,
/turf/open/floor/tile/dark,
/area/bigredv3/inside/secondary/office_complex)
"hZ" = (
/obj/machinery/light{
	dir = 8
	},
/turf/open/floor/tile/whiteyellow/full,
/area/bigredv3/inside/secondary/office_complex)
"ic" = (
/obj/structure/bed/chair/office/light{
	dir = 1
	},
/turf/open/floor,
/area/bigredv3/inside/secondary/office_complex)
"ie" = (
/obj/structure/window/framed/colony,
/turf/open/floor,
/area/bigredv3/inside/wall)
"if" = (
/obj/structure/table,
/obj/machinery/microwave,
/turf/open/floor,
/area/bigredv3/inside/secondary/office_complex)
"iu" = (
/obj/structure/table,
/obj/item/storage/box/m94,
/turf/open/floor/tile/whiteyellow/full,
/area/bigredv3/inside/secondary/office_complex)
"iI" = (
/obj/structure/table,
/obj/item/reagent_containers/food/drinks/flask,
/turf/open/floor/tile/dark,
/area/bigredv3/inside/secondary/office_complex)
"iK" = (
/obj/structure/bed/chair{
	dir = 1
	},
/obj/effect/decal/cleanable/dirt,
/turf/open/floor,
/area/bigredv3/inside/secondary/office_complex)
"jh" = (
/obj/machinery/atmospherics/components/unary/vent_pump{
	dir = 1;
	on = 1
	},
/turf/open/floor/tile/whiteyellow/full,
/area/bigredv3/inside/secondary/office_complex)
"jl" = (
/obj/machinery/atmospherics/pipe/manifold/green/hidden{
	dir = 1
	},
/obj/effect/decal/cleanable/dirt,
/turf/open/floor,
/area/bigredv3/inside/secondary/office_complex)
"jz" = (
/obj/effect/decal/cleanable/dirt,
/obj/effect/decal/cleanable/dirt,
/obj/machinery/atmospherics/components/unary/vent_pump{
	dir = 4;
	on = 1
	},
/turf/open/floor/tile/white,
/area/bigredv3/inside/secondary/office_complex)
"jD" = (
/obj/effect/decal/cleanable/blood,
/obj/effect/decal/cleanable/dirt,
/turf/open/floor/tile/white,
/area/bigredv3/inside/secondary/office_complex)
"jG" = (
/turf/open/floor/marking/asteroidwarning{
	dir = 4
	},
/area/bigredv3/outside/directions/e)
"kz" = (
/obj/structure/table,
/obj/structure/flora/pottedplant/fifteen{
	pixel_y = 10
	},
/turf/open/floor/grimy,
/area/bigredv3/inside/secondary/office_complex)
"kF" = (
/obj/effect/ai_node,
/turf/open/floor/tile/white/warningstripe,
/area/bigredv3/inside/secondary/office_complex)
"kW" = (
/obj/machinery/door/airlock/mainship/generic{
	dir = 1;
	name = "\improper Private Office"
	},
/turf/open/floor,
/area/bigredv3/inside/secondary/office_complex)
"lb" = (
/turf/open/floor/grimy,
/area/bigredv3/inside/secondary/office_complex)
"ld" = (
/obj/effect/landmark/start/job/survivor,
/obj/effect/landmark/start/latejoinsurvivor,
/turf/open/floor/tile/red/redtaupecorner{
	dir = 8
	},
/area/bigredv3/inside/secondary/office_complex)
"lK" = (
/turf/open/floor/plating/ground/mars/dirttosand/autosmooth,
/area/bigredv3/outside/directions/central)
"ma" = (
/turf/open/floor/tile/red/redtaupecorner,
/area/bigredv3/inside/secondary/office_complex)
"mc" = (
/obj/machinery/atmospherics/pipe/simple/green/hidden{
	dir = 4
	},
/obj/effect/decal/cleanable/dirt,
/obj/effect/ai_node,
/obj/machinery/light,
/turf/open/floor/tile/red/redtaupecorner,
/area/bigredv3/inside/secondary/office_complex)
"mh" = (
/obj/effect/decal/cleanable/dirt,
/obj/effect/landmark/start/job/survivor,
/obj/effect/landmark/start/latejoinsurvivor,
/turf/open/floor,
/area/bigredv3/inside/secondary/office_complex)
"mq" = (
/obj/machinery/atmospherics/pipe/simple/green/hidden,
/turf/open/floor/tile/red/redtaupecorner,
/area/bigredv3/inside/secondary/office_complex)
"ms" = (
/obj/machinery/light{
	dir = 4
	},
/turf/open/floor/tile/red/redtaupecorner,
/area/bigredv3/inside/secondary/office_complex)
"mu" = (
/obj/effect/decal/cleanable/dirt,
/turf/open/floor/tile/whiteyellow/full,
/area/bigredv3/inside/secondary/office_complex)
"mS" = (
/obj/machinery/door/airlock/multi_tile/mainship/generic{
	dir = 1;
	name = "\improper Office Complex"
	},
/turf/open/floor,
/area/bigredv3/inside/secondary/office_complex)
"mZ" = (
/obj/machinery/atmospherics/pipe/simple/green/hidden{
	dir = 10
	},
/turf/open/floor/tile/red/redtaupecorner,
/area/bigredv3/inside/secondary/office_complex)
"nS" = (
/obj/machinery/light{
	dir = 1
	},
/turf/open/floor/tile/red/redtaupecorner{
	dir = 4
	},
/area/bigredv3/inside/secondary/office_complex)
"nU" = (
/obj/effect/decal/cleanable/dirt,
/turf/open/floor/marking/asteroidwarning,
/area/bigredv3/outside/directions/se)
"oh" = (
/obj/effect/decal/cleanable/dirt,
/obj/item/trash/hotdog,
/turf/open/floor/tile/white,
/area/bigredv3/inside/secondary/office_complex)
"oQ" = (
/obj/machinery/atmospherics/pipe/simple/green/hidden{
	dir = 4
	},
/obj/effect/decal/cleanable/dirt,
/obj/structure/cable,
/turf/open/floor/tile/red/redtaupecorner,
/area/bigredv3/inside/secondary/office_complex)
"oU" = (
/obj/machinery/atmospherics/pipe/simple/green/hidden,
/obj/structure/cable,
/turf/open/floor/tile/white/warningstripe,
/area/bigredv3/inside/secondary/office_complex)
"pp" = (
/obj/effect/ai_node,
/turf/open/floor/asteroidfloor,
/area/bigredv3/outside/directions/e)
"ps" = (
/obj/machinery/atmospherics/pipe/simple/green/hidden,
/obj/structure/cable,
/turf/open/floor/tile/red/redtaupecorner{
	dir = 8
	},
/area/bigredv3/inside/secondary/office_complex)
"pt" = (
/obj/machinery/door_control{
	dir = 4;
	id = "Office Complex 1";
	name = "Storm Shutters"
	},
/turf/open/floor/tile/red/redtaupecorner{
	dir = 8
	},
/area/bigredv3/inside/secondary/office_complex)
"pL" = (
/obj/machinery/photocopier,
/turf/open/floor/tile/white,
/area/bigredv3/inside/secondary/office_complex)
"qa" = (
/obj/effect/decal/cleanable/dirt,
/obj/machinery/atmospherics/pipe/simple/green/hidden{
	dir = 10
	},
/obj/structure/cable,
/turf/open/floor/tile/white,
/area/bigredv3/inside/secondary/office_complex)
"qu" = (
/obj/machinery/atmospherics/pipe/manifold/green/hidden{
	dir = 1
	},
/obj/structure/cable,
/turf/open/floor/tile/red/redtaupecorner{
	dir = 8
	},
/area/bigredv3/inside/secondary/office_complex)
"qB" = (
/obj/effect/ai_node,
/turf/open/floor/tile/red/redtaupecorner{
	dir = 4
	},
/area/bigredv3/inside/secondary/office_complex)
"qU" = (
/obj/structure/closet/jcloset,
/obj/item/clothing/head/beret/jan,
/obj/item/clothing/head/beret/jan,
/obj/item/clothing/head/beret/jan,
/obj/item/clothing/head/beret/jan,
/obj/item/clothing/head/beret/jan,
/obj/item/clothing/head/beret/jan,
/obj/item/clothing/head/beret/jan,
/obj/machinery/light{
	dir = 4
	},
/turf/open/floor/tile/whiteyellow/full,
/area/bigredv3/inside/secondary/office_complex)
"rb" = (
/obj/structure/janitorialcart,
/turf/open/floor/tile/whiteyellow/full,
/area/bigredv3/inside/secondary/office_complex)
"rf" = (
/obj/item/trash/raisins,
/turf/open/floor/tile/dark,
/area/bigredv3/inside/secondary/office_complex)
"rr" = (
/obj/structure/table,
/obj/item/cell/hyper,
/turf/open/floor/tile/white,
/area/bigredv3/inside/secondary/office_complex)
"rX" = (
/obj/structure/table,
/obj/item/clipboard,
/turf/open/floor/tile/white/warningstripe,
/area/bigredv3/inside/secondary/office_complex)
"sh" = (
/obj/item/taperecorder,
/turf/open/floor/tile/white,
/area/bigredv3/inside/secondary/office_complex)
"tt" = (
/obj/structure/bed/chair/office/light{
	dir = 8
	},
/obj/machinery/light{
	dir = 4
	},
/turf/open/floor/grimy,
/area/bigredv3/inside/secondary/office_complex)
"tx" = (
/obj/machinery/light{
	dir = 4
	},
/obj/structure/bed/chair/office/light{
	dir = 1
	},
/obj/effect/decal/cleanable/dirt,
/turf/open/floor,
/area/bigredv3/inside/secondary/office_complex)
"um" = (
/obj/effect/decal/cleanable/dirt,
/obj/machinery/atmospherics/pipe/simple/green/hidden,
/obj/structure/cable,
/turf/open/floor/tile/red/redtaupecorner{
	dir = 8
	},
/area/bigredv3/inside/secondary/office_complex)
"ut" = (
/obj/structure/cable,
/obj/machinery/atmospherics/pipe/simple/green/hidden,
/obj/machinery/door/airlock/multi_tile/mainship/generic{
	name = "\improper Office Complex"
	},
/turf/open/floor,
/area/bigredv3/inside/secondary/office_complex)
"uG" = (
/obj/structure/table,
/obj/item/tool/analyzer,
/turf/open/floor/tile/white/warningstripe,
/area/bigredv3/inside/secondary/office_complex)
"uH" = (
/obj/structure/bed/chair{
	dir = 4
	},
/turf/open/floor/grimy,
/area/bigredv3/inside/secondary/office_complex)
"vb" = (
/obj/structure/sign/safety/breakroom,
/turf/open/floor,
/area/bigredv3/inside/secondary/office_complex)
"vo" = (
/obj/machinery/light{
	dir = 4
	},
/turf/open/floor,
/area/bigredv3/inside/secondary/office_complex)
"vU" = (
/obj/structure/table,
/obj/effect/spawner/random/engineering/tech_supply,
/turf/open/floor/tile/white,
/area/bigredv3/inside/secondary/office_complex)
"vW" = (
/obj/structure/closet/jcloset,
/turf/open/floor/tile/whiteyellow/full,
/area/bigredv3/inside/secondary/office_complex)
"wh" = (
/obj/structure/rack,
/obj/effect/spawner/random/engineering/tech_supply,
/obj/machinery/light{
	dir = 8
	},
/turf/open/floor/tile/white,
/area/bigredv3/inside/secondary/office_complex)
"wr" = (
/obj/machinery/atmospherics/pipe/simple/green/hidden,
/obj/structure/cable,
/obj/machinery/light{
	dir = 8
	},
/turf/open/floor/tile/red/redtaupecorner{
	dir = 8
	},
/area/bigredv3/inside/secondary/office_complex)
"wy" = (
/obj/effect/decal/cleanable/dirt,
/turf/open/floor/tile/white,
/area/bigredv3/inside/secondary/office_complex)
"xd" = (
/obj/machinery/atmospherics/pipe/simple/green/hidden{
	dir = 4
	},
/obj/item/trash/cheesie,
/turf/open/floor/tile/red/redtaupecorner,
/area/bigredv3/inside/secondary/office_complex)
"xp" = (
/obj/effect/decal/cleanable/dirt,
/obj/item/paper,
/turf/open/floor/tile/whiteyellow/full,
/area/bigredv3/inside/secondary/office_complex)
"xx" = (
/obj/structure/window/framed/colony,
/turf/open/floor/plating,
/area/bigredv3/inside/wall)
"xE" = (
/obj/structure/table,
/obj/item/paper,
/obj/item/paper,
/obj/item/paper{
	pixel_x = -4;
	pixel_y = 4
	},
/obj/item/tool/pen/blue{
	pixel_x = 0;
	pixel_y = 5
	},
/turf/open/floor,
/area/bigredv3/inside/secondary/office_complex)
"xJ" = (
/obj/item/mass_spectrometer,
/turf/open/floor/tile/white,
/area/bigredv3/inside/secondary/office_complex)
"ya" = (
/obj/effect/decal/cleanable/dirt,
/obj/machinery/light{
	dir = 8
	},
/turf/open/floor/tile/red/redtaupecorner{
	dir = 8
	},
/area/bigredv3/inside/secondary/office_complex)
"yf" = (
/turf/open/floor/tile/white,
/area/bigredv3/inside/secondary/office_complex)
"yu" = (
/obj/machinery/atmospherics/pipe/simple/green/hidden,
/obj/structure/cable,
/turf/open/floor/tile/red/redtaupecorner{
	dir = 4
	},
/area/bigredv3/inside/secondary/office_complex)
"yO" = (
/obj/machinery/door_control{
	dir = 4;
	id = "Office Complex 1";
	name = "Storm Shutters"
	},
/obj/structure/cable,
/obj/machinery/atmospherics/pipe/simple/green/hidden,
/turf/open/floor/tile/red/redtaupecorner{
	dir = 8
	},
/area/bigredv3/inside/secondary/office_complex)
"za" = (
/obj/structure/bed/chair{
	dir = 1
	},
/obj/effect/decal/cleanable/dirt,
/obj/structure/sign/prop1,
/turf/open/floor,
/area/bigredv3/inside/secondary/office_complex)
"zj" = (
/obj/machinery/light{
	dir = 1
	},
/turf/open/floor/tile/dark,
/area/bigredv3/inside/secondary/office_complex)
"zx" = (
/obj/effect/decal/cleanable/dirt,
/obj/effect/spawner/random/misc/folder/nooffset,
/turf/open/floor/tile/white,
/area/bigredv3/inside/secondary/office_complex)
"zI" = (
/obj/structure/table,
/obj/structure/sign/prop3,
/turf/open/floor,
/area/bigredv3/inside/secondary/office_complex)
"zJ" = (
/obj/effect/decal/cleanable/dirt,
/turf/closed/wall,
/area/bigredv3/inside/wall)
"zV" = (
/obj/structure/table,
/obj/item/clothing/mask/cigarette,
/turf/open/floor/tile/dark,
/area/bigredv3/inside/secondary/office_complex)
"Aq" = (
/obj/structure/table,
/obj/effect/decal/cleanable/dirt,
/obj/item/paper/janitor,
/turf/open/floor/tile/whiteyellow/full,
/area/bigredv3/inside/secondary/office_complex)
"As" = (
/obj/machinery/light{
	dir = 1
	},
/turf/open/floor,
/area/bigredv3/inside/secondary/office_complex)
"AA" = (
/obj/effect/decal/cleanable/dirt,
/obj/item/trash/eat,
/turf/open/floor,
/area/bigredv3/inside/secondary/office_complex)
"Bd" = (
/obj/machinery/light{
	dir = 4
	},
/obj/structure/bed/chair/comfy/black{
	dir = 8
	},
/obj/effect/decal/cleanable/dirt,
/turf/open/floor,
/area/bigredv3/inside/secondary/office_complex)
"BA" = (
/obj/machinery/air_alarm{
	dir = 4
	},
/turf/open/floor/tile/red/redtaupecorner{
	dir = 8
	},
/area/bigredv3/inside/secondary/office_complex)
"Cz" = (
/obj/machinery/light{
	dir = 8
	},
/obj/effect/decal/cleanable/dirt,
/turf/open/floor/tile/red/redtaupecorner{
	dir = 8
	},
/area/bigredv3/inside/secondary/office_complex)
"CL" = (
/obj/effect/decal/cleanable/dirt,
/obj/machinery/atmospherics/pipe/simple/green/hidden,
/turf/open/floor/tile/whiteyellow/full,
/area/bigredv3/inside/secondary/office_complex)
"Db" = (
/obj/effect/decal/cleanable/dirt,
/obj/item/tool/lighter/random,
/obj/effect/ai_node,
/turf/open/floor/tile/whiteyellow/full,
/area/bigredv3/inside/secondary/office_complex)
"Dq" = (
/turf/open/floor,
/area/bigredv3/inside/secondary/office_complex)
"Dt" = (
/obj/machinery/atmospherics/pipe/simple/green/hidden{
	dir = 4
	},
/obj/effect/decal/cleanable/dirt,
/obj/effect/ai_node,
/turf/open/floor,
/area/bigredv3/inside/secondary/office_complex)
"DG" = (
/obj/effect/decal/cleanable/dirt,
/obj/structure/cable,
/obj/machinery/atmospherics/pipe/simple/green/hidden,
/turf/open/floor/tile/red/redtaupecorner{
	dir = 8
	},
/area/bigredv3/inside/secondary/office_complex)
"DR" = (
/obj/structure/cable,
/obj/machinery/atmospherics/pipe/simple/green/hidden,
/turf/open/floor,
/area/bigredv3/inside/secondary/office_complex)
"Ep" = (
/obj/machinery/atmospherics/pipe/simple/green/hidden,
/obj/structure/cable,
/turf/open/floor,
/area/bigredv3/inside/secondary/office_complex)
"EF" = (
/turf/open/floor/tile/dark,
/area/bigredv3/inside/secondary/office_complex)
"EP" = (
/obj/effect/decal/cleanable/dirt,
/obj/machinery/atmospherics/pipe/simple/green/hidden{
	dir = 4
	},
/turf/open/floor/tile/white,
/area/bigredv3/inside/secondary/office_complex)
"Fg" = (
/obj/structure/bed/chair/office/light,
/turf/open/floor,
/area/bigredv3/inside/secondary/office_complex)
"FH" = (
/obj/effect/decal/cleanable/dirt,
/obj/structure/cable,
/obj/machinery/atmospherics/pipe/simple/green/hidden,
/turf/open/floor,
/area/bigredv3/inside/secondary/office_complex)
"FZ" = (
/turf/open/floor/marking/asteroidwarning{
	dir = 1
	},
/area/bigredv3/outside/directions/e)
"Gm" = (
/obj/machinery/light{
	dir = 4
	},
/obj/effect/ai_node,
/turf/open/floor/tile/red/redtaupecorner,
/area/bigredv3/inside/secondary/office_complex)
"Gq" = (
/turf/closed/wall,
/area/bigredv3/inside/wall)
"Hm" = (
/obj/structure/bed/chair{
	dir = 4
	},
/turf/open/floor,
/area/bigredv3/inside/secondary/office_complex)
"HC" = (
/obj/effect/decal/cleanable/dirt,
/obj/structure/cable,
/turf/open/floor/tile/white,
/area/bigredv3/inside/secondary/office_complex)
"HG" = (
/obj/effect/decal/cleanable/dirt,
/obj/effect/ai_node,
/turf/open/floor/tile/white,
/area/bigredv3/inside/secondary/office_complex)
"HQ" = (
/obj/effect/decal/cleanable/dirt,
/turf/open/floor/marking/asteroidwarning,
/area/bigredv3/outside/directions/central)
"HY" = (
/turf/open/floor/tile/whiteyellow/full,
/area/bigredv3/inside/secondary/office_complex)
"If" = (
/obj/structure/bed/chair/comfy/black{
	dir = 8
	},
/turf/open/floor,
/area/bigredv3/inside/secondary/office_complex)
"Ig" = (
/turf/open/floor/asteroidfloor,
/area/bigredv3/outside/directions/e)
"Ip" = (
/turf/open/floor/marking/asteroidwarning{
	dir = 8
	},
/area/bigredv3/outside/directions/central)
"Iy" = (
/obj/machinery/atmospherics/pipe/simple/green/hidden{
	dir = 4
	},
/obj/structure/cable,
/obj/effect/ai_node,
/turf/open/floor/tile/red/redtaupecorner,
/area/bigredv3/inside/secondary/office_complex)
"IA" = (
/obj/machinery/door/airlock/mainship/generic{
	name = "\improper Private Office"
	},
/turf/open/floor,
/area/bigredv3/inside/secondary/office_complex)
"IL" = (
/obj/structure/table,
/obj/effect/spawner/random/engineering/tech_supply,
/obj/effect/spawner/random/engineering/tech_supply,
/turf/open/floor/tile/white,
/area/bigredv3/inside/secondary/office_complex)
"IO" = (
/obj/item/clothing/shoes/galoshes,
/turf/open/floor/tile/whiteyellow/full,
/area/bigredv3/inside/secondary/office_complex)
"IR" = (
/obj/machinery/photocopier,
/obj/machinery/light{
	dir = 8
	},
/turf/open/floor/tile/white,
/area/bigredv3/inside/secondary/office_complex)
"Jy" = (
/obj/structure/janitorialcart,
/obj/effect/decal/cleanable/dirt,
/turf/open/floor/tile/whiteyellow/full,
/area/bigredv3/inside/secondary/office_complex)
"JI" = (
/obj/effect/decal/cleanable/dirt,
/turf/open/floor,
/area/bigredv3/inside/secondary/office_complex)
"JM" = (
/obj/structure/table,
/obj/machinery/computer/pod/old{
	name = "Personal Computer"
	},
/turf/open/floor,
/area/bigredv3/inside/secondary/office_complex)
"JV" = (
/obj/structure/bed/chair/comfy/lime{
	dir = 4
	},
/turf/open/floor,
/area/bigredv3/inside/secondary/office_complex)
"KM" = (
/obj/structure/table,
/obj/item/paper,
/turf/open/floor/grimy,
/area/bigredv3/inside/secondary/office_complex)
"Lq" = (
/obj/structure/noticeboard{
	dir = 1;
	pixel_y = -27
	},
/obj/effect/decal/cleanable/dirt,
/turf/open/floor/tile/whiteyellow/full,
/area/bigredv3/inside/secondary/office_complex)
"LE" = (
/obj/machinery/prop/autolathe,
/turf/open/floor/tile/white,
/area/bigredv3/inside/secondary/office_complex)
"LH" = (
/obj/machinery/atmospherics/pipe/simple/green/hidden,
/obj/effect/decal/cleanable/dirt,
/turf/open/floor/tile/red/redtaupecorner,
/area/bigredv3/inside/secondary/office_complex)
"LS" = (
/obj/structure/table,
/obj/item/trash/semki,
/turf/open/floor/tile/dark,
/area/bigredv3/inside/secondary/office_complex)
"Mq" = (
/obj/structure/cable,
/obj/machinery/atmospherics/pipe/simple/green/hidden,
/turf/open/floor/tile/red/redtaupecorner{
	dir = 8
	},
/area/bigredv3/inside/secondary/office_complex)
"MP" = (
/obj/machinery/light{
	dir = 8
	},
/turf/open/floor/tile/white,
/area/bigredv3/inside/secondary/office_complex)
"Np" = (
/obj/effect/decal/cleanable/dirt,
/obj/effect/ai_node,
/obj/machinery/light{
	dir = 1
	},
/turf/open/floor,
/area/bigredv3/inside/secondary/office_complex)
"Nq" = (
/turf/open/floor/marking/asteroidwarning{
	dir = 9
	},
/area/bigredv3/outside/directions/central)
"NM" = (
/obj/structure/table,
/obj/item/tool/multitool,
/turf/open/floor/tile/dark,
/area/bigredv3/inside/secondary/office_complex)
"NT" = (
/turf/open/floor/tile/red/redtaupecorner{
	dir = 8
	},
/area/bigredv3/inside/secondary/office_complex)
"NW" = (
/obj/machinery/atmospherics/pipe/manifold/green/hidden,
/obj/structure/cable,
/turf/open/floor/tile/red/redtaupecorner,
/area/bigredv3/inside/secondary/office_complex)
"OI" = (
/obj/structure/table,
/obj/effect/decal/cleanable/dirt,
/obj/item/trash/syndi_cakes,
/obj/machinery/light{
	dir = 4
	},
/turf/open/floor/tile/dark,
/area/bigredv3/inside/secondary/office_complex)
"OL" = (
/obj/machinery/light{
	dir = 4
	},
/turf/open/floor/tile/white,
/area/bigredv3/inside/secondary/office_complex)
"OP" = (
/obj/effect/decal/cleanable/blood/gibs/down,
/turf/open/floor/tile/dark,
/area/bigredv3/inside/secondary/office_complex)
"OS" = (
/obj/machinery/light{
	dir = 4
	},
/obj/structure/table,
/obj/item/paper,
/turf/open/floor,
/area/bigredv3/inside/secondary/office_complex)
"Pb" = (
/turf/open/floor/wood,
/area/bigredv3/inside/secondary/office_complex)
"Pj" = (
/obj/effect/decal/cleanable/blood/gibs,
/turf/open/floor/marking/asteroidwarning,
/area/bigredv3/outside/directions/central)
"Pq" = (
/turf/open/floor/plating/ground/mars/random/sand,
/area/bigredv3/outside/directions/central)
"PX" = (
/obj/effect/decal/cleanable/dirt,
/turf/open/floor/tile/red/redtaupecorner,
/area/bigredv3/inside/secondary/office_complex)
"Qk" = (
/turf/open/floor/marking/asteroidwarning{
	dir = 8
	},
/area/bigredv3/outside/directions/e)
"Ql" = (
/obj/structure/table,
/obj/effect/spawner/random/engineering/tech_supply,
/obj/machinery/light{
	dir = 4
	},
/turf/open/floor/tile/white,
/area/bigredv3/inside/secondary/office_complex)
"Qs" = (
/obj/machinery/vending/cola,
/obj/machinery/light{
	dir = 8
	},
/turf/open/floor,
/area/bigredv3/inside/secondary/office_complex)
"Qy" = (
/turf/open/floor/marking/asteroidwarning{
	dir = 4
	},
/area/bigredv3/outside/directions/se)
"Rc" = (
/obj/machinery/atmospherics/pipe/simple/green/hidden,
/obj/machinery/door/airlock/multi_tile/mainship/generic{
	name = "\improper Robotics"
	},
/obj/structure/cable,
/turf/open/floor,
/area/bigredv3/inside/secondary/office_complex)
"Rh" = (
/obj/structure/table,
/obj/item/trash/kepler,
/obj/machinery/light{
	dir = 8
	},
/turf/open/floor/tile/whiteyellow/full,
/area/bigredv3/inside/secondary/office_complex)
"RB" = (
/obj/machinery/atmospherics/pipe/simple/green/hidden{
	dir = 4
	},
/turf/open/floor/tile/dark,
/area/bigredv3/inside/secondary/office_complex)
"RR" = (
/obj/structure/rack,
/obj/effect/spawner/random/engineering/tech_supply,
/obj/effect/spawner/random/engineering/tech_supply,
/turf/open/floor/tile/white,
/area/bigredv3/inside/secondary/office_complex)
"Sc" = (
/obj/structure/flora/pottedplant,
/turf/open/floor/wood,
/area/bigredv3/inside/secondary/office_complex)
"SK" = (
/obj/structure/table,
/obj/item/reagent_containers/glass/beaker/sulphuric,
/obj/structure/cable,
/obj/machinery/power/apc/weak/ntf,
/turf/open/floor/tile/white,
/area/bigredv3/inside/secondary/office_complex)
"SY" = (
/turf/open/floor/plating/ground/mars/random/dirt,
/area/bigredv3/outside/directions/e)
"SZ" = (
/obj/effect/decal/cleanable/dirt,
/turf/open/floor/wood,
/area/bigredv3/inside/secondary/office_complex)
"Td" = (
/obj/structure/window/framed/colony,
/obj/machinery/door/poddoor/shutters/mainship{
	id = "Office Complex 1";
	name = "\improper Office Complex Shutters"
	},
/turf/open/floor/plating,
/area/bigredv3/inside/wall)
"Tz" = (
/turf/open/floor/plating/ground/mars/dirttosand/autosmooth{
	dir = 6
	},
/area/bigredv3/outside/directions/central)
"TG" = (
/obj/machinery/door/airlock/multi_tile/mainship/generic{
	name = "\improper Office Complex"
	},
/turf/open/floor,
/area/bigredv3/inside/secondary/office_complex)
"Uh" = (
/obj/machinery/atmospherics/pipe/simple/green/hidden{
	dir = 4
	},
/obj/structure/cable,
/obj/effect/ai_node,
/turf/open/floor,
/area/bigredv3/inside/secondary/office_complex)
"Uw" = (
/obj/effect/decal/cleanable/dirt,
/turf/open/floor/tile/red/redtaupecorner{
	dir = 4
	},
/area/bigredv3/inside/secondary/office_complex)
"UD" = (
/turf/open/floor/marking/asteroidwarning,
/area/bigredv3/outside/directions/se)
"UJ" = (
/obj/structure/table,
/obj/effect/decal/cleanable/dirt,
/turf/open/floor/tile/dark,
/area/bigredv3/inside/secondary/office_complex)
"Vs" = (
/obj/structure/mopbucket,
/turf/open/floor/tile/whiteyellow/full,
/area/bigredv3/inside/secondary/office_complex)
"VI" = (
/turf/open/floor/tile/red/redtaupecorner{
	dir = 4
	},
/area/bigredv3/inside/secondary/office_complex)
"We" = (
/obj/structure/cable,
/obj/machinery/door/airlock/mainship/generic{
	dir = 1;
	name = "\improper Private Office"
	},
/turf/open/floor,
/area/bigredv3/inside/secondary/office_complex)
"XB" = (
/obj/structure/mopbucket,
/obj/machinery/light{
	dir = 4
	},
/turf/open/floor/tile/whiteyellow/full,
/area/bigredv3/inside/secondary/office_complex)
"XP" = (
/obj/machinery/atmospherics/pipe/simple/green/hidden,
/obj/effect/decal/cleanable/dirt,
/obj/item/folder/red,
/obj/structure/cable,
/turf/open/floor,
/area/bigredv3/inside/secondary/office_complex)
"Yt" = (
/obj/machinery/door/airlock/multi_tile/mainship/generic{
	name = "\improper Office Complex Janitor Room"
	},
/turf/open/floor,
/area/bigredv3/inside/secondary/office_complex)
"YO" = (
/obj/machinery/atmospherics/pipe/simple/green/hidden{
	dir = 4
	},
/obj/machinery/door/airlock/mainship/generic{
	name = "\improper Office Complex Storage"
	},
/turf/open/floor,
/area/bigredv3/inside/secondary/office_complex)
"Za" = (
/obj/machinery/atmospherics/pipe/simple/green/hidden{
	dir = 4
	},
/obj/machinery/light,
/turf/open/floor/tile/red/redtaupecorner,
/area/bigredv3/inside/secondary/office_complex)
"Zt" = (
/obj/structure/window/framed/colony,
/obj/machinery/door/poddoor/shutters/mainship{
	dir = 2;
	id = "Office Complex 1";
	name = "\improper Office Complex Shutters"
	},
/turf/open/floor/plating,
/area/bigredv3/inside/wall)
"ZG" = (
/obj/structure/table,
/obj/effect/spawner/random/engineering/toolbox,
/turf/open/floor/tile/white,
/area/bigredv3/inside/secondary/office_complex)
"ZR" = (
/obj/machinery/light,
/turf/open/floor/tile/white,
/area/bigredv3/inside/secondary/office_complex)

(1,1,1) = {"
lK
Pq
Nq
Ip
Ip
Ip
Ip
Ip
Ip
Ip
Ip
Ip
Ip
Ip
Ip
Ip
Ip
Ip
Ip
Ip
gf
Pq
Pq
"}
(2,1,1) = {"
lK
Pq
Gq
Gq
Gq
Td
Td
Td
Gq
Gq
Gq
Gq
Gq
Gq
Gq
Td
Td
Td
Gq
Gq
aF
Pq
Pq
"}
(3,1,1) = {"
lK
Pq
Gq
MP
fz
yf
RR
RR
wh
Gq
pL
IR
LE
Gq
iI
aL
EF
aL
LS
Gq
aF
Pq
Pq
"}
(4,1,1) = {"
lK
Pq
Zt
yf
fz
wy
oh
yf
wy
wy
wy
xJ
yf
Gq
aL
rf
dS
dS
zV
Zt
aF
Pq
Pq
"}
(5,1,1) = {"
lK
Pq
Zt
yf
fz
HG
wy
yf
HG
wy
jD
wy
HG
Gq
zj
EF
OP
EF
EF
xx
Pj
Pq
Pq
"}
(6,1,1) = {"
lK
Pq
Zt
yf
fz
wy
zx
wy
wy
Gq
IL
wy
sh
Gq
ho
dS
EF
EF
NM
Zt
aF
Pq
Pq
"}
(7,1,1) = {"
lK
Pq
Gq
yf
fz
yf
yf
jD
wy
Gq
vU
Ql
vU
Gq
RB
EF
EF
OI
UJ
Gq
HQ
Pq
Pq
"}
(8,1,1) = {"
lK
Pq
Gq
yf
fz
yf
yf
wy
ZR
Gq
Gq
Gq
Gq
Gq
YO
Gq
Gq
Gq
Gq
Gq
zJ
Gq
Gq
"}
(9,1,1) = {"
lK
Pq
Gq
Gq
Gq
yf
wy
jz
uG
ie
JV
JV
Gq
ya
qu
ps
ps
ps
ps
ps
um
wr
Mq
"}
(10,1,1) = {"
Tz
Pq
Pq
Pq
Gq
rr
wy
EP
rX
ie
JI
Dq
Gq
VI
Uh
PX
PX
PX
ms
ma
ma
ma
ma
"}
(11,1,1) = {"
Pq
Pq
Pq
Pq
Gq
SK
HC
qa
oU
Ep
XP
Ep
Rc
yu
NW
Gq
Gq
IA
Gq
Gq
Gq
Gq
Gq
"}
(12,1,1) = {"
Gq
Gq
Gq
Gq
Gq
ZG
OL
yf
kF
Dq
vo
JI
Dq
VI
Iy
Gq
SZ
Pb
Pb
dr
en
Gq
UD
"}
(13,1,1) = {"
Gq
aO
Qs
if
Gq
Gq
Gq
Gq
Gq
Gq
Gq
Gq
Gq
Uw
oQ
Gq
Pb
Pb
SZ
SZ
Pb
Zt
nU
"}
(14,1,1) = {"
ut
DR
DR
DR
Mq
Mq
Mq
DG
DG
DG
Mq
yO
Mq
FH
am
Gq
uH
lb
uH
SZ
SZ
Gq
nU
"}
(15,1,1) = {"
Dq
Dq
Dq
JI
PX
PX
PX
ma
Gm
ma
PX
PX
ma
mh
mc
Gq
fW
gh
KM
Pb
Pb
Zt
nU
"}
(16,1,1) = {"
Zt
JI
AA
vb
Gq
Gq
Gq
Gq
Gq
Gq
Gq
Gq
Gq
VI
ei
Gq
kz
tt
lb
Pb
Sc
Gq
nU
"}
(17,1,1) = {"
Gq
hl
Bd
If
Gq
Dq
ic
Dq
Gq
Hm
Hm
zI
Gq
VI
ei
Gq
Gq
Gq
Gq
Gq
Gq
Gq
UD
"}
(18,1,1) = {"
Gq
Gq
Gq
Gq
Gq
xE
vo
Dq
kW
JI
Dq
cg
Gq
nS
Dt
Cz
BA
NT
pt
ld
NT
TG
UD
"}
(19,1,1) = {"
cD
FZ
Ig
pp
Gq
Gq
Gq
Gq
Gq
Np
Dq
JI
We
qB
jl
LH
mq
LH
LH
ao
ma
Dq
UD
"}
(20,1,1) = {"
SY
FZ
Ig
Ig
Zt
Fg
cx
ic
Gq
JI
Dq
za
Gq
VI
xd
Gq
Gq
Gq
Gq
Gq
Gq
Gq
UD
"}
(21,1,1) = {"
Qk
FZ
Ig
Ig
Gq
Dq
Dq
Dq
kW
Dq
Dq
iK
Gq
VI
ei
Gq
Jy
hZ
iu
Rh
Aq
Gq
nU
"}
(22,1,1) = {"
jG
FZ
Ig
Ig
Gq
Gq
Gq
Gq
Gq
As
JI
cg
Gq
VI
Za
Gq
Jy
HY
mu
mu
IO
Gq
nU
"}
(23,1,1) = {"
SY
FZ
Ig
Ig
Gq
Dq
Dq
Dq
kW
Dq
JI
cg
Gq
VI
ei
Gq
rb
HY
mu
mu
HY
Yt
nU
"}
(24,1,1) = {"
cD
FZ
Ig
Ig
Zt
Fg
OS
ic
Gq
Gq
IA
Gq
Gq
qB
mZ
cn
CL
CL
jh
Db
mu
Dq
nU
"}
(25,1,1) = {"
cD
FZ
Ig
Ig
Gq
Gq
Gq
Gq
Gq
eU
Dq
Dq
Gq
nS
ma
HY
HY
mu
mu
xp
Lq
Gq
UD
"}
(26,1,1) = {"
cD
FZ
Ig
pp
Ig
Ig
Ig
Ig
Gq
JM
tx
JI
Gq
VI
ma
Gq
Vs
XB
HY
qU
vW
Gq
UD
"}
(27,1,1) = {"
cD
FZ
Ig
Ig
Ig
Ig
Ig
Ig
Gq
Gq
Gq
Gq
Gq
Dq
mS
Gq
Gq
Gq
Gq
Gq
Gq
Gq
UD
"}
(28,1,1) = {"
cD
bF
jG
jG
jG
jG
jG
jG
jG
jG
jG
jG
Qy
Qy
Qy
Qy
Qy
Qy
Qy
Qy
Qy
Qy
fp
"}
