//MAP CONVERTED BY dmm2tgm.py THIS HEADER COMMENT PREVENTS RECONVERSION, DO NOT REMOVE
"B" = (
/turf/closed/mineral/smooth/bigred,
/area/bigredv2/caves/rock)
"G" = (
/obj/effect/landmark/lv624/fog_blocker/xeno_spawn,
/turf/closed/mineral/smooth/bigred,
/area/bigredv2/caves/rock)
"O" = (
/turf/open/floor/plating/ground/mars/random/cave,
/area/bigredv3/caves/northeast)
"T" = (
/obj/structure/glowshroom,
/turf/open/floor/plating/ground/mars/random/cave,
/area/bigredv3/caves/northeast)

(1,1,1) = {"
O
O
O
O
O
O
B
B
B
B
B
B
B
B
B
"}
(2,1,1) = {"
B
O
O
O
B
B
B
B
B
B
B
B
B
B
B
"}
(3,1,1) = {"
B
O
O
O
O
B
B
B
B
B
B
B
B
B
O
"}
(4,1,1) = {"
B
O
O
O
T
O
O
O
B
B
B
B
B
O
O
"}
(5,1,1) = {"
B
B
O
O
O
O
O
O
O
B
B
B
B
O
O
"}
(6,1,1) = {"
B
B
B
O
O
O
O
O
T
O
B
B
O
O
O
"}
(7,1,1) = {"
B
B
B
B
O
O
O
O
O
O
O
B
O
O
O
"}
(8,1,1) = {"
B
B
B
B
B
O
O
O
O
O
O
O
O
O
O
"}
(9,1,1) = {"
B
B
T
T
B
O
T
O
O
T
O
O
O
O
O
"}
(10,1,1) = {"
B
T
O
O
T
O
O
B
B
B
B
B
O
O
O
"}
(11,1,1) = {"
B
T
O
O
O
O
O
B
B
B
B
B
B
O
O
"}
(12,1,1) = {"
B
T
O
T
O
T
O
T
B
B
B
B
B
B
O
"}
(13,1,1) = {"
B
B
T
T
T
O
T
O
B
B
B
B
B
B
B
"}
(14,1,1) = {"
B
B
B
B
T
T
B
B
B
B
B
B
B
B
B
"}
(15,1,1) = {"
G
G
G
G
G
G
G
G
G
G
G
G
G
G
G
"}
