//MAP CONVERTED BY dmm2tgm.py THIS HEADER COMMENT PREVENTS RECONVERSION, DO NOT REMOVE
"aO" = (
/turf/open/floor/marking/asteroidwarning{
	dir = 1
	},
/area/bigredv3/outside/directions/se)
"by" = (
/obj/effect/turf_decal/warning_stripes/box/empty,
/turf/open/floor,
/area/bigredv3/outside/directions/s)
"bz" = (
/turf/open/floor/plating/ground/mars/random/sand,
/area/bigredv3/outside/directions/se)
"ce" = (
/obj/machinery/portable_atmospherics/scrubber/huge,
/obj/effect/turf_decal/warning_stripes,
/obj/structure/cable,
/turf/open/floor/plating,
/area/bigredv3/inside/engi/east)
"ct" = (
/turf/open/floor,
/area/bigredv3/outside/directions/s)
"cx" = (
/obj/machinery/computer3/server/rack,
/obj/effect/turf_decal/warning_stripes/box/threeside,
/turf/open/floor,
/area/bigredv3/inside/engi/east)
"cT" = (
/obj/effect/ai_node,
/turf/open/floor/plating/ground/mars/random/cave,
/area/bigredv3/outside/directions/se)
"dn" = (
/obj/machinery/light{
	dir = 1
	},
/obj/effect/ai_node,
/turf/open/floor,
/area/bigredv3/inside/engi/east)
"dP" = (
/obj/machinery/atmospherics/pipe/simple/green/hidden{
	dir = 4
	},
/obj/effect/ai_node,
/obj/structure/cable,
/turf/open/floor,
/area/bigredv3/inside/engi/east)
"dR" = (
/obj/effect/decal/cleanable/dirt,
/obj/structure/rack,
/obj/effect/spawner/random/engineering/tool,
/obj/structure/cable,
/turf/open/floor,
/area/bigredv3/inside/engi/east)
"em" = (
/turf/closed/wall,
/area/bigredv3/inside/wall)
"eQ" = (
/obj/machinery/door/airlock/mainship/engineering{
	dir = 1;
	name = "\improper Filtration Facility";
	req_one_access = null
	},
/obj/machinery/atmospherics/pipe/simple/green/hidden,
/obj/structure/cable,
/turf/open/floor,
/area/bigredv3/inside/engi/east)
"eR" = (
/obj/effect/decal/cleanable/dirt,
/obj/effect/turf_decal/warning_stripes/box/empty,
/obj/effect/spawner/random/engineering/structure/tank/fuelweighted,
/turf/open/floor,
/area/bigredv3/outside/directions/s)
"fg" = (
/obj/effect/decal/cleanable/dirt,
/obj/machinery/atmospherics/pipe/simple/green/hidden,
/obj/effect/ai_node,
/turf/open/floor,
/area/bigredv3/inside/engi/east)
"fx" = (
/obj/effect/spawner/random/engineering/pickaxe,
/turf/open/floor,
/area/bigredv3/outside/directions/s)
"fH" = (
/obj/item/clothing/head/warning_cone,
/turf/open/floor/plating/ground/mars/random/sand,
/area/bigredv3/outside/directions/se)
"fI" = (
/obj/effect/spawner/random/engineering/structure/tank_dispenser/oxygenweighted,
/obj/effect/landmark/lv624/fog_blocker,
/turf/open/floor/plating/ground/mars/random/cave,
/area/bigredv3/outside/directions/se)
"gj" = (
/obj/effect/spawner/random/engineering/structure/tank/waterweighted,
/turf/open/floor,
/area/bigredv3/inside/engi/east)
"gl" = (
/obj/machinery/light{
	dir = 1
	},
/obj/item/clothing/head/warning_cone,
/turf/open/floor,
/area/bigredv3/outside/directions/s)
"gw" = (
/obj/effect/ai_node,
/obj/structure/cable,
/turf/open/floor,
/area/bigredv3/inside/engi/east)
"hR" = (
/obj/effect/decal/cleanable/dirt,
/turf/open/floor/marking/asteroidwarning{
	dir = 4
	},
/area/bigredv3/outside/directions/s)
"iQ" = (
/obj/machinery/atmospherics/pipe/simple/green/hidden{
	dir = 4
	},
/obj/structure/cable,
/turf/open/floor,
/area/bigredv3/inside/engi/east)
"jl" = (
/obj/structure/window/framed/colony,
/turf/open/floor/plating,
/area/bigredv2/outside/filtration_plant)
"kf" = (
/obj/effect/decal/cleanable/dirt,
/turf/open/floor,
/area/bigredv3/outside/directions/s)
"kB" = (
/obj/machinery/atmospherics/pipe/simple/green/hidden{
	dir = 9
	},
/obj/effect/decal/cleanable/dirt,
/obj/effect/ai_node,
/obj/structure/cable,
/turf/open/floor,
/area/bigredv3/inside/engi/east)
"kH" = (
/obj/structure/table,
/obj/effect/spawner/random/engineering/toolbox,
/turf/open/floor,
/area/bigredv3/inside/engi/east)
"kI" = (
/obj/effect/landmark/lv624/fog_blocker,
/turf/closed/mineral/smooth/bigred,
/area/bigredv3/caves/rock)
"kO" = (
/obj/machinery/door/airlock/mainship/engineering{
	dir = 1;
	name = "\improper Filtration Facility";
	req_one_access = null
	},
/turf/open/floor,
/area/bigredv3/inside/engi/east)
"kY" = (
/obj/machinery/portable_atmospherics/scrubber/huge,
/obj/effect/turf_decal/warning_stripes,
/turf/open/floor/plating,
/area/bigredv3/inside/engi/east)
"lo" = (
/obj/machinery/door/airlock/mainship/engineering{
	name = "\improper Filtration Facility";
	req_one_access = null
	},
/obj/machinery/atmospherics/pipe/simple/green/hidden{
	dir = 4
	},
/turf/open/floor,
/area/bigredv3/inside/engi/east)
"lt" = (
/obj/structure/table,
/obj/effect/spawner/random/engineering/toolbox,
/obj/machinery/light{
	dir = 1
	},
/turf/open/floor,
/area/bigredv3/inside/engi/east)
"lK" = (
/obj/item/tank/air,
/turf/open/floor/plating/ground/mars/random/cave,
/area/bigredv3/outside/directions/se)
"mH" = (
/obj/item/clothing/head/warning_cone,
/turf/open/floor/plating/ground/mars/random/cave,
/area/bigredv3/outside/directions/se)
"ne" = (
/obj/structure/rack,
/obj/effect/spawner/random/engineering/tool,
/obj/machinery/light,
/obj/structure/cable,
/turf/open/floor,
/area/bigredv3/inside/engi/east)
"ni" = (
/obj/effect/landmark/lv624/fog_blocker,
/turf/closed/wall/r_wall/unmeltable,
/area/bigredv3/inside/wall)
"no" = (
/obj/structure/sign/safety/vent,
/turf/closed/wall/r_wall,
/area/bigredv3/inside/wall)
"nt" = (
/obj/effect/decal/cleanable/dirt,
/obj/item/radio/headset,
/turf/open/floor,
/area/bigredv3/inside/engi/east)
"nO" = (
/obj/structure/cable,
/turf/closed/wall/r_wall,
/area/bigredv3/inside/wall)
"nQ" = (
/obj/machinery/floodlight/outpost/bigred,
/turf/open/floor/plating/ground/mars/random/cave,
/area/bigredv3/outside/directions/se)
"ok" = (
/obj/structure/closet/firecloset/full,
/turf/open/floor,
/area/bigredv3/inside/engi/east)
"oz" = (
/obj/effect/landmark/lv624/fog_blocker,
/turf/open/floor/asteroidfloor,
/area/bigredv3/outside/directions/s)
"pg" = (
/turf/open/floor/plating/ground/mars/random/cave,
/area/bigredv3/outside/directions/se)
"pu" = (
/obj/item/tank/air,
/obj/effect/decal/cleanable/dirt,
/turf/open/floor,
/area/bigredv3/inside/engi/east)
"pX" = (
/obj/machinery/computer/general_air_control,
/turf/open/floor,
/area/bigredv3/inside/engi/east)
"pY" = (
/obj/item/weapon/twohanded/fireaxe,
/turf/open/floor,
/area/bigredv3/inside/engi/east)
"qc" = (
/turf/open/floor/asteroidfloor,
/area/bigredv3/outside/directions/s)
"qp" = (
/obj/machinery/power/geothermal,
/obj/structure/cable,
/turf/open/floor/plating,
/area/bigredv3/inside/engi/east)
"qx" = (
/obj/effect/decal/cleanable/dirt,
/obj/machinery/door/poddoor/shutters/mainship{
	dir = 1;
	id = "FiltrationShutters";
	name = "\improper Airlock Shutters"
	},
/turf/open/floor,
/area/bigredv3/inside/engi/east)
"qK" = (
/obj/effect/landmark/lv624/fog_blocker,
/turf/open/floor/marking/asteroidwarning{
	dir = 8
	},
/area/bigredv3/outside/directions/s)
"rm" = (
/obj/machinery/atmospherics/pipe/manifold/green/hidden,
/obj/effect/decal/cleanable/dirt,
/obj/structure/cable,
/turf/open/floor,
/area/bigredv3/inside/engi/east)
"rF" = (
/obj/effect/decal/cleanable/dirt,
/obj/machinery/atmospherics/pipe/manifold/green/hidden{
	dir = 4
	},
/obj/structure/cable,
/turf/open/floor,
/area/bigredv3/inside/engi/east)
"rT" = (
/obj/effect/decal/cleanable/dirt,
/obj/machinery/atmospherics/pipe/simple/green/hidden{
	dir = 4
	},
/obj/effect/ai_node,
/turf/open/floor,
/area/bigredv3/inside/engi/east)
"rU" = (
/obj/structure/closet/wardrobe/atmospherics_yellow,
/turf/open/floor,
/area/bigredv3/inside/engi/east)
"sk" = (
/obj/effect/spawner/random/engineering/structure/tank_dispenser/oxygenweighted,
/obj/effect/turf_decal/warning_stripes/box/empty,
/turf/open/floor,
/area/bigredv3/inside/engi/east)
"ss" = (
/obj/effect/decal/cleanable/dirt,
/obj/structure/table,
/turf/open/floor,
/area/bigredv3/inside/engi/east)
"tm" = (
/turf/closed/wall/r_wall,
/area/bigredv3/inside/wall)
"tn" = (
/obj/machinery/floodlight/outpost/bigred,
/turf/open/floor/plating/ground/mars/random/sand,
/area/bigredv3/outside/directions/se)
"uc" = (
/obj/effect/turf_decal/warning_stripes/box/empty,
/obj/effect/spawner/random/engineering/structure/tank/waterweighted,
/turf/open/floor,
/area/bigredv3/inside/engi/east)
"ux" = (
/obj/structure/window/framed/colony/reinforced/hull,
/obj/effect/forcefield/allow_bullet_travel,
/turf/open/floor/plating,
/area/bigredv3/inside/wall)
"uU" = (
/obj/machinery/atmospherics/components/unary/vent_pump,
/turf/open/floor,
/area/bigredv3/inside/engi/east)
"vN" = (
/obj/machinery/door/airlock/mainship/engineering{
	dir = 1;
	name = "\improper Atmospherics Condenser";
	req_one_access = null
	},
/turf/open/floor,
/area/bigredv3/inside/engi/east)
"wk" = (
/obj/structure/cryofeed,
/turf/open/floor/engine,
/area/bigredv3/caves/rock)
"wY" = (
/obj/machinery/atmospherics/pipe/simple/green/hidden{
	dir = 5
	},
/obj/structure/cable,
/turf/open/floor,
/area/bigredv3/inside/engi/east)
"xv" = (
/obj/machinery/atmospherics/pipe/simple/green/hidden{
	dir = 5
	},
/turf/open/floor,
/area/bigredv3/inside/engi/east)
"xD" = (
/obj/structure/table,
/obj/item/tool/lighter/random,
/obj/effect/decal/cleanable/dirt,
/turf/open/floor,
/area/bigredv3/inside/engi/east)
"xE" = (
/obj/structure/cargo_container/ch_red{
	dir = 1
	},
/obj/effect/landmark/lv624/fog_blocker,
/obj/effect/turf_decal/warning_stripes/box/empty,
/turf/open/floor,
/area/bigredv3/outside/directions/s)
"xJ" = (
/obj/machinery/atmospherics/components/unary/vent_pump,
/obj/effect/decal/cleanable/dirt,
/obj/effect/decal/cleanable/dirt,
/obj/structure/cable,
/turf/open/floor,
/area/bigredv3/inside/engi/east)
"xL" = (
/obj/structure/fence/standard/xenoproof,
/turf/open/floor/plating/ground/mars/random/cave,
/area/bigredv3/outside/directions/se)
"xW" = (
/obj/machinery/door_control{
	id = "FiltrationShutters";
	name = "Airlock Shutters"
	},
/turf/open/floor,
/area/bigredv3/outside/directions/s)
"xY" = (
/obj/structure/cryofeed/right{
	name = "\improper coolant feed"
	},
/turf/open/floor/engine,
/area/bigredv3/caves/rock)
"yj" = (
/obj/structure/window/framed/colony,
/obj/structure/sign/safety/vent,
/turf/open/floor/plating,
/area/bigredv3/inside/engi/east)
"yA" = (
/obj/structure/window/framed/colony,
/turf/open/floor/plating,
/area/bigredv3/inside/engi/east)
"yG" = (
/obj/structure/cable,
/turf/open/floor/plating,
/area/bigredv3/inside/engi/east)
"yS" = (
/obj/effect/ai_node,
/turf/open/floor/asteroidfloor,
/area/bigredv3/outside/directions/s)
"ze" = (
/obj/structure/table,
/turf/open/floor,
/area/bigredv3/inside/engi/east)
"zq" = (
/obj/effect/landmark/lv624/fog_blocker,
/turf/open/floor/marking/asteroidwarning{
	dir = 4
	},
/area/bigredv3/outside/directions/s)
"zD" = (
/obj/effect/forcefield/allow_bullet_travel,
/turf/closed/wall/r_wall/unmeltable,
/area/bigredv3/inside/wall)
"zX" = (
/obj/machinery/door/poddoor/shutters/mainship{
	dir = 1;
	id = "FiltrationShutters";
	name = "\improper Airlock Shutters"
	},
/turf/open/floor,
/area/bigredv3/inside/engi/east)
"AH" = (
/obj/structure/cargo_container/ch_red{
	dir = 4
	},
/obj/effect/turf_decal/warning_stripes/box/empty,
/turf/open/floor,
/area/bigredv3/outside/directions/s)
"BP" = (
/turf/closed/wall/r_wall/unmeltable,
/area/bigredv3/inside/wall)
"CD" = (
/obj/effect/ai_node,
/turf/open/floor,
/area/bigredv3/outside/directions/s)
"CJ" = (
/obj/structure/table,
/obj/effect/spawner/random/engineering/technology_scanner,
/turf/open/floor,
/area/bigredv3/inside/engi/east)
"CW" = (
/turf/open/floor/marking/asteroidwarning{
	dir = 9
	},
/area/bigredv3/outside/directions/se)
"Dl" = (
/obj/effect/decal/cleanable/dirt,
/obj/machinery/atmospherics/pipe/simple/green/hidden{
	dir = 4
	},
/obj/structure/cable,
/turf/open/floor,
/area/bigredv3/inside/engi/east)
"Dx" = (
/obj/machinery/door/airlock/mainship/engineering{
	dir = 1;
	name = "\improper Atmospherics Condenser";
	req_one_access = null
	},
/obj/machinery/atmospherics/pipe/simple/green/hidden,
/obj/structure/cable,
/turf/open/floor,
/area/bigredv3/inside/engi/east)
"Ey" = (
/obj/machinery/atmospherics/components/unary/vent_pump{
	dir = 4
	},
/obj/effect/ai_node,
/turf/open/floor,
/area/bigredv3/inside/engi/east)
"Fe" = (
/obj/effect/turf_decal/warning_stripes/box/empty,
/obj/effect/spawner/random/engineering/structure/tank/fuelweighted,
/turf/open/floor,
/area/bigredv3/inside/engi/east)
"Fi" = (
/obj/effect/ai_node,
/obj/machinery/power/apc/weak/ntf,
/obj/structure/cable,
/turf/open/floor,
/area/bigredv3/inside/engi/east)
"FG" = (
/obj/effect/decal/cleanable/dirt,
/obj/machinery/atmospherics/pipe/simple/green/hidden{
	dir = 10
	},
/obj/structure/cable,
/turf/open/floor,
/area/bigredv3/inside/engi/east)
"FY" = (
/obj/effect/decal/cleanable/dirt,
/obj/machinery/atmospherics/pipe/simple/green/hidden{
	dir = 10
	},
/turf/open/floor,
/area/bigredv3/inside/engi/east)
"GD" = (
/turf/open/floor/plating,
/area/bigredv3/inside/engi/east)
"Ha" = (
/obj/effect/turf_decal/warning_stripes/box/threeside,
/obj/machinery/computer3/server/rack,
/turf/open/floor,
/area/bigredv3/inside/engi/east)
"Hd" = (
/obj/structure/window/framed/colony/reinforced,
/turf/open/floor/plating,
/area/bigredv3/inside/wall)
"Ht" = (
/obj/effect/turf_decal/warning_stripes/box/empty,
/turf/open/floor,
/area/bigredv3/inside/engi/east)
"HM" = (
/turf/open/floor,
/area/bigredv3/inside/engi/east)
"If" = (
/obj/effect/decal/cleanable/dirt,
/obj/structure/window/framed/colony,
/obj/structure/cable,
/turf/open/floor/plating,
/area/bigredv3/inside/engi/east)
"Is" = (
/turf/open/floor/marking/asteroidwarning{
	dir = 4
	},
/area/bigredv3/outside/directions/s)
"Iy" = (
/obj/structure/table,
/obj/effect/spawner/random/engineering/tool,
/turf/open/floor,
/area/bigredv3/inside/engi/east)
"IM" = (
/obj/structure/cable,
/turf/open/floor,
/area/bigredv3/inside/engi/east)
"Jl" = (
/turf/closed/mineral/smooth/bigred,
/area/bigredv3/caves/rock)
"Jp" = (
/obj/item/tank/air,
/turf/open/floor,
/area/bigredv3/outside/directions/s)
"Ju" = (
/obj/effect/decal/cleanable/dirt,
/obj/effect/forcefield/allow_bullet_travel,
/turf/closed/wall/r_wall/unmeltable,
/area/bigredv3/inside/wall)
"JF" = (
/obj/machinery/computer/area_atmos/area,
/turf/open/floor,
/area/bigredv3/inside/engi/east)
"KE" = (
/obj/machinery/power/geothermal,
/obj/structure/cable,
/obj/machinery/light{
	dir = 4
	},
/turf/open/floor/plating,
/area/bigredv3/inside/engi/east)
"LK" = (
/obj/effect/turf_decal/warning_stripes/box/empty,
/obj/effect/spawner/random/misc/structure/supplycrate,
/turf/open/floor,
/area/bigredv3/inside/engi/east)
"LX" = (
/obj/machinery/atmospherics/pipe/simple/green/hidden,
/obj/structure/cable,
/turf/open/floor,
/area/bigredv3/inside/engi/east)
"Mj" = (
/obj/structure/table,
/obj/machinery/door_control/old{
	id = "FiltrationShutters";
	name = "Airlock Shutters";
	pixel_y = 2
	},
/turf/open/floor,
/area/bigredv3/inside/engi/east)
"Mx" = (
/obj/structure/cargo_container/ch_red,
/obj/effect/turf_decal/warning_stripes/box/empty,
/turf/open/floor,
/area/bigredv3/outside/directions/s)
"ME" = (
/obj/effect/landmark/lv624/fog_blocker,
/turf/open/floor/plating/ground/mars/random/cave,
/area/bigredv3/outside/directions/se)
"Np" = (
/obj/machinery/atmospherics/pipe/manifold/green/hidden,
/obj/effect/ai_node,
/obj/structure/cable,
/turf/open/floor,
/area/bigredv3/inside/engi/east)
"Nq" = (
/obj/machinery/floodlight/outpost/bigred,
/turf/open/floor/asteroidfloor,
/area/bigredv3/outside/directions/s)
"Ny" = (
/turf/open/floor/marking/asteroidwarning{
	dir = 5
	},
/area/bigredv3/outside/directions/se)
"NN" = (
/obj/machinery/light,
/obj/effect/ai_node,
/turf/open/floor/asteroidfloor,
/area/bigredv3/outside/directions/s)
"NR" = (
/obj/machinery/portable_atmospherics/scrubber/huge,
/turf/open/floor/plating,
/area/bigredv3/inside/engi/east)
"OK" = (
/obj/machinery/atmospherics/pipe/simple/green/hidden{
	dir = 4
	},
/obj/machinery/door/airlock/mainship/engineering{
	name = "\improper Atmospherics Condenser Storage";
	req_one_access = null
	},
/obj/structure/cable,
/turf/open/floor,
/area/bigredv3/inside/engi/east)
"PG" = (
/obj/effect/ai_node,
/turf/open/floor,
/area/bigredv3/inside/engi/east)
"Qo" = (
/obj/machinery/atmospherics/pipe/manifold/green/hidden,
/turf/open/floor,
/area/bigredv3/inside/engi/east)
"Qp" = (
/obj/effect/ai_node,
/obj/effect/turf_decal/warning_stripes/box/empty,
/turf/open/floor,
/area/bigredv3/inside/engi/east)
"Qt" = (
/obj/effect/landmark/lv624/fog_blocker,
/obj/machinery/floodlight/outpost/bigred,
/turf/open/floor/plating/ground/mars/random/cave,
/area/bigredv3/outside/directions/se)
"Rb" = (
/obj/structure/window/framed/colony,
/turf/open/floor/plating,
/area/bigredv3/inside/wall)
"Rj" = (
/obj/machinery/door/poddoor/shutters/mainship{
	dir = 1;
	id = "FiltrationShutters";
	name = "\improper Airlock Shutters"
	},
/turf/open/floor/marking/delivery,
/area/bigredv3/inside/engi/east)
"Ru" = (
/obj/effect/decal/cleanable/dirt,
/turf/closed/wall,
/area/bigredv3/inside/wall)
"Rz" = (
/obj/effect/landmark/lv624/fog_blocker,
/obj/effect/turf_decal/warning_stripes/box/empty,
/turf/open/floor,
/area/bigredv3/outside/directions/s)
"SI" = (
/obj/machinery/computer3/server/rack,
/obj/effect/turf_decal/warning_stripes/box/threeside{
	dir = 1
	},
/turf/open/floor,
/area/bigredv3/inside/engi/east)
"SR" = (
/obj/machinery/computer/atmos_alert{
	dir = 8
	},
/obj/structure/table,
/turf/open/floor,
/area/bigredv3/inside/engi/east)
"Te" = (
/obj/effect/decal/cleanable/dirt,
/obj/effect/decal/cleanable/dirt,
/obj/structure/cable,
/obj/machinery/atmospherics/pipe/simple/green/hidden{
	dir = 5
	},
/turf/open/floor,
/area/bigredv3/inside/engi/east)
"Tm" = (
/obj/machinery/atmospherics/pipe/simple/green/hidden{
	dir = 4
	},
/obj/effect/ai_node,
/turf/open/floor,
/area/bigredv3/inside/engi/east)
"TA" = (
/obj/structure/rack,
/obj/item/tank/air,
/obj/effect/spawner/random/engineering/pickaxe,
/turf/open/floor,
/area/bigredv3/inside/engi/east)
"TO" = (
/obj/effect/decal/cleanable/dirt,
/obj/effect/decal/cleanable/dirt,
/turf/open/floor,
/area/bigredv3/inside/engi/east)
"UH" = (
/turf/open/floor/marking/asteroidwarning{
	dir = 8
	},
/area/bigredv3/outside/directions/s)
"UL" = (
/obj/machinery/light{
	dir = 1
	},
/turf/open/floor,
/area/bigredv3/inside/engi/east)
"UP" = (
/obj/effect/landmark/lv624/fog_blocker,
/turf/open/floor,
/area/bigredv3/outside/directions/s)
"VK" = (
/obj/machinery/atmospherics/pipe/simple/green/hidden{
	dir = 10
	},
/obj/effect/ai_node,
/turf/open/floor,
/area/bigredv3/inside/engi/east)
"Wn" = (
/obj/structure/table,
/obj/effect/spawner/random/engineering/technology_scanner,
/obj/machinery/light,
/turf/open/floor,
/area/bigredv3/inside/engi/east)
"Wt" = (
/obj/machinery/atmospherics/pipe/simple/green/hidden{
	dir = 4
	},
/turf/open/floor,
/area/bigredv3/inside/engi/east)
"Wy" = (
/obj/effect/decal/cleanable/dirt,
/turf/open/floor,
/area/bigredv3/inside/engi/east)
"WS" = (
/obj/structure/bed/chair{
	dir = 4
	},
/obj/effect/decal/cleanable/dirt,
/turf/open/floor,
/area/bigredv3/inside/engi/east)
"Xr" = (
/obj/machinery/light,
/turf/open/floor,
/area/bigredv3/inside/engi/east)
"XH" = (
/obj/structure/table,
/obj/item/circuitboard/solar_tracker,
/turf/open/floor,
/area/bigredv3/inside/engi/east)
"Yh" = (
/obj/effect/ai_node,
/turf/open/floor/plating/ground/mars/random/sand,
/area/bigredv3/outside/directions/se)
"ZD" = (
/obj/machinery/light,
/turf/open/floor,
/area/bigredv3/outside/directions/s)

(1,1,1) = {"
em
OK
em
em
em
em
em
em
em
Rb
Rb
Hd
BP
BP
BP
BP
qc
qc
qc
qc
qc
qc
qc
qc
em
"}
(2,1,1) = {"
rU
iQ
gj
em
Fe
Ht
Fe
Fe
em
HM
HM
pY
BP
Jl
Jl
BP
qc
qc
qc
yS
qc
Nq
qc
NN
BP
"}
(3,1,1) = {"
rU
dP
Xr
em
UL
PG
HM
HM
kO
HM
Ey
HM
BP
BP
BP
BP
Is
Is
Is
Is
hR
Is
Is
Is
tm
"}
(4,1,1) = {"
rU
iQ
HM
em
sk
uc
sk
Ht
em
HM
Wt
HM
ss
HM
Mj
tm
xW
ct
ct
kf
ct
kf
ct
ct
tm
"}
(5,1,1) = {"
em
OK
em
em
em
em
em
em
em
UL
Wt
HM
HM
HM
Xr
tm
gl
kf
kf
kf
ct
by
by
ZD
tm
"}
(6,1,1) = {"
xD
Dl
Wy
em
Fi
cx
SI
HM
em
HM
Wt
Qp
Ht
Ht
PG
Rj
ct
kf
kf
CD
ct
by
Mx
ct
BP
"}
(7,1,1) = {"
Wy
FG
xv
vN
IM
HM
HM
PG
kO
HM
Tm
Fe
LK
Ht
HM
Rj
ct
UP
UP
UP
UP
Rz
xE
UP
ni
"}
(8,1,1) = {"
Te
xJ
rm
jl
IM
Ha
SI
Wy
Rb
Wy
Wt
Ht
Ht
LK
HM
Rj
ct
UP
ct
ct
ct
by
AH
ct
BP
"}
(9,1,1) = {"
FY
fg
rF
Dx
LX
LX
wY
gw
Rb
HM
Wt
Ht
Ht
Ht
PG
Rj
ct
UP
ct
CD
Jp
eR
by
ZD
tm
"}
(10,1,1) = {"
Wy
nt
WS
em
dn
HM
rT
ne
em
UL
Wt
HM
HM
HM
Xr
tm
gl
UP
ct
fx
ct
by
by
ct
tm
"}
(11,1,1) = {"
ze
JF
SR
em
ok
uU
Qo
dR
em
em
lo
em
zD
ux
ux
zD
ct
UP
ct
ct
ct
ct
ct
ct
tm
"}
(12,1,1) = {"
Rb
Rb
Rb
em
ok
HM
Wt
IM
em
HM
Wt
CJ
zD
xY
xY
zD
UH
qK
UH
UH
UH
UH
UH
UH
tm
"}
(13,1,1) = {"
GD
NR
GD
em
pX
HM
VK
LX
eQ
LX
Np
CJ
Ju
wk
wk
zD
qc
oz
qc
yS
qc
Nq
qc
NN
tm
"}
(14,1,1) = {"
yG
yG
yG
em
lt
HM
HM
Xr
Ru
UL
iQ
Wn
zD
xY
xY
zD
Is
zq
Is
Is
hR
Is
Is
Is
em
"}
(15,1,1) = {"
qp
KE
qp
em
Iy
kH
ze
XH
em
HM
iQ
CJ
zD
wk
wk
zD
pg
ME
pg
pg
pg
pg
pg
xL
xL
"}
(16,1,1) = {"
em
em
em
em
em
em
Ru
em
em
HM
iQ
HM
zD
ux
ux
zD
pg
fI
lK
pg
pg
pg
xL
xL
pg
"}
(17,1,1) = {"
bz
bz
bz
bz
fH
tm
UL
TA
TA
HM
iQ
Xr
em
mH
pg
pg
pg
Qt
pg
pg
pg
xL
xL
pg
pg
"}
(18,1,1) = {"
Jl
bz
bz
bz
CW
zX
HM
HM
HM
HM
iQ
Wy
qx
pg
pg
pg
pg
ME
pg
pg
xL
xL
pg
pg
pg
"}
(19,1,1) = {"
Jl
bz
Yh
bz
aO
zX
PG
HM
HM
uU
kB
HM
zX
cT
pg
pg
pg
ME
cT
xL
xL
pg
cT
pg
cT
"}
(20,1,1) = {"
bz
bz
bz
bz
Ny
zX
HM
HM
Wy
pu
IM
TO
zX
pg
pg
pg
pg
ME
xL
xL
pg
pg
pg
pg
pg
"}
(21,1,1) = {"
bz
bz
bz
bz
fH
tm
UL
ok
ok
HM
IM
Xr
tm
mH
pg
pg
pg
ME
xL
pg
pg
pg
pg
pg
pg
"}
(22,1,1) = {"
bz
bz
tn
bz
bz
tm
tm
no
tm
yA
If
yj
tm
pg
pg
pg
pg
ME
xL
pg
pg
pg
pg
pg
pg
"}
(23,1,1) = {"
bz
bz
bz
bz
bz
bz
bz
bz
tm
kY
ce
kY
tm
Jl
pg
nQ
Jl
kI
xL
pg
pg
pg
pg
pg
pg
"}
(24,1,1) = {"
bz
bz
Yh
bz
bz
bz
bz
Yh
tm
tm
nO
tm
tm
Jl
Jl
Jl
Jl
Jl
kI
cT
pg
pg
pg
pg
cT
"}
