//MAP CONVERTED BY dmm2tgm.py THIS HEADER COMMENT PREVENTS RECONVERSION, DO NOT REMOVE
"ce" = (
/obj/structure/bookcase,
/obj/item/book/manual/engineering_construction,
/obj/item/book/manual/engineering_guide,
/turf/open/floor/wood,
/area/bigredv3/inside/colony/library)
"da" = (
/obj/machinery/light{
	dir = 4
	},
/obj/machinery/power/apc/weak/ntf,
/obj/structure/cable,
/obj/effect/ai_node,
/turf/open/floor/wood,
/area/bigredv3/inside/colony/library)
"eF" = (
/obj/structure/bookcase,
/obj/item/book/manual/barman_recipes,
/turf/open/floor/wood,
/area/bigredv3/inside/colony/library)
"gS" = (
/obj/structure/table/wood,
/obj/item/book/manual/nuclear,
/turf/open/floor/wood,
/area/bigredv3/inside/colony/library)
"iU" = (
/obj/structure/cable,
/obj/machinery/atmospherics/components/unary/vent_pump{
	dir = 8;
	on = 1
	},
/turf/open/floor/wood,
/area/bigredv3/inside/colony/library)
"iX" = (
/obj/machinery/atmospherics/pipe/simple/green/hidden,
/obj/structure/cable,
/turf/open/floor/carpet/side{
	dir = 5
	},
/area/bigredv3/inside/colony/library)
"jD" = (
/obj/machinery/atmospherics/pipe/simple/green/hidden,
/obj/machinery/door/airlock/multi_tile/mainship/generic{
	name = "\improper Library"
	},
/obj/structure/cable,
/turf/open/floor/wood,
/area/bigredv3/inside/colony/library)
"li" = (
/obj/machinery/door_control{
	dir = 8;
	id = "Library";
	name = "Storm Shutters"
	},
/turf/open/floor/wood,
/area/bigredv3/inside/colony/library)
"lB" = (
/obj/structure/cable,
/obj/machinery/atmospherics/pipe/simple/green/hidden,
/turf/open/floor/wood,
/area/bigredv3/inside/colony/library)
"oL" = (
/turf/open/floor/carpet/side{
	dir = 1
	},
/area/bigredv3/inside/colony/library)
"pO" = (
/obj/structure/window/framed/colony,
/obj/machinery/door/poddoor/shutters/mainship{
	id = "Library";
	name = "\improper Library Shutters"
	},
/turf/open/floor/plating,
/area/bigredv3/inside/wall)
"pV" = (
/obj/structure/table/wood,
/obj/item/toy/dice/d20,
/turf/open/floor/wood,
/area/bigredv3/inside/colony/library)
"ql" = (
/obj/structure/window/framed/colony,
/obj/machinery/door/poddoor/shutters/mainship{
	dir = 2;
	id = "Library";
	name = "\improper Library Shutters"
	},
/turf/open/floor/plating,
/area/bigredv3/inside/wall)
"qr" = (
/obj/structure/bookcase,
/obj/item/book/manual/detective,
/turf/open/floor/wood,
/area/bigredv3/inside/colony/library)
"qY" = (
/obj/structure/bookcase,
/obj/item/book/manual/ripley_build_and_repair,
/turf/open/floor/wood,
/area/bigredv3/inside/colony/library)
"ua" = (
/turf/open/floor/carpet/side,
/area/bigredv3/inside/colony/library)
"uo" = (
/obj/structure/bookcase,
/obj/item/book/manual/engineering_particle_accelerator,
/obj/item/book/manual/engineering_singularity_safety,
/turf/open/floor/wood,
/area/bigredv3/inside/colony/library)
"vg" = (
/obj/structure/cable,
/obj/machinery/atmospherics/pipe/simple/green/hidden{
	dir = 4
	},
/turf/open/floor/wood,
/area/bigredv3/inside/colony/library)
"vJ" = (
/obj/structure/cable,
/obj/machinery/atmospherics/pipe/simple/green/hidden{
	dir = 6
	},
/turf/open/floor/wood,
/area/bigredv3/inside/colony/library)
"xz" = (
/turf/open/floor/carpet/side{
	dir = 6
	},
/area/bigredv3/inside/colony/library)
"yu" = (
/obj/structure/bookcase,
/obj/item/book/manual/evaguide,
/obj/item/book/manual/marine_law,
/turf/open/floor/wood,
/area/bigredv3/inside/colony/library)
"yy" = (
/turf/closed/wall,
/area/bigredv3/inside/wall)
"yG" = (
/turf/open/floor/marking/asteroidwarning{
	dir = 4
	},
/area/bigredv3/outside/directions/e)
"yM" = (
/obj/machinery/atmospherics/pipe/simple/green/hidden,
/obj/structure/cable,
/turf/open/floor/carpet,
/area/bigredv3/inside/colony/library)
"AN" = (
/turf/open/floor/carpet/side{
	dir = 9
	},
/area/bigredv3/inside/colony/library)
"AY" = (
/obj/structure/bookcase,
/obj/item/book/manual/chef_recipes,
/turf/open/floor/wood,
/area/bigredv3/inside/colony/library)
"Bm" = (
/obj/machinery/atmospherics/pipe/simple/green/hidden{
	dir = 4
	},
/obj/structure/cable,
/obj/machinery/door/airlock/mainship/medical/glass/free_access{
	name = "\improper Greenhouse Storage"
	},
/turf/open/floor/wood,
/area/bigredv3/inside/colony/library)
"Cn" = (
/obj/machinery/atmospherics/pipe/simple/green/hidden,
/obj/structure/cable,
/turf/open/floor/marking/asteroidwarning{
	dir = 8
	},
/area/bigredv3/outside/directions/e)
"Dt" = (
/obj/structure/cable,
/obj/machinery/atmospherics/pipe/simple/green/hidden{
	dir = 4
	},
/obj/machinery/door/airlock/mainship/generic{
	name = "\improper Library Backroom"
	},
/turf/open/floor/wood,
/area/bigredv3/inside/colony/library)
"Ey" = (
/obj/structure/bed/chair/wood/normal{
	dir = 1
	},
/turf/open/floor/wood,
/area/bigredv3/inside/colony/library)
"EI" = (
/obj/machinery/atmospherics/pipe/simple/green/hidden{
	dir = 4
	},
/obj/structure/cable,
/turf/open/floor/wood,
/area/bigredv3/inside/colony/library)
"Fe" = (
/obj/structure/bookcase,
/obj/item/book/manual/engineering_guide,
/obj/item/book/manual/nuclear,
/turf/open/floor/wood,
/area/bigredv3/inside/colony/library)
"Ft" = (
/obj/structure/table/wood,
/turf/open/floor/wood,
/area/bigredv3/inside/colony/library)
"FB" = (
/obj/machinery/light{
	dir = 1
	},
/obj/effect/ai_node,
/turf/open/floor/wood,
/area/bigredv3/inside/colony/library)
"FH" = (
/obj/machinery/air_alarm{
	dir = 4
	},
/turf/open/floor/wood,
/area/bigredv3/inside/colony/library)
"Ht" = (
/obj/machinery/atmospherics/pipe/simple/green/hidden{
	dir = 10
	},
/obj/structure/cable,
/turf/open/floor/carpet/side,
/area/bigredv3/inside/colony/library)
"HF" = (
/obj/machinery/atmospherics/pipe/manifold/green/hidden{
	dir = 4
	},
/obj/effect/ai_node,
/obj/structure/cable,
/turf/open/floor/wood,
/area/bigredv3/inside/colony/library)
"JC" = (
/obj/machinery/atmospherics/pipe/simple/green/hidden{
	dir = 5
	},
/obj/structure/cable,
/turf/open/floor/carpet/side,
/area/bigredv3/inside/colony/library)
"JQ" = (
/obj/structure/bookcase,
/obj/item/book/manual/engineering_singularity_safety,
/turf/open/floor/wood,
/area/bigredv3/inside/colony/library)
"KJ" = (
/obj/machinery/light{
	dir = 4
	},
/turf/open/floor/wood,
/area/bigredv3/inside/colony/library)
"LK" = (
/obj/machinery/light{
	dir = 8
	},
/turf/open/floor/wood,
/area/bigredv3/inside/colony/library)
"Mb" = (
/obj/machinery/light,
/turf/open/floor/wood,
/area/bigredv3/inside/colony/library)
"MU" = (
/obj/structure/bed/chair/wood/normal,
/turf/open/floor/wood,
/area/bigredv3/inside/colony/library)
"Nc" = (
/obj/structure/cable,
/obj/machinery/atmospherics/pipe/simple/green/hidden{
	dir = 9
	},
/turf/open/floor/wood,
/area/bigredv3/inside/colony/library)
"Nh" = (
/obj/structure/bookcase,
/obj/item/book/manual/medical_cloning,
/turf/open/floor/wood,
/area/bigredv3/inside/colony/library)
"NC" = (
/turf/open/floor/carpet/side{
	dir = 5
	},
/area/bigredv3/inside/colony/library)
"NO" = (
/turf/open/floor/wood,
/area/bigredv3/inside/colony/library)
"NR" = (
/obj/structure/table/wood,
/obj/item/paper,
/turf/open/floor/wood,
/area/bigredv3/inside/colony/library)
"OB" = (
/obj/structure/bookcase,
/obj/item/book/manual/engineering_guide,
/turf/open/floor/wood,
/area/bigredv3/inside/colony/library)
"PW" = (
/obj/structure/bookcase,
/obj/item/book/manual/atmospipes,
/turf/open/floor/wood,
/area/bigredv3/inside/colony/library)
"QC" = (
/turf/open/floor/plating/ground/mars/random/dirt,
/area/bigredv3/outside/directions/e)
"Sj" = (
/turf/open/floor/carpet/side{
	dir = 10
	},
/area/bigredv3/inside/colony/library)
"Sy" = (
/obj/machinery/atmospherics/pipe/simple/green/hidden,
/obj/effect/ai_node,
/obj/structure/cable,
/turf/open/floor/carpet/side{
	dir = 4
	},
/area/bigredv3/inside/colony/library)
"SK" = (
/obj/machinery/atmospherics/pipe/simple/green/hidden,
/obj/structure/cable,
/turf/open/floor/wood,
/area/bigredv3/inside/colony/library)
"VR" = (
/obj/structure/bookcase,
/obj/item/book/manual/engineering_construction,
/turf/open/floor/wood,
/area/bigredv3/inside/colony/library)
"Wf" = (
/turf/open/floor/carpet/side{
	dir = 8
	},
/area/bigredv3/inside/colony/library)
"WJ" = (
/obj/machinery/atmospherics/pipe/simple/green/hidden,
/obj/structure/cable,
/turf/open/floor/carpet/side{
	dir = 4
	},
/area/bigredv3/inside/colony/library)
"WY" = (
/obj/effect/ai_node,
/turf/open/floor/wood,
/area/bigredv3/inside/colony/library)
"YQ" = (
/obj/structure/bookcase,
/obj/item/book/manual/engineering_construction,
/obj/item/book/manual/marine_law,
/turf/open/floor/wood,
/area/bigredv3/inside/colony/library)

(1,1,1) = {"
yy
yy
yy
yy
Bm
yy
yy
yy
yy
yy
yy
yy
yy
yy
yy
yy
yy
yy
"}
(2,1,1) = {"
yy
AY
NO
NO
EI
OB
LK
ce
FH
JQ
LK
qY
NO
VR
LK
NO
yy
QC
"}
(3,1,1) = {"
yy
eF
NO
NO
EI
PW
NO
uo
NO
YQ
NO
Nh
NO
qr
NO
NO
ql
QC
"}
(4,1,1) = {"
yy
NO
NO
NO
vg
AN
Wf
Wf
Wf
Wf
Wf
Wf
Wf
Wf
Sj
NO
ql
QC
"}
(5,1,1) = {"
yy
yu
WY
vJ
HF
iX
WJ
WJ
WJ
WJ
WJ
Sy
WJ
yM
JC
Mb
yy
QC
"}
(6,1,1) = {"
yy
FB
NO
vg
NO
NO
NO
NO
NO
NO
NO
uo
WY
oL
Ht
SK
jD
Cn
"}
(7,1,1) = {"
yy
vJ
lB
Nc
li
NO
MU
NR
pV
Ey
NO
NO
NO
oL
ua
NO
NO
yG
"}
(8,1,1) = {"
yy
Dt
yy
yy
yy
NO
MU
Ft
gS
Ey
NO
Fe
NO
oL
ua
Mb
yy
QC
"}
(9,1,1) = {"
yy
iU
Ft
Ft
yy
NO
NO
NO
NO
NO
NO
qY
NO
NC
xz
NO
ql
QC
"}
(10,1,1) = {"
yy
da
NO
NO
yy
KJ
NO
NO
NO
KJ
NO
NO
KJ
NO
NO
NO
ql
QC
"}
(11,1,1) = {"
yy
yy
yy
yy
yy
yy
yy
pO
pO
yy
pO
pO
yy
pO
pO
yy
yy
QC
"}
