//MAP CONVERTED BY dmm2tgm.py THIS HEADER COMMENT PREVENTS RECONVERSION, DO NOT REMOVE
"d" = (
/obj/effect/landmark/lv624/fog_blocker/xeno_spawn,
/turf/closed/mineral/smooth/bigred,
/area/bigredv2/caves/rock)
"f" = (
/turf/open/floor/plating/ground/mars/random/cave,
/area/bigredv2/caves/southwest)
"m" = (
/obj/effect/landmark/patrol_point/som/som_11,
/turf/open/floor/plating/ground/mars/random/cave/rock,
/area/bigredv2/caves/southwest)
"p" = (
/obj/effect/ai_node,
/turf/open/floor/plating/ground/mars/random/cave/rock,
/area/bigredv2/caves/southwest)
"r" = (
/obj/effect/landmark/excavation_site_spawner,
/turf/open/floor/plating/ground/mars/random/cave,
/area/bigredv2/caves/southwest)
"t" = (
/obj/effect/ai_node,
/turf/open/floor/plating/ground/mars/random/cave,
/area/bigredv2/caves/southwest)
"w" = (
/obj/effect/landmark/lv624/fog_blocker,
/turf/closed/mineral/smooth/bigred,
/area/bigredv2/caves/rock)
"E" = (
/turf/open/floor/plating/ground/mars/random/cave/rock,
/area/bigredv2/caves/southwest)
"F" = (
/obj/effect/landmark/excavation_site_spawner,
/obj/effect/ai_node,
/turf/open/floor/plating/ground/mars/random/cave,
/area/bigredv2/caves/southwest)
"K" = (
/turf/closed/mineral/smooth/bigred/indestructible,
/area/space)
"L" = (
/obj/effect/landmark/xeno_tunnel_spawn,
/turf/open/floor/plating/ground/mars/random/cave,
/area/bigredv2/caves/southwest)
"N" = (
/obj/effect/landmark/lv624/fog_blocker,
/turf/open/floor/plating/ground/mars/random/cave,
/area/bigredv2/caves/southwest)
"Q" = (
/turf/closed/mineral/smooth/bigred,
/area/bigredv2/caves/rock)
"S" = (
/obj/effect/landmark/xeno_silo_spawn,
/turf/open/floor/plating/ground/mars/random/cave,
/area/bigredv2/caves/southwest)
"V" = (
/obj/effect/landmark/lv624/fog_blocker/xeno_spawn,
/turf/open/floor/plating/ground/mars/random/cave,
/area/bigredv2/caves/southwest)

(1,1,1) = {"
K
K
K
K
K
K
K
K
K
K
K
K
K
K
K
K
K
K
K
K
K
K
K
K
K
K
K
K
K
K
K
K
K
K
K
K
K
K
K
K
K
K
K
"}
(2,1,1) = {"
Q
Q
Q
Q
Q
Q
Q
Q
Q
Q
Q
Q
Q
Q
Q
Q
Q
Q
Q
Q
Q
Q
Q
Q
Q
Q
Q
Q
Q
Q
Q
Q
Q
Q
Q
Q
Q
Q
Q
Q
Q
Q
K
"}
(3,1,1) = {"
Q
Q
Q
Q
Q
Q
Q
Q
Q
Q
Q
Q
Q
Q
Q
Q
Q
Q
Q
Q
Q
Q
Q
Q
Q
Q
Q
Q
d
d
d
d
d
d
d
d
d
d
d
d
Q
Q
K
"}
(4,1,1) = {"
Q
Q
Q
Q
Q
Q
Q
Q
Q
Q
Q
Q
Q
Q
Q
Q
Q
Q
Q
Q
Q
Q
Q
Q
Q
Q
Q
Q
d
Q
Q
Q
Q
Q
Q
Q
Q
Q
Q
d
Q
Q
K
"}
(5,1,1) = {"
Q
Q
Q
Q
Q
Q
Q
Q
Q
Q
Q
Q
Q
Q
Q
Q
Q
Q
Q
Q
Q
Q
Q
Q
Q
Q
Q
Q
d
Q
Q
Q
Q
Q
f
f
t
f
Q
d
Q
Q
K
"}
(6,1,1) = {"
Q
Q
Q
Q
Q
Q
Q
Q
Q
Q
Q
Q
Q
Q
Q
Q
Q
Q
Q
Q
Q
Q
Q
Q
Q
Q
Q
Q
d
Q
Q
Q
Q
f
f
f
S
f
f
d
Q
Q
K
"}
(7,1,1) = {"
Q
Q
Q
Q
f
f
f
f
f
Q
Q
Q
Q
Q
Q
Q
Q
Q
Q
Q
Q
Q
Q
Q
Q
Q
Q
f
V
f
E
Q
f
f
f
f
f
f
f
d
Q
Q
K
"}
(8,1,1) = {"
Q
Q
f
f
f
f
E
f
f
f
f
Q
Q
Q
Q
Q
Q
f
f
f
f
E
f
f
f
f
f
f
V
f
E
f
f
f
f
f
f
f
L
d
Q
Q
K
"}
(9,1,1) = {"
Q
f
E
f
f
f
f
f
f
f
f
f
f
f
f
f
f
f
f
f
f
f
f
f
f
f
f
f
V
f
E
f
f
f
f
f
f
f
Q
d
Q
Q
K
"}
(10,1,1) = {"
f
f
t
f
f
f
f
f
f
f
f
t
f
f
f
f
f
t
f
f
f
f
t
f
f
f
f
t
V
f
f
E
f
t
f
f
t
f
Q
d
Q
Q
K
"}
(11,1,1) = {"
f
f
f
f
f
f
f
f
E
f
f
f
f
E
E
f
f
f
f
E
f
f
f
f
f
f
f
f
V
f
f
m
f
f
f
f
f
Q
Q
d
Q
Q
K
"}
(12,1,1) = {"
f
f
f
f
f
f
f
f
f
f
Q
Q
Q
f
f
f
E
f
f
f
f
f
f
f
f
f
f
f
V
f
f
f
f
f
Q
Q
Q
Q
Q
d
Q
Q
K
"}
(13,1,1) = {"
f
E
p
Q
Q
Q
Q
Q
Q
Q
Q
Q
Q
Q
f
f
f
t
f
f
f
f
f
f
f
f
f
f
V
f
f
f
f
f
Q
Q
Q
Q
Q
d
Q
Q
K
"}
(14,1,1) = {"
f
f
E
Q
Q
Q
Q
Q
Q
Q
Q
Q
Q
Q
Q
Q
Q
Q
f
f
f
f
f
f
f
f
f
f
V
f
f
f
f
f
E
Q
Q
Q
Q
d
Q
Q
K
"}
(15,1,1) = {"
f
f
f
E
E
Q
Q
Q
Q
Q
Q
Q
Q
Q
Q
Q
Q
Q
Q
Q
f
f
f
f
f
f
f
f
V
V
V
V
V
V
V
d
d
d
d
d
Q
Q
K
"}
(16,1,1) = {"
f
f
f
f
E
Q
Q
Q
Q
Q
Q
Q
Q
Q
Q
Q
Q
Q
Q
Q
f
f
t
f
f
f
f
t
f
f
f
f
t
f
f
Q
Q
Q
Q
Q
Q
Q
K
"}
(17,1,1) = {"
f
f
f
f
E
Q
Q
Q
Q
Q
Q
Q
Q
Q
Q
Q
Q
Q
Q
Q
f
f
f
f
f
f
r
f
f
f
f
f
f
f
E
Q
Q
Q
Q
Q
Q
Q
K
"}
(18,1,1) = {"
f
f
f
f
E
Q
Q
Q
Q
Q
Q
Q
Q
Q
Q
Q
Q
Q
Q
f
f
f
f
f
f
f
f
f
f
f
f
f
f
Q
Q
Q
Q
Q
Q
Q
Q
Q
K
"}
(19,1,1) = {"
f
f
t
f
p
Q
Q
Q
Q
Q
Q
Q
Q
Q
Q
Q
Q
f
f
E
f
f
f
f
f
f
f
f
f
f
E
f
f
Q
Q
Q
Q
Q
Q
Q
Q
Q
K
"}
(20,1,1) = {"
Q
f
f
f
f
E
Q
Q
Q
Q
Q
Q
Q
Q
Q
f
f
f
f
f
f
f
f
f
f
E
f
f
f
f
E
f
f
f
Q
Q
Q
Q
Q
Q
Q
Q
K
"}
(21,1,1) = {"
Q
Q
Q
f
f
E
Q
Q
Q
Q
Q
E
f
f
f
f
f
E
f
f
f
f
f
f
f
f
f
f
f
E
f
f
t
f
Q
Q
Q
Q
Q
Q
Q
Q
K
"}
(22,1,1) = {"
Q
Q
Q
f
f
f
E
f
Q
Q
Q
f
t
f
f
f
f
f
f
f
f
f
t
E
Q
E
f
f
f
E
Q
Q
f
t
f
f
t
Q
Q
Q
Q
Q
K
"}
(23,1,1) = {"
Q
Q
Q
f
f
f
f
f
f
Q
f
f
f
f
f
E
Q
Q
Q
Q
Q
Q
Q
Q
Q
f
f
t
Q
Q
Q
Q
Q
f
f
f
f
Q
Q
Q
Q
Q
K
"}
(24,1,1) = {"
Q
Q
Q
f
f
f
f
f
E
f
f
E
f
f
f
E
Q
Q
Q
Q
Q
Q
Q
Q
f
f
f
f
Q
Q
Q
Q
Q
f
E
f
f
f
f
Q
Q
Q
K
"}
(25,1,1) = {"
Q
Q
Q
E
f
f
f
f
f
f
E
f
f
f
f
Q
Q
Q
Q
Q
Q
Q
Q
Q
f
t
f
f
Q
Q
Q
Q
Q
Q
f
f
f
f
f
f
Q
Q
K
"}
(26,1,1) = {"
Q
Q
Q
Q
t
f
f
f
f
f
f
f
E
f
f
Q
Q
Q
Q
Q
Q
Q
Q
Q
Q
f
t
f
Q
Q
Q
Q
Q
Q
Q
f
f
f
E
f
Q
Q
K
"}
(27,1,1) = {"
Q
Q
Q
f
f
t
f
f
f
f
f
f
t
f
f
Q
Q
Q
Q
Q
Q
Q
Q
Q
Q
f
f
f
f
Q
Q
Q
Q
Q
Q
f
f
f
f
f
Q
Q
K
"}
(28,1,1) = {"
Q
Q
f
f
f
f
f
f
f
f
f
f
f
f
E
Q
Q
Q
Q
Q
Q
Q
Q
Q
Q
Q
f
f
f
Q
Q
Q
Q
Q
Q
f
E
f
f
f
Q
Q
K
"}
(29,1,1) = {"
Q
f
f
f
f
f
f
f
f
f
f
f
f
f
f
Q
Q
Q
Q
Q
Q
Q
Q
Q
Q
Q
f
f
f
Q
Q
Q
Q
Q
Q
f
f
f
f
f
Q
Q
K
"}
(30,1,1) = {"
Q
f
f
f
f
f
f
f
f
E
Q
E
t
f
f
f
Q
Q
Q
Q
Q
Q
Q
Q
Q
Q
f
f
f
f
Q
Q
Q
t
f
f
t
f
f
Q
Q
Q
K
"}
(31,1,1) = {"
Q
f
f
f
f
f
f
f
f
E
Q
Q
E
t
f
f
f
Q
Q
Q
Q
Q
Q
Q
Q
Q
p
f
f
f
f
f
f
f
f
f
Q
Q
Q
Q
Q
Q
K
"}
(32,1,1) = {"
Q
f
t
f
f
t
Q
f
f
E
Q
Q
Q
f
t
f
f
t
f
Q
Q
Q
Q
Q
Q
Q
E
p
f
f
f
f
f
f
Q
Q
Q
Q
Q
Q
Q
Q
K
"}
(33,1,1) = {"
Q
f
f
f
Q
Q
Q
E
E
Q
Q
Q
Q
f
f
f
f
f
f
f
E
Q
Q
Q
Q
Q
Q
E
t
f
f
f
f
t
Q
K
K
K
K
K
K
K
K
"}
(34,1,1) = {"
Q
f
f
f
Q
Q
Q
Q
Q
Q
Q
Q
Q
Q
f
f
f
f
f
f
f
E
Q
Q
Q
Q
Q
Q
f
f
f
f
f
Q
Q
K
K
K
K
K
K
K
K
"}
(35,1,1) = {"
Q
f
f
f
Q
Q
Q
Q
Q
Q
Q
Q
Q
f
f
f
f
f
f
f
E
Q
Q
Q
Q
Q
Q
Q
f
f
f
Q
Q
Q
Q
K
K
K
K
K
K
K
K
"}
(36,1,1) = {"
Q
f
f
f
Q
Q
Q
Q
Q
Q
Q
Q
Q
E
t
f
f
t
f
f
E
Q
Q
Q
Q
Q
Q
Q
f
f
f
Q
Q
Q
Q
K
K
K
K
K
K
K
K
"}
(37,1,1) = {"
f
f
f
f
Q
Q
Q
Q
Q
Q
Q
Q
Q
Q
Q
Q
f
F
f
f
f
p
Q
Q
Q
Q
Q
Q
f
r
f
Q
Q
Q
Q
K
K
K
K
K
K
K
K
"}
(38,1,1) = {"
f
f
f
f
Q
Q
Q
Q
Q
Q
Q
Q
Q
Q
Q
Q
f
f
f
f
f
E
Q
Q
Q
Q
E
E
f
f
f
Q
Q
Q
Q
K
K
K
K
K
K
K
K
"}
(39,1,1) = {"
f
f
f
f
Q
Q
Q
Q
Q
Q
Q
Q
Q
Q
Q
Q
E
f
f
f
f
E
Q
Q
Q
Q
E
E
f
f
Q
Q
Q
Q
Q
K
K
K
K
K
K
K
K
"}
(40,1,1) = {"
f
f
f
f
Q
Q
Q
Q
Q
Q
Q
Q
Q
Q
Q
Q
Q
Q
Q
f
f
f
E
E
Q
Q
Q
Q
t
f
Q
Q
Q
Q
Q
K
K
K
K
K
K
K
K
"}
(41,1,1) = {"
N
N
N
w
w
w
w
w
w
w
w
w
w
w
Q
Q
Q
Q
Q
f
f
f
f
E
Q
Q
Q
Q
f
f
Q
Q
Q
Q
Q
K
K
K
K
K
K
K
K
"}
