//MAP CONVERTED BY dmm2tgm.py THIS HEADER COMMENT PREVENTS RECONVERSION, DO NOT REMOVE
"a" = (
/turf/closed/shuttle/escapepod/cornerone{
	dir = 1
	},
/area/shuttle/escape_pod)
"b" = (
/turf/closed/shuttle/escapepod/wallone,
/area/shuttle/escape_pod)
"c" = (
/obj/machinery/computer/shuttle/escape_pod,
/turf/closed/shuttle/escapepod/walltwo,
/area/shuttle/escape_pod)
"d" = (
/turf/closed/shuttle/escapepod/cornerone{
	dir = 4
	},
/area/shuttle/escape_pod)
"e" = (
/turf/closed/shuttle/escapepod/walltwelve,
/area/shuttle/escape_pod)
"f" = (
/obj/structure/bed/chair/dropship/passenger{
	dir = 1
	},
/obj/machinery/light/red{
	dir = 8
	},
/turf/open/shuttle/escapepod/eleven,
/area/shuttle/escape_pod)
"g" = (
/obj/structure/bed/chair/dropship/passenger,
/turf/open/shuttle/escapepod/zero,
/area/shuttle/escape_pod)
"h" = (
/turf/closed/shuttle/escapepod/walltwo{
	dir = 8
	},
/area/shuttle/escape_pod)
"i" = (
/obj/machinery/cryopod/evacuation{
	pixel_x = 18
	},
/turf/closed/shuttle/escapepod/walleleven,
/area/shuttle/escape_pod)
"j" = (
/turf/open/shuttle/escapepod/plain,
/area/shuttle/escape_pod)
"k" = (
/obj/docking_port/mobile/escape_pod,
/obj/machinery/door/airlock/evacuation,
/turf/open/floor/plating,
/area/shuttle/escape_pod)
"l" = (
/obj/structure/bed/chair/dropship/passenger{
	dir = 1
	},
/turf/open/shuttle/escapepod/ten,
/area/shuttle/escape_pod)
"m" = (
/turf/closed/shuttle/escapepod/cornerone{
	dir = 8
	},
/area/shuttle/escape_pod)
"n" = (
/turf/closed/shuttle/escapepod/walltwo{
	dir = 1
	},
/area/shuttle/escape_pod)
"o" = (
/turf/closed/shuttle/escapepod/cornerone,
/area/shuttle/escape_pod)
"p" = (
/turf/closed/shuttle/escapepod/wallone{
	dir = 4
	},
/area/shuttle/escape_pod)
"q" = (
/turf/closed/shuttle/escapepod/wallfive,
/area/shuttle/escape_pod)
"s" = (
/turf/open/shuttle/escapepod,
/area/shuttle/escape_pod)
"W" = (
/obj/machinery/vending/nanomed,
/obj/structure/bed/chair/dropship/passenger,
/obj/machinery/light/red{
	dir = 8
	},
/turf/open/shuttle/escapepod/eight,
/area/shuttle/escape_pod)

(1,1,1) = {"
a
e
i
p
m
"}
(2,1,1) = {"
b
W
s
f
n
"}
(3,1,1) = {"
c
g
j
l
n
"}
(4,1,1) = {"
d
h
k
q
o
"}
