//MAP CONVERTED BY dmm2tgm.py THIS HEADER COMMENT PREVENTS RECONVERSION, DO NOT REMOVE
"a" = (
/turf/open/floor/plating/plating_catwalk,
/area/shuttle/vehicle_supply/som)
"b" = (
/turf/open/floor/plating,
/area/shuttle/vehicle_supply/som)
"c" = (
/obj/docking_port/mobile/supply/vehicle/som,
/turf/open/floor/plating/plating_catwalk,
/area/shuttle/vehicle_supply/som)
"f" = (
/obj/machinery/door/poddoor/railing{
	id = "vehicle_elevator_railing"
	},
/obj/machinery/door/poddoor/railing{
	dir = 2;
	id = "vehicle_elevator_railing"
	},
/turf/open/floor/plating/plating_catwalk,
/area/shuttle/vehicle_supply/som)
"l" = (
/obj/machinery/door/poddoor/railing{
	dir = 8;
	id = "vehicle_elevator_railing"
	},
/turf/open/floor/plating/plating_catwalk,
/area/shuttle/vehicle_supply/som)
"C" = (
/obj/machinery/door/poddoor/railing{
	id = "vehicle_elevator_railing"
	},
/turf/open/floor/plating/plating_catwalk,
/area/shuttle/vehicle_supply/som)
"E" = (
/obj/machinery/door/poddoor/railing{
	dir = 2;
	id = "vehicle_elevator_railing"
	},
/turf/open/floor/plating/plating_catwalk,
/area/shuttle/vehicle_supply/som)
"I" = (
/obj/machinery/door/poddoor/railing{
	dir = 1;
	id = "vehicle_elevator_railing"
	},
/obj/machinery/door/poddoor/railing{
	dir = 8;
	id = "vehicle_elevator_railing"
	},
/turf/open/floor/plating/plating_catwalk,
/area/shuttle/vehicle_supply/som)
"K" = (
/obj/machinery/door/poddoor/railing{
	dir = 1;
	id = "vehicle_elevator_railing"
	},
/turf/open/floor/plating/plating_catwalk,
/area/shuttle/vehicle_supply/som)
"M" = (
/obj/machinery/door/poddoor/railing{
	dir = 8;
	id = "vehicle_elevator_railing"
	},
/obj/machinery/door/poddoor/railing{
	dir = 2;
	id = "vehicle_elevator_railing"
	},
/turf/open/floor/plating/plating_catwalk,
/area/shuttle/vehicle_supply/som)
"Q" = (
/obj/machinery/door/poddoor/railing{
	dir = 1;
	id = "vehicle_elevator_railing"
	},
/obj/machinery/door/poddoor/railing{
	id = "vehicle_elevator_railing"
	},
/turf/open/floor/plating/plating_catwalk,
/area/shuttle/vehicle_supply/som)

(1,1,1) = {"
I
l
l
l
M
"}
(2,1,1) = {"
K
b
a
b
E
"}
(3,1,1) = {"
K
a
c
a
E
"}
(4,1,1) = {"
K
b
a
b
E
"}
(5,1,1) = {"
Q
C
C
C
f
"}
